"Game","Date","Round","Home.Team","Home.Goals","Home.Behinds","Home.Points","Away.Team","Away.Goals","Away.Behinds","Away.Points","Venue","Margin","Season","Round.Type","Round.Number","Winner.Location","Winning.Team","Loosing.Team","Victory.Margin"
1,1897-05-08,"R1","Fitzroy",6,13,49,"Carlton",2,4,16,"Brunswick St",33,1897,"Regular",1,"Home","Fitzroy","Carlton",33
2,1897-05-08,"R1","Collingwood",5,11,41,"St Kilda",2,4,16,"Victoria Park",25,1897,"Regular",1,"Home","Collingwood","St Kilda",25
3,1897-05-08,"R1","Geelong",3,6,24,"Essendon",7,5,47,"Corio Oval",-23,1897,"Regular",1,"Away","Essendon","Geelong",23
4,1897-05-08,"R1","Sydney",3,9,27,"Melbourne",6,8,44,"Lake Oval",-17,1897,"Regular",1,"Away","Melbourne","Sydney",17
5,1897-05-15,"R2","Sydney",6,4,40,"Carlton",5,6,36,"Lake Oval",4,1897,"Regular",2,"Home","Sydney","Carlton",4
6,1897-05-15,"R2","Essendon",4,6,30,"Collingwood",8,2,50,"East Melbourne",-20,1897,"Regular",2,"Away","Collingwood","Essendon",20
7,1897-05-15,"R2","St Kilda",3,8,26,"Fitzroy",10,6,66,"Junction Oval",-40,1897,"Regular",2,"Away","Fitzroy","St Kilda",40
8,1897-05-15,"R2","Melbourne",9,10,64,"Geelong",3,1,19,"M.C.G.",45,1897,"Regular",2,"Home","Melbourne","Geelong",45
9,1897-05-22,"R3","Collingwood",6,5,41,"Geelong",5,7,37,"Victoria Park",4,1897,"Regular",3,"Home","Collingwood","Geelong",4
10,1897-05-22,"R3","Fitzroy",5,9,39,"Melbourne",7,8,50,"Brunswick St",-11,1897,"Regular",3,"Away","Melbourne","Fitzroy",11
11,1897-05-24,"R3","Essendon",12,6,78,"Carlton",6,5,41,"East Melbourne",37,1897,"Regular",3,"Home","Essendon","Carlton",37
12,1897-05-24,"R3","Sydney",8,11,59,"St Kilda",0,2,2,"Lake Oval",57,1897,"Regular",3,"Home","Sydney","St Kilda",57
13,1897-05-29,"R4","Geelong",5,14,44,"Carlton",3,4,22,"Corio Oval",22,1897,"Regular",4,"Home","Geelong","Carlton",22
14,1897-05-29,"R4","Sydney",5,11,41,"Collingwood",5,3,33,"Lake Oval",8,1897,"Regular",4,"Home","Sydney","Collingwood",8
15,1897-05-29,"R4","Fitzroy",2,8,20,"Essendon",6,6,42,"Brunswick St",-22,1897,"Regular",4,"Away","Essendon","Fitzroy",22
16,1897-05-29,"R4","Melbourne",11,10,76,"St Kilda",7,4,46,"M.C.G.",30,1897,"Regular",4,"Home","Melbourne","St Kilda",30
17,1897-06-05,"R5","Melbourne",15,17,107,"Carlton",3,8,26,"M.C.G.",81,1897,"Regular",5,"Home","Melbourne","Carlton",81
18,1897-06-05,"R5","Collingwood",5,7,37,"Fitzroy",2,9,21,"Victoria Park",16,1897,"Regular",5,"Home","Collingwood","Fitzroy",16
19,1897-06-05,"R5","St Kilda",3,8,26,"Essendon",9,9,63,"Junction Oval",-37,1897,"Regular",5,"Away","Essendon","St Kilda",37
20,1897-06-05,"R5","Geelong",10,12,72,"Sydney",3,6,24,"Corio Oval",48,1897,"Regular",5,"Home","Geelong","Sydney",48
21,1897-06-19,"R6","St Kilda",3,6,24,"Carlton",5,5,35,"Junction Oval",-11,1897,"Regular",6,"Away","Carlton","St Kilda",11
22,1897-06-19,"R6","Melbourne",5,3,33,"Collingwood",3,8,26,"M.C.G.",7,1897,"Regular",6,"Home","Melbourne","Collingwood",7
23,1897-06-19,"R6","Sydney",2,4,16,"Essendon",1,13,19,"Lake Oval",-3,1897,"Regular",6,"Away","Essendon","Sydney",3
24,1897-06-19,"R6","Geelong",3,13,31,"Fitzroy",2,3,15,"Corio Oval",16,1897,"Regular",6,"Home","Geelong","Fitzroy",16
25,1897-06-22,"R7","Carlton",5,5,35,"Collingwood",6,5,41,"Princes Park",-6,1897,"Regular",7,"Away","Collingwood","Carlton",6
26,1897-06-22,"R7","Essendon",8,15,63,"Melbourne",3,9,27,"East Melbourne",36,1897,"Regular",7,"Home","Essendon","Melbourne",36
27,1897-06-22,"R7","Fitzroy",5,13,43,"Sydney",5,13,43,"Brunswick St",0,1897,"Regular",7,"Home","Fitzroy","Sydney",0
28,1897-06-22,"R7","St Kilda",4,7,31,"Geelong",16,18,114,"Junction Oval",-83,1897,"Regular",7,"Away","Geelong","St Kilda",83
29,1897-06-26,"R8","St Kilda",4,5,29,"Collingwood",7,11,53,"Junction Oval",-24,1897,"Regular",8,"Away","Collingwood","St Kilda",24
30,1897-06-26,"R8","Essendon",5,2,32,"Geelong",8,9,57,"East Melbourne",-25,1897,"Regular",8,"Away","Geelong","Essendon",25
31,1897-06-26,"R8","Melbourne",3,2,20,"Sydney",11,7,73,"M.C.G.",-53,1897,"Regular",8,"Away","Sydney","Melbourne",53
32,1897-06-26,"R8","Carlton",1,3,9,"Fitzroy",5,17,47,"Princes Park",-38,1897,"Regular",8,"Away","Fitzroy","Carlton",38
33,1897-07-03,"R9","Carlton",4,4,28,"Sydney",11,8,74,"Princes Park",-46,1897,"Regular",9,"Away","Sydney","Carlton",46
34,1897-07-03,"R9","Collingwood",5,7,37,"Essendon",6,10,46,"Victoria Park",-9,1897,"Regular",9,"Away","Essendon","Collingwood",9
35,1897-07-03,"R9","Fitzroy",9,21,75,"St Kilda",2,6,18,"Brunswick St",57,1897,"Regular",9,"Home","Fitzroy","St Kilda",57
36,1897-07-03,"R9","Geelong",1,9,15,"Melbourne",0,10,10,"Corio Oval",5,1897,"Regular",9,"Home","Geelong","Melbourne",5
37,1897-07-10,"R10","Carlton",2,1,13,"Essendon",5,12,42,"Princes Park",-29,1897,"Regular",10,"Away","Essendon","Carlton",29
38,1897-07-10,"R10","Geelong",7,10,52,"Collingwood",1,4,10,"Corio Oval",42,1897,"Regular",10,"Home","Geelong","Collingwood",42
39,1897-07-10,"R10","Melbourne",8,5,53,"Fitzroy",3,8,26,"M.C.G.",27,1897,"Regular",10,"Home","Melbourne","Fitzroy",27
40,1897-07-10,"R10","St Kilda",0,3,3,"Sydney",8,16,64,"Junction Oval",-61,1897,"Regular",10,"Away","Sydney","St Kilda",61
41,1897-07-17,"R11","Carlton",2,4,16,"Geelong",9,12,66,"Princes Park",-50,1897,"Regular",11,"Away","Geelong","Carlton",50
42,1897-07-17,"R11","Collingwood",0,8,8,"Sydney",2,15,27,"Victoria Park",-19,1897,"Regular",11,"Away","Sydney","Collingwood",19
43,1897-07-17,"R11","Essendon",9,8,62,"Fitzroy",4,6,30,"East Melbourne",32,1897,"Regular",11,"Home","Essendon","Fitzroy",32
44,1897-07-17,"R11","St Kilda",1,7,13,"Melbourne",10,11,71,"Junction Oval",-58,1897,"Regular",11,"Away","Melbourne","St Kilda",58
45,1897-07-24,"R12","Carlton",2,6,18,"Melbourne",5,16,46,"M.C.G.",-28,1897,"Regular",12,"Away","Melbourne","Carlton",28
46,1897-07-24,"R12","Fitzroy",4,4,28,"Collingwood",3,17,35,"Brunswick St",-7,1897,"Regular",12,"Away","Collingwood","Fitzroy",7
47,1897-07-24,"R12","Essendon",13,16,94,"St Kilda",0,3,3,"East Melbourne",91,1897,"Regular",12,"Home","Essendon","St Kilda",91
48,1897-07-24,"R12","Sydney",5,2,32,"Geelong",6,8,44,"Lake Oval",-12,1897,"Regular",12,"Away","Geelong","Sydney",12
49,1897-07-31,"R13","Carlton",8,11,59,"St Kilda",3,7,25,"Princes Park",34,1897,"Regular",13,"Home","Carlton","St Kilda",34
50,1897-07-31,"R13","Collingwood",5,13,43,"Melbourne",3,10,28,"Victoria Park",15,1897,"Regular",13,"Home","Collingwood","Melbourne",15
51,1897-07-31,"R13","Essendon",8,1,49,"Sydney",6,9,45,"East Melbourne",4,1897,"Regular",13,"Home","Essendon","Sydney",4
52,1897-07-31,"R13","Fitzroy",2,9,21,"Geelong",5,3,33,"Brunswick St",-12,1897,"Regular",13,"Away","Geelong","Fitzroy",12
53,1897-08-07,"R14","Collingwood",7,12,54,"Carlton",3,4,22,"Victoria Park",32,1897,"Regular",14,"Home","Collingwood","Carlton",32
54,1897-08-07,"R14","Melbourne",8,8,56,"Essendon",6,3,39,"M.C.G.",17,1897,"Regular",14,"Home","Melbourne","Essendon",17
55,1897-08-07,"R14","Sydney",3,12,30,"Fitzroy",4,5,29,"Lake Oval",1,1897,"Regular",14,"Home","Sydney","Fitzroy",1
56,1897-08-07,"R14","Geelong",14,12,96,"St Kilda",3,0,18,"Corio Oval",78,1897,"Regular",14,"Home","Geelong","St Kilda",78
57,1897-08-21,"SF","Melbourne",7,5,47,"Collingwood",7,9,51,"M.C.G.",-4,1897,"Finals",15,"Away","Collingwood","Melbourne",4
58,1897-08-21,"SF","Geelong",3,11,29,"Essendon",5,5,35,"Corio Oval",-6,1897,"Finals",15,"Away","Essendon","Geelong",6
59,1897-08-28,"SF","Essendon",9,16,70,"Collingwood",4,6,30,"M.C.G.",40,1897,"Finals",15,"Home","Essendon","Collingwood",40
60,1897-08-28,"SF","Geelong",5,16,46,"Melbourne",5,7,37,"Brunswick St",9,1897,"Finals",15,"Home","Geelong","Melbourne",9
61,1897-09-04,"SF","Geelong",8,4,52,"Collingwood",6,12,48,"East Melbourne",4,1897,"Finals",15,"Home","Geelong","Collingwood",4
62,1897-09-04,"SF","Essendon",1,8,14,"Melbourne",0,8,8,"Lake Oval",6,1897,"Finals",15,"Home","Essendon","Melbourne",6
63,1898-05-14,"R1","Carlton",6,11,47,"Sydney",3,12,30,"Princes Park",17,1898,"Regular",1,"Home","Carlton","Sydney",17
64,1898-05-14,"R1","Collingwood",7,6,48,"Geelong",3,9,27,"Victoria Park",21,1898,"Regular",1,"Home","Collingwood","Geelong",21
65,1898-05-14,"R1","Essendon",10,10,70,"Fitzroy",2,5,17,"East Melbourne",53,1898,"Regular",1,"Home","Essendon","Fitzroy",53
66,1898-05-14,"R1","St Kilda",2,4,16,"Melbourne",13,14,92,"Junction Oval",-76,1898,"Regular",1,"Away","Melbourne","St Kilda",76
67,1898-05-21,"R2","Melbourne",12,11,83,"Carlton",4,2,26,"M.C.G.",57,1898,"Regular",2,"Home","Melbourne","Carlton",57
68,1898-05-21,"R2","Fitzroy",7,6,48,"Collingwood",5,6,36,"Brunswick St",12,1898,"Regular",2,"Home","Fitzroy","Collingwood",12
69,1898-05-21,"R2","Sydney",3,9,27,"Essendon",5,8,38,"Lake Oval",-11,1898,"Regular",2,"Away","Essendon","Sydney",11
70,1898-05-21,"R2","Geelong",11,19,85,"St Kilda",2,5,17,"Corio Oval",68,1898,"Regular",2,"Home","Geelong","St Kilda",68
71,1898-05-24,"R3","Carlton",2,4,16,"Essendon",4,4,28,"Princes Park",-12,1898,"Regular",3,"Away","Essendon","Carlton",12
72,1898-05-24,"R3","Melbourne",6,10,46,"Collingwood",5,6,36,"M.C.G.",10,1898,"Regular",3,"Home","Melbourne","Collingwood",10
73,1898-05-24,"R3","St Kilda",2,4,16,"Fitzroy",7,11,53,"Junction Oval",-37,1898,"Regular",3,"Away","Fitzroy","St Kilda",37
74,1898-05-24,"R3","Geelong",7,18,60,"Sydney",1,2,8,"Corio Oval",52,1898,"Regular",3,"Home","Geelong","Sydney",52
75,1898-05-28,"R4","Carlton",4,5,29,"Geelong",3,12,30,"Princes Park",-1,1898,"Regular",4,"Away","Geelong","Carlton",1
76,1898-05-28,"R4","Sydney",7,11,53,"Collingwood",6,6,42,"Lake Oval",11,1898,"Regular",4,"Home","Sydney","Collingwood",11
77,1898-05-28,"R4","Essendon",16,16,112,"St Kilda",5,7,37,"East Melbourne",75,1898,"Regular",4,"Home","Essendon","St Kilda",75
78,1898-05-28,"R4","Fitzroy",4,14,38,"Melbourne",2,7,19,"Brunswick St",19,1898,"Regular",4,"Home","Fitzroy","Melbourne",19
79,1898-06-04,"R5","Collingwood",6,12,48,"Carlton",0,6,6,"Victoria Park",42,1898,"Regular",5,"Home","Collingwood","Carlton",42
80,1898-06-04,"R5","Essendon",6,12,48,"Melbourne",3,5,23,"East Melbourne",25,1898,"Regular",5,"Home","Essendon","Melbourne",25
81,1898-06-04,"R5","Geelong",4,10,34,"Fitzroy",6,3,39,"Corio Oval",-5,1898,"Regular",5,"Away","Fitzroy","Geelong",5
82,1898-06-04,"R5","St Kilda",3,3,21,"Sydney",7,20,62,"Junction Oval",-41,1898,"Regular",5,"Away","Sydney","St Kilda",41
83,1898-06-11,"R6","Fitzroy",5,7,37,"Carlton",4,9,33,"Brunswick St",4,1898,"Regular",6,"Home","Fitzroy","Carlton",4
84,1898-06-11,"R6","St Kilda",5,4,34,"Collingwood",10,8,68,"Junction Oval",-34,1898,"Regular",6,"Away","Collingwood","St Kilda",34
85,1898-06-11,"R6","Geelong",4,7,31,"Essendon",3,6,24,"Corio Oval",7,1898,"Regular",6,"Home","Geelong","Essendon",7
86,1898-06-11,"R6","Melbourne",1,7,13,"Sydney",2,3,15,"M.C.G.",-2,1898,"Regular",6,"Away","Sydney","Melbourne",2
87,1898-06-18,"R7","Carlton",5,13,43,"St Kilda",5,3,33,"Princes Park",10,1898,"Regular",7,"Home","Carlton","St Kilda",10
88,1898-06-18,"R7","Collingwood",5,10,40,"Essendon",3,2,20,"Victoria Park",20,1898,"Regular",7,"Home","Collingwood","Essendon",20
89,1898-06-18,"R7","Sydney",7,9,51,"Fitzroy",2,10,22,"Lake Oval",29,1898,"Regular",7,"Home","Sydney","Fitzroy",29
90,1898-06-18,"R7","Melbourne",9,5,59,"Geelong",5,9,39,"M.C.G.",20,1898,"Regular",7,"Home","Melbourne","Geelong",20
91,1898-06-25,"R8","Sydney",6,8,44,"Carlton",1,6,12,"Lake Oval",32,1898,"Regular",8,"Home","Sydney","Carlton",32
92,1898-06-25,"R8","Geelong",6,5,41,"Collingwood",2,10,22,"Corio Oval",19,1898,"Regular",8,"Home","Geelong","Collingwood",19
93,1898-06-25,"R8","Fitzroy",2,4,16,"Essendon",8,11,59,"Brunswick St",-43,1898,"Regular",8,"Away","Essendon","Fitzroy",43
94,1898-06-25,"R8","Melbourne",5,15,45,"St Kilda",3,3,21,"M.C.G.",24,1898,"Regular",8,"Home","Melbourne","St Kilda",24
95,1898-07-09,"R9","Carlton",4,4,28,"Melbourne",3,10,28,"Princes Park",0,1898,"Regular",9,"Home","Carlton","Melbourne",0
96,1898-07-09,"R9","Collingwood",4,11,35,"Fitzroy",3,5,23,"Victoria Park",12,1898,"Regular",9,"Home","Collingwood","Fitzroy",12
97,1898-07-09,"R9","Essendon",7,12,54,"Sydney",4,6,30,"East Melbourne",24,1898,"Regular",9,"Home","Essendon","Sydney",24
98,1898-07-09,"R9","St Kilda",3,7,25,"Geelong",13,15,93,"Junction Oval",-68,1898,"Regular",9,"Away","Geelong","St Kilda",68
99,1898-07-16,"R10","Essendon",10,17,77,"Carlton",1,3,9,"East Melbourne",68,1898,"Regular",10,"Home","Essendon","Carlton",68
100,1898-07-16,"R10","Collingwood",8,11,59,"Melbourne",1,5,11,"Victoria Park",48,1898,"Regular",10,"Home","Collingwood","Melbourne",48
101,1898-07-16,"R10","Fitzroy",9,13,67,"St Kilda",3,1,19,"Brunswick St",48,1898,"Regular",10,"Home","Fitzroy","St Kilda",48
102,1898-07-16,"R10","Sydney",1,3,9,"Geelong",3,11,29,"Lake Oval",-20,1898,"Regular",10,"Away","Geelong","Sydney",20
103,1898-07-23,"R11","Geelong",8,10,58,"Carlton",5,2,32,"Corio Oval",26,1898,"Regular",11,"Home","Geelong","Carlton",26
104,1898-07-23,"R11","Collingwood",10,13,73,"Sydney",1,7,13,"Victoria Park",60,1898,"Regular",11,"Home","Collingwood","Sydney",60
105,1898-07-23,"R11","St Kilda",1,9,15,"Essendon",10,11,71,"Junction Oval",-56,1898,"Regular",11,"Away","Essendon","St Kilda",56
106,1898-07-23,"R11","Melbourne",5,3,33,"Fitzroy",7,8,50,"M.C.G.",-17,1898,"Regular",11,"Away","Fitzroy","Melbourne",17
107,1898-07-30,"R12","Carlton",1,4,10,"Collingwood",3,11,29,"Princes Park",-19,1898,"Regular",12,"Away","Collingwood","Carlton",19
108,1898-07-30,"R12","Melbourne",2,8,20,"Essendon",11,9,75,"M.C.G.",-55,1898,"Regular",12,"Away","Essendon","Melbourne",55
109,1898-07-30,"R12","Fitzroy",5,9,39,"Geelong",4,6,30,"Brunswick St",9,1898,"Regular",12,"Home","Fitzroy","Geelong",9
110,1898-07-30,"R12","Sydney",12,15,87,"St Kilda",3,6,24,"Lake Oval",63,1898,"Regular",12,"Home","Sydney","St Kilda",63
111,1898-08-13,"R13","Carlton",3,4,22,"Fitzroy",8,6,54,"Princes Park",-32,1898,"Regular",13,"Away","Fitzroy","Carlton",32
112,1898-08-13,"R13","Collingwood",8,17,65,"St Kilda",1,0,6,"Victoria Park",59,1898,"Regular",13,"Home","Collingwood","St Kilda",59
113,1898-08-13,"R13","Essendon",7,13,55,"Geelong",5,7,37,"East Melbourne",18,1898,"Regular",13,"Home","Essendon","Geelong",18
114,1898-08-13,"R13","Sydney",6,7,43,"Melbourne",5,8,38,"Lake Oval",5,1898,"Regular",13,"Home","Sydney","Melbourne",5
115,1898-08-20,"R14","St Kilda",8,7,55,"Carlton",10,9,69,"Junction Oval",-14,1898,"Regular",14,"Away","Carlton","St Kilda",14
116,1898-08-20,"R14","Essendon",2,13,25,"Collingwood",7,14,56,"East Melbourne",-31,1898,"Regular",14,"Away","Collingwood","Essendon",31
117,1898-08-20,"R14","Fitzroy",9,11,65,"Sydney",1,4,10,"Brunswick St",55,1898,"Regular",14,"Home","Fitzroy","Sydney",55
118,1898-08-20,"R14","Geelong",7,9,51,"Melbourne",2,7,19,"Corio Oval",32,1898,"Regular",14,"Home","Geelong","Melbourne",32
119,1898-08-27,"R15","Essendon",9,21,75,"Carlton",1,2,8,"East Melbourne",67,1898,"Regular",15,"Home","Essendon","Carlton",67
120,1898-08-27,"R15","St Kilda",4,3,27,"Collingwood",14,19,103,"Junction Oval",-76,1898,"Regular",15,"Away","Collingwood","St Kilda",76
121,1898-08-27,"R15","Sydney",5,3,33,"Fitzroy",6,11,47,"Lake Oval",-14,1898,"Regular",15,"Away","Fitzroy","Sydney",14
122,1898-08-27,"R15","Geelong",11,12,78,"Melbourne",2,4,16,"Corio Oval",62,1898,"Regular",15,"Home","Geelong","Melbourne",62
123,1898-09-03,"R16","Fitzroy",12,18,90,"Carlton",1,1,7,"Brunswick St",83,1898,"Regular",16,"Home","Fitzroy","Carlton",83
124,1898-09-03,"R16","Collingwood",6,9,45,"Geelong",4,6,30,"Victoria Park",15,1898,"Regular",16,"Home","Collingwood","Geelong",15
125,1898-09-03,"R16","Sydney",3,6,24,"Essendon",5,11,41,"Lake Oval",-17,1898,"Regular",16,"Away","Essendon","Sydney",17
126,1898-09-03,"R16","St Kilda",2,5,17,"Melbourne",5,8,38,"Junction Oval",-21,1898,"Regular",16,"Away","Melbourne","St Kilda",21
127,1898-09-10,"R17","Sydney",6,11,47,"Carlton",3,4,22,"Lake Oval",25,1898,"Regular",17,"Home","Sydney","Carlton",25
128,1898-09-10,"R17","Collingwood",7,13,55,"Melbourne",6,5,41,"Victoria Park",14,1898,"Regular",17,"Home","Collingwood","Melbourne",14
129,1898-09-10,"R17","Fitzroy",5,15,45,"Essendon",2,4,16,"Brunswick St",29,1898,"Regular",17,"Home","Fitzroy","Essendon",29
130,1898-09-10,"R17","Geelong",14,18,102,"St Kilda",4,3,27,"Corio Oval",75,1898,"Regular",17,"Home","Geelong","St Kilda",75
131,1898-09-17,"SF","Collingwood",1,5,11,"Fitzroy",2,10,22,"Brunswick St",-11,1898,"Finals",18,"Away","Fitzroy","Collingwood",11
132,1898-09-24,"GF","Essendon",3,5,23,"Fitzroy",5,8,38,"Junction Oval",-15,1898,"Finals",19,"Away","Fitzroy","Essendon",15
133,1899-05-13,"R1","Sydney",10,13,73,"Carlton",2,6,18,"Lake Oval",55,1899,"Regular",1,"Home","Sydney","Carlton",55
134,1899-05-13,"R1","Geelong",8,6,54,"Collingwood",3,9,27,"Corio Oval",27,1899,"Regular",1,"Home","Geelong","Collingwood",27
135,1899-05-13,"R1","Fitzroy",6,11,47,"Essendon",0,9,9,"Brunswick St",38,1899,"Regular",1,"Home","Fitzroy","Essendon",38
136,1899-05-13,"R1","Melbourne",16,20,116,"St Kilda",3,5,23,"M.C.G.",93,1899,"Regular",1,"Home","Melbourne","St Kilda",93
137,1899-05-20,"R2","Carlton",1,5,11,"Geelong",5,6,36,"Princes Park",-25,1899,"Regular",2,"Away","Geelong","Carlton",25
138,1899-05-20,"R2","Collingwood",4,3,27,"Melbourne",7,12,54,"Victoria Park",-27,1899,"Regular",2,"Away","Melbourne","Collingwood",27
139,1899-05-20,"R2","St Kilda",3,2,20,"Essendon",8,18,66,"Junction Oval",-46,1899,"Regular",2,"Away","Essendon","St Kilda",46
140,1899-05-20,"R2","Sydney",5,8,38,"Fitzroy",6,6,42,"Lake Oval",-4,1899,"Regular",2,"Away","Fitzroy","Sydney",4
141,1899-05-24,"R3","Collingwood",13,9,87,"St Kilda",2,6,18,"Victoria Park",69,1899,"Regular",3,"Home","Collingwood","St Kilda",69
142,1899-05-24,"R3","Carlton",3,1,19,"Melbourne",6,9,45,"Princes Park",-26,1899,"Regular",3,"Away","Melbourne","Carlton",26
143,1899-05-24,"R3","Essendon",1,9,15,"Sydney",0,9,9,"East Melbourne",6,1899,"Regular",3,"Home","Essendon","Sydney",6
144,1899-05-24,"R3","Geelong",0,8,8,"Fitzroy",4,8,32,"Corio Oval",-24,1899,"Regular",3,"Away","Fitzroy","Geelong",24
145,1899-05-27,"R4","Essendon",6,12,48,"Carlton",1,3,9,"East Melbourne",39,1899,"Regular",4,"Home","Essendon","Carlton",39
146,1899-05-27,"R4","Sydney",3,4,22,"Collingwood",3,11,29,"Lake Oval",-7,1899,"Regular",4,"Away","Collingwood","Sydney",7
147,1899-05-27,"R4","Fitzroy",7,14,56,"St Kilda",5,3,33,"Brunswick St",23,1899,"Regular",4,"Home","Fitzroy","St Kilda",23
148,1899-05-27,"R4","Melbourne",4,8,32,"Geelong",4,3,27,"M.C.G.",5,1899,"Regular",4,"Home","Melbourne","Geelong",5
149,1899-06-03,"R5","Carlton",3,3,21,"Collingwood",7,10,52,"Princes Park",-31,1899,"Regular",5,"Away","Collingwood","Carlton",31
150,1899-06-03,"R5","Geelong",3,10,28,"Essendon",3,6,24,"Corio Oval",4,1899,"Regular",5,"Home","Geelong","Essendon",4
151,1899-06-03,"R5","Melbourne",4,11,35,"Fitzroy",3,6,24,"M.C.G.",11,1899,"Regular",5,"Home","Melbourne","Fitzroy",11
152,1899-06-03,"R5","St Kilda",4,9,33,"Sydney",10,10,70,"Junction Oval",-37,1899,"Regular",5,"Away","Sydney","St Kilda",37
153,1899-06-10,"R6","St Kilda",4,5,29,"Carlton",4,7,31,"Junction Oval",-2,1899,"Regular",6,"Away","Carlton","St Kilda",2
154,1899-06-10,"R6","Collingwood",1,7,13,"Fitzroy",5,5,35,"Victoria Park",-22,1899,"Regular",6,"Away","Fitzroy","Collingwood",22
155,1899-06-10,"R6","Essendon",4,6,30,"Melbourne",1,10,16,"East Melbourne",14,1899,"Regular",6,"Home","Essendon","Melbourne",14
156,1899-06-10,"R6","Sydney",5,5,35,"Geelong",3,1,19,"Lake Oval",16,1899,"Regular",6,"Home","Sydney","Geelong",16
157,1899-06-17,"R7","Fitzroy",5,15,45,"Carlton",1,7,13,"Brunswick St",32,1899,"Regular",7,"Home","Fitzroy","Carlton",32
158,1899-06-17,"R7","Collingwood",6,12,48,"Essendon",4,4,28,"Victoria Park",20,1899,"Regular",7,"Home","Collingwood","Essendon",20
159,1899-06-17,"R7","St Kilda",3,13,31,"Geelong",12,6,78,"Junction Oval",-47,1899,"Regular",7,"Away","Geelong","St Kilda",47
160,1899-06-17,"R7","Melbourne",7,8,50,"Sydney",6,7,43,"M.C.G.",7,1899,"Regular",7,"Home","Melbourne","Sydney",7
161,1899-06-24,"R8","Carlton",3,6,24,"Sydney",0,5,5,"Princes Park",19,1899,"Regular",8,"Home","Carlton","Sydney",19
162,1899-06-24,"R8","Collingwood",2,8,20,"Geelong",9,7,61,"Victoria Park",-41,1899,"Regular",8,"Away","Geelong","Collingwood",41
163,1899-06-24,"R8","Essendon",6,15,51,"Fitzroy",10,3,63,"East Melbourne",-12,1899,"Regular",8,"Away","Fitzroy","Essendon",12
164,1899-06-24,"R8","St Kilda",2,8,20,"Melbourne",5,7,37,"Junction Oval",-17,1899,"Regular",8,"Away","Melbourne","St Kilda",17
165,1899-07-08,"R9","Geelong",9,9,63,"Carlton",5,3,33,"Corio Oval",30,1899,"Regular",9,"Home","Geelong","Carlton",30
166,1899-07-08,"R9","Melbourne",1,7,13,"Collingwood",3,3,21,"M.C.G.",-8,1899,"Regular",9,"Away","Collingwood","Melbourne",8
167,1899-07-08,"R9","Essendon",11,19,85,"St Kilda",1,0,6,"East Melbourne",79,1899,"Regular",9,"Home","Essendon","St Kilda",79
168,1899-07-08,"R9","Fitzroy",9,8,62,"Sydney",4,5,29,"Brunswick St",33,1899,"Regular",9,"Home","Fitzroy","Sydney",33
169,1899-07-15,"R10","Melbourne",7,12,54,"Carlton",3,4,22,"M.C.G.",32,1899,"Regular",10,"Home","Melbourne","Carlton",32
170,1899-07-15,"R10","St Kilda",1,5,11,"Collingwood",13,16,94,"Junction Oval",-83,1899,"Regular",10,"Away","Collingwood","St Kilda",83
171,1899-07-15,"R10","Sydney",5,5,35,"Essendon",7,9,51,"Lake Oval",-16,1899,"Regular",10,"Away","Essendon","Sydney",16
172,1899-07-15,"R10","Fitzroy",3,5,23,"Geelong",8,10,58,"Brunswick St",-35,1899,"Regular",10,"Away","Geelong","Fitzroy",35
173,1899-07-22,"R11","Carlton",3,8,26,"Essendon",8,9,57,"Princes Park",-31,1899,"Regular",11,"Away","Essendon","Carlton",31
174,1899-07-22,"R11","Collingwood",5,9,39,"Sydney",5,6,36,"Victoria Park",3,1899,"Regular",11,"Home","Collingwood","Sydney",3
175,1899-07-22,"R11","St Kilda",4,6,30,"Fitzroy",12,12,84,"Junction Oval",-54,1899,"Regular",11,"Away","Fitzroy","St Kilda",54
176,1899-07-22,"R11","Geelong",5,6,36,"Melbourne",2,10,22,"Corio Oval",14,1899,"Regular",11,"Home","Geelong","Melbourne",14
177,1899-07-29,"R12","Collingwood",5,13,43,"Carlton",4,3,27,"Victoria Park",16,1899,"Regular",12,"Home","Collingwood","Carlton",16
178,1899-07-29,"R12","Essendon",10,7,67,"Geelong",6,7,43,"East Melbourne",24,1899,"Regular",12,"Home","Essendon","Geelong",24
179,1899-07-29,"R12","Fitzroy",6,5,41,"Melbourne",4,9,33,"Brunswick St",8,1899,"Regular",12,"Home","Fitzroy","Melbourne",8
180,1899-07-29,"R12","Sydney",8,9,57,"St Kilda",3,6,24,"Lake Oval",33,1899,"Regular",12,"Home","Sydney","St Kilda",33
181,1899-08-05,"R13","Carlton",6,11,47,"St Kilda",1,2,8,"Princes Park",39,1899,"Regular",13,"Home","Carlton","St Kilda",39
182,1899-08-05,"R13","Fitzroy",3,7,25,"Collingwood",5,7,37,"Brunswick St",-12,1899,"Regular",13,"Away","Collingwood","Fitzroy",12
183,1899-08-05,"R13","Melbourne",3,7,25,"Essendon",5,8,38,"M.C.G.",-13,1899,"Regular",13,"Away","Essendon","Melbourne",13
184,1899-08-05,"R13","Geelong",7,12,54,"Sydney",3,9,27,"Corio Oval",27,1899,"Regular",13,"Home","Geelong","Sydney",27
185,1899-08-12,"R14","Carlton",2,4,16,"Fitzroy",5,9,39,"Princes Park",-23,1899,"Regular",14,"Away","Fitzroy","Carlton",23
186,1899-08-12,"R14","Essendon",4,7,31,"Collingwood",8,5,53,"East Melbourne",-22,1899,"Regular",14,"Away","Collingwood","Essendon",22
187,1899-08-12,"R14","Geelong",16,23,119,"St Kilda",0,2,2,"Corio Oval",117,1899,"Regular",14,"Home","Geelong","St Kilda",117
188,1899-08-12,"R14","Sydney",6,13,49,"Melbourne",6,6,42,"Lake Oval",7,1899,"Regular",14,"Home","Sydney","Melbourne",7
189,1899-08-26,"R15","Fitzroy",5,11,41,"Carlton",6,4,40,"Brunswick St",1,1899,"Regular",15,"Home","Fitzroy","Carlton",1
190,1899-08-26,"R15","Melbourne",3,7,25,"Collingwood",6,9,45,"Lake Oval",-20,1899,"Regular",15,"Away","Collingwood","Melbourne",20
191,1899-08-26,"R15","Essendon",16,24,120,"St Kilda",3,4,22,"East Melbourne",98,1899,"Regular",15,"Home","Essendon","St Kilda",98
192,1899-08-26,"R15","Geelong",5,8,38,"Sydney",6,5,41,"Corio Oval",-3,1899,"Regular",15,"Away","Sydney","Geelong",3
193,1899-09-02,"R16","Collingwood",5,8,38,"Carlton",2,5,17,"Victoria Park",21,1899,"Regular",16,"Home","Collingwood","Carlton",21
194,1899-09-02,"R16","Essendon",4,15,39,"Geelong",6,11,47,"East Melbourne",-8,1899,"Regular",16,"Away","Geelong","Essendon",8
195,1899-09-02,"R16","Fitzroy",5,10,40,"Melbourne",0,2,2,"Brunswick St",38,1899,"Regular",16,"Home","Fitzroy","Melbourne",38
196,1899-09-02,"R16","St Kilda",1,6,12,"Sydney",12,10,82,"Junction Oval",-70,1899,"Regular",16,"Away","Sydney","St Kilda",70
197,1899-09-09,"R17","Carlton",6,5,41,"Melbourne",2,4,16,"Princes Park",25,1899,"Regular",17,"Home","Carlton","Melbourne",25
198,1899-09-09,"R17","Collingwood",4,7,31,"Fitzroy",6,9,45,"Victoria Park",-14,1899,"Regular",17,"Away","Fitzroy","Collingwood",14
199,1899-09-09,"R17","Sydney",3,10,28,"Essendon",2,1,13,"Lake Oval",15,1899,"Regular",17,"Home","Sydney","Essendon",15
200,1899-09-09,"R17","Geelong",23,24,162,"St Kilda",0,1,1,"Corio Oval",161,1899,"Regular",17,"Home","Geelong","St Kilda",161
201,1899-09-16,"GF","Fitzroy",3,9,27,"Sydney",3,8,26,"Junction Oval",1,1899,"Finals",18,"Home","Fitzroy","Sydney",1
202,1900-05-05,"R1","Carlton",2,6,18,"Geelong",4,11,35,"Princes Park",-17,1900,"Regular",1,"Away","Geelong","Carlton",17
203,1900-05-05,"R1","Collingwood",10,7,67,"Fitzroy",6,10,46,"Victoria Park",21,1900,"Regular",1,"Home","Collingwood","Fitzroy",21
204,1900-05-05,"R1","Essendon",12,10,82,"Sydney",4,2,26,"East Melbourne",56,1900,"Regular",1,"Home","Essendon","Sydney",56
205,1900-05-05,"R1","St Kilda",10,8,68,"Melbourne",9,13,67,"Junction Oval",1,1900,"Regular",1,"Home","St Kilda","Melbourne",1
206,1900-05-12,"R2","Fitzroy",4,10,34,"Carlton",1,4,10,"Brunswick St",24,1900,"Regular",2,"Home","Fitzroy","Carlton",24
207,1900-05-12,"R2","Geelong",7,15,57,"Collingwood",5,5,35,"Corio Oval",22,1900,"Regular",2,"Home","Geelong","Collingwood",22
208,1900-05-12,"R2","Melbourne",5,4,34,"Essendon",2,6,18,"M.C.G.",16,1900,"Regular",2,"Home","Melbourne","Essendon",16
209,1900-05-12,"R2","Sydney",6,21,57,"St Kilda",3,7,25,"Lake Oval",32,1900,"Regular",2,"Home","Sydney","St Kilda",32
210,1900-05-23,"R4","Essendon",13,7,85,"Collingwood",2,4,16,"East Melbourne",69,1900,"Regular",4,"Home","Essendon","Collingwood",69
211,1900-05-24,"R4","St Kilda",2,6,18,"Carlton",3,9,27,"Junction Oval",-9,1900,"Regular",4,"Away","Carlton","St Kilda",9
212,1900-05-24,"R4","Fitzroy",6,19,55,"Sydney",3,4,22,"Brunswick St",33,1900,"Regular",4,"Home","Fitzroy","Sydney",33
213,1900-05-24,"R4","Geelong",11,15,81,"Melbourne",2,3,15,"Corio Oval",66,1900,"Regular",4,"Home","Geelong","Melbourne",66
214,1900-05-26,"R5","Carlton",2,6,18,"Essendon",3,5,23,"Princes Park",-5,1900,"Regular",5,"Away","Essendon","Carlton",5
215,1900-05-26,"R5","Collingwood",9,11,65,"St Kilda",2,7,19,"Victoria Park",46,1900,"Regular",5,"Home","Collingwood","St Kilda",46
216,1900-05-26,"R5","Melbourne",3,9,27,"Fitzroy",10,6,66,"M.C.G.",-39,1900,"Regular",5,"Away","Fitzroy","Melbourne",39
217,1900-05-26,"R5","Sydney",5,7,37,"Geelong",3,5,23,"Lake Oval",14,1900,"Regular",5,"Home","Sydney","Geelong",14
218,1900-06-02,"R6","Carlton",4,1,25,"Collingwood",0,9,9,"Princes Park",16,1900,"Regular",6,"Home","Carlton","Collingwood",16
219,1900-06-02,"R6","St Kilda",2,6,18,"Essendon",3,11,29,"Junction Oval",-11,1900,"Regular",6,"Away","Essendon","St Kilda",11
220,1900-06-02,"R6","Sydney",6,8,44,"Melbourne",6,5,41,"Lake Oval",3,1900,"Regular",6,"Home","Sydney","Melbourne",3
221,1900-06-02,"R6","Fitzroy",6,10,46,"Geelong",1,6,12,"Brunswick St",34,1900,"Regular",6,"Home","Fitzroy","Geelong",34
222,1900-06-09,"R7","Sydney",4,6,30,"Carlton",2,6,18,"Lake Oval",12,1900,"Regular",7,"Home","Sydney","Carlton",12
223,1900-06-09,"R7","Melbourne",8,18,66,"Collingwood",5,7,37,"M.C.G.",29,1900,"Regular",7,"Home","Melbourne","Collingwood",29
224,1900-06-09,"R7","Geelong",8,5,53,"Essendon",4,7,31,"Corio Oval",22,1900,"Regular",7,"Home","Geelong","Essendon",22
225,1900-06-09,"R7","Fitzroy",16,20,116,"St Kilda",2,5,17,"Brunswick St",99,1900,"Regular",7,"Home","Fitzroy","St Kilda",99
226,1900-06-23,"R8","Geelong",5,9,39,"Carlton",3,13,31,"Corio Oval",8,1900,"Regular",8,"Home","Geelong","Carlton",8
227,1900-06-23,"R8","Fitzroy",6,6,42,"Collingwood",2,8,20,"Brunswick St",22,1900,"Regular",8,"Home","Fitzroy","Collingwood",22
228,1900-06-23,"R8","Sydney",4,14,38,"Essendon",1,4,10,"Lake Oval",28,1900,"Regular",8,"Home","Sydney","Essendon",28
229,1900-06-23,"R8","Melbourne",15,18,108,"St Kilda",4,5,29,"M.C.G.",79,1900,"Regular",8,"Home","Melbourne","St Kilda",79
230,1900-06-30,"R9","Carlton",2,3,15,"Fitzroy",7,11,53,"Princes Park",-38,1900,"Regular",9,"Away","Fitzroy","Carlton",38
231,1900-06-30,"R9","Collingwood",6,6,42,"Geelong",3,5,23,"Victoria Park",19,1900,"Regular",9,"Home","Collingwood","Geelong",19
232,1900-06-30,"R9","Essendon",2,6,18,"Melbourne",6,8,44,"East Melbourne",-26,1900,"Regular",9,"Away","Melbourne","Essendon",26
233,1900-06-30,"R9","St Kilda",1,5,11,"Sydney",5,22,52,"Junction Oval",-41,1900,"Regular",9,"Away","Sydney","St Kilda",41
234,1900-07-07,"R10","Melbourne",9,14,68,"Carlton",5,3,33,"M.C.G.",35,1900,"Regular",10,"Home","Melbourne","Carlton",35
235,1900-07-07,"R10","Sydney",3,8,26,"Collingwood",2,12,24,"Lake Oval",2,1900,"Regular",10,"Home","Sydney","Collingwood",2
236,1900-07-07,"R10","Fitzroy",7,12,54,"Essendon",5,10,40,"Brunswick St",14,1900,"Regular",10,"Home","Fitzroy","Essendon",14
237,1900-07-07,"R10","Geelong",13,8,86,"St Kilda",4,4,28,"Corio Oval",58,1900,"Regular",10,"Home","Geelong","St Kilda",58
238,1900-07-14,"R11","Carlton",7,7,49,"St Kilda",4,4,28,"Princes Park",21,1900,"Regular",11,"Home","Carlton","St Kilda",21
239,1900-07-14,"R11","Collingwood",6,14,50,"Essendon",4,5,29,"Victoria Park",21,1900,"Regular",11,"Home","Collingwood","Essendon",21
240,1900-07-14,"R11","Sydney",4,9,33,"Fitzroy",5,9,39,"Lake Oval",-6,1900,"Regular",11,"Away","Fitzroy","Sydney",6
241,1900-07-14,"R11","Melbourne",4,16,40,"Geelong",4,5,29,"M.C.G.",11,1900,"Regular",11,"Home","Melbourne","Geelong",11
242,1900-07-28,"R12","Essendon",12,12,84,"Carlton",5,5,35,"East Melbourne",49,1900,"Regular",12,"Home","Essendon","Carlton",49
243,1900-07-28,"R12","St Kilda",3,5,23,"Collingwood",6,12,48,"Junction Oval",-25,1900,"Regular",12,"Away","Collingwood","St Kilda",25
244,1900-07-28,"R12","Fitzroy",8,9,57,"Melbourne",4,8,32,"Brunswick St",25,1900,"Regular",12,"Home","Fitzroy","Melbourne",25
245,1900-07-28,"R12","Geelong",10,10,70,"Sydney",3,6,24,"Corio Oval",46,1900,"Regular",12,"Home","Geelong","Sydney",46
246,1900-08-04,"R13","Collingwood",14,12,96,"Carlton",4,4,28,"Victoria Park",68,1900,"Regular",13,"Home","Collingwood","Carlton",68
247,1900-08-04,"R13","Essendon",17,15,117,"St Kilda",3,7,25,"East Melbourne",92,1900,"Regular",13,"Home","Essendon","St Kilda",92
248,1900-08-04,"R13","Geelong",8,9,57,"Fitzroy",1,6,12,"Corio Oval",45,1900,"Regular",13,"Home","Geelong","Fitzroy",45
249,1900-08-04,"R13","Melbourne",6,8,44,"Sydney",7,6,48,"M.C.G.",-4,1900,"Regular",13,"Away","Sydney","Melbourne",4
250,1900-08-11,"R14","Carlton",5,15,45,"Sydney",2,7,19,"Princes Park",26,1900,"Regular",14,"Home","Carlton","Sydney",26
251,1900-08-11,"R14","Collingwood",10,13,73,"Melbourne",7,4,46,"Victoria Park",27,1900,"Regular",14,"Home","Collingwood","Melbourne",27
252,1900-08-11,"R14","Essendon",10,7,67,"Geelong",6,11,47,"East Melbourne",20,1900,"Regular",14,"Home","Essendon","Geelong",20
253,1900-08-11,"R14","St Kilda",7,7,49,"Fitzroy",10,22,82,"Junction Oval",-33,1900,"Regular",14,"Away","Fitzroy","St Kilda",33
254,1900-08-18,"R3","Carlton",6,6,42,"Melbourne",3,4,22,"Princes Park",20,1900,"Regular",3,"Home","Carlton","Melbourne",20
255,1900-08-18,"R3","Collingwood",5,15,45,"Sydney",3,7,25,"Victoria Park",20,1900,"Regular",3,"Home","Collingwood","Sydney",20
256,1900-08-18,"R3","Essendon",4,9,33,"Fitzroy",3,9,27,"East Melbourne",6,1900,"Regular",3,"Home","Essendon","Fitzroy",6
257,1900-08-18,"R3","St Kilda",2,6,18,"Geelong",7,16,58,"Junction Oval",-40,1900,"Regular",3,"Away","Geelong","St Kilda",40
258,1900-08-25,"R15","Fitzroy",9,13,67,"Carlton",5,8,38,"Brunswick St",29,1900,"Regular",15,"Home","Fitzroy","Carlton",29
259,1900-08-25,"R15","Collingwood",8,20,68,"St Kilda",0,9,9,"Victoria Park",59,1900,"Regular",15,"Home","Collingwood","St Kilda",59
260,1900-08-25,"R15","Sydney",3,1,19,"Essendon",9,5,59,"Lake Oval",-40,1900,"Regular",15,"Away","Essendon","Sydney",40
261,1900-08-25,"R15","Melbourne",5,15,45,"Geelong",3,10,28,"East Melbourne",17,1900,"Regular",15,"Home","Melbourne","Geelong",17
262,1900-09-01,"R16","Carlton",4,7,31,"Sydney",4,6,30,"Princes Park",1,1900,"Regular",16,"Home","Carlton","Sydney",1
263,1900-09-01,"R16","Geelong",6,8,44,"Collingwood",4,7,31,"Corio Oval",13,1900,"Regular",16,"Home","Geelong","Collingwood",13
264,1900-09-01,"R16","Essendon",6,3,39,"Fitzroy",5,6,36,"East Melbourne",3,1900,"Regular",16,"Home","Essendon","Fitzroy",3
265,1900-09-01,"R16","St Kilda",2,3,15,"Melbourne",12,14,86,"Junction Oval",-71,1900,"Regular",16,"Away","Melbourne","St Kilda",71
266,1900-09-08,"R17","Essendon",12,23,95,"Carlton",1,4,10,"East Melbourne",85,1900,"Regular",17,"Home","Essendon","Carlton",85
267,1900-09-08,"R17","Melbourne",3,6,24,"Collingwood",4,6,30,"Lake Oval",-6,1900,"Regular",17,"Away","Collingwood","Melbourne",6
268,1900-09-08,"R17","Fitzroy",7,9,51,"Sydney",2,8,20,"Brunswick St",31,1900,"Regular",17,"Home","Fitzroy","Sydney",31
269,1900-09-08,"R17","St Kilda",5,9,39,"Geelong",7,15,57,"Junction Oval",-18,1900,"Regular",17,"Away","Geelong","St Kilda",18
270,1900-09-15,"SF","Essendon",5,13,43,"Melbourne",7,3,45,"Lake Oval",-2,1900,"Finals",18,"Away","Melbourne","Essendon",2
271,1900-09-22,"GF","Fitzroy",3,12,30,"Melbourne",4,10,34,"East Melbourne",-4,1900,"Finals",19,"Away","Melbourne","Fitzroy",4
272,1901-05-04,"R1","Fitzroy",8,13,61,"Carlton",2,7,19,"Brunswick St",42,1901,"Regular",1,"Home","Fitzroy","Carlton",42
273,1901-05-04,"R1","Essendon",1,15,21,"Collingwood",9,10,64,"East Melbourne",-43,1901,"Regular",1,"Away","Collingwood","Essendon",43
274,1901-05-04,"R1","Geelong",2,11,23,"Melbourne",3,3,21,"Corio Oval",2,1901,"Regular",1,"Home","Geelong","Melbourne",2
275,1901-05-04,"R1","St Kilda",6,5,41,"Sydney",6,13,49,"Junction Oval",-8,1901,"Regular",1,"Away","Sydney","St Kilda",8
276,1901-05-09,"R2","Collingwood",13,16,94,"Carlton",0,7,7,"Victoria Park",87,1901,"Regular",2,"Home","Collingwood","Carlton",87
277,1901-05-09,"R2","St Kilda",3,1,19,"Essendon",9,14,68,"Junction Oval",-49,1901,"Regular",2,"Away","Essendon","St Kilda",49
278,1901-05-09,"R2","Fitzroy",5,8,38,"Geelong",6,12,48,"Brunswick St",-10,1901,"Regular",2,"Away","Geelong","Fitzroy",10
279,1901-05-09,"R2","Melbourne",5,6,36,"Sydney",5,10,40,"M.C.G.",-4,1901,"Regular",2,"Away","Sydney","Melbourne",4
280,1901-05-11,"R3","Carlton",3,8,26,"Geelong",7,13,55,"Princes Park",-29,1901,"Regular",3,"Away","Geelong","Carlton",29
281,1901-05-11,"R3","Sydney",9,4,58,"Collingwood",6,11,47,"Lake Oval",11,1901,"Regular",3,"Home","Sydney","Collingwood",11
282,1901-05-11,"R3","Essendon",6,8,44,"Fitzroy",7,5,47,"East Melbourne",-3,1901,"Regular",3,"Away","Fitzroy","Essendon",3
283,1901-05-11,"R3","Melbourne",7,16,58,"St Kilda",3,3,21,"M.C.G.",37,1901,"Regular",3,"Home","Melbourne","St Kilda",37
284,1901-05-18,"R4","Carlton",4,3,27,"Sydney",3,7,25,"Princes Park",2,1901,"Regular",4,"Home","Carlton","Sydney",2
285,1901-05-18,"R4","Collingwood",6,8,44,"Melbourne",3,4,22,"Victoria Park",22,1901,"Regular",4,"Home","Collingwood","Melbourne",22
286,1901-05-18,"R4","Geelong",4,10,34,"Essendon",4,6,30,"Corio Oval",4,1901,"Regular",4,"Home","Geelong","Essendon",4
287,1901-05-18,"R4","Fitzroy",15,16,106,"St Kilda",3,5,23,"Brunswick St",83,1901,"Regular",4,"Home","Fitzroy","St Kilda",83
288,1901-05-25,"R5","Carlton",5,10,40,"St Kilda",2,8,20,"Princes Park",20,1901,"Regular",5,"Home","Carlton","St Kilda",20
289,1901-05-25,"R5","Geelong",3,6,24,"Collingwood",4,8,32,"Corio Oval",-8,1901,"Regular",5,"Away","Collingwood","Geelong",8
290,1901-05-25,"R5","Essendon",7,8,50,"Melbourne",3,6,24,"East Melbourne",26,1901,"Regular",5,"Home","Essendon","Melbourne",26
291,1901-05-25,"R5","Sydney",3,7,25,"Fitzroy",6,5,41,"Lake Oval",-16,1901,"Regular",5,"Away","Fitzroy","Sydney",16
292,1901-06-01,"R6","Melbourne",7,7,49,"Carlton",5,4,34,"M.C.G.",15,1901,"Regular",6,"Home","Melbourne","Carlton",15
293,1901-06-01,"R6","Collingwood",7,13,55,"Fitzroy",6,9,45,"Victoria Park",10,1901,"Regular",6,"Home","Collingwood","Fitzroy",10
294,1901-06-01,"R6","Sydney",5,5,35,"Essendon",3,23,41,"Lake Oval",-6,1901,"Regular",6,"Away","Essendon","Sydney",6
295,1901-06-01,"R6","St Kilda",2,5,17,"Geelong",11,12,78,"Junction Oval",-61,1901,"Regular",6,"Away","Geelong","St Kilda",61
296,1901-06-03,"R7","Essendon",15,15,105,"Carlton",3,7,25,"East Melbourne",80,1901,"Regular",7,"Home","Essendon","Carlton",80
297,1901-06-03,"R7","St Kilda",3,1,19,"Collingwood",7,11,53,"Junction Oval",-34,1901,"Regular",7,"Away","Collingwood","St Kilda",34
298,1901-06-03,"R7","Fitzroy",5,6,36,"Melbourne",5,6,36,"Brunswick St",0,1901,"Regular",7,"Home","Fitzroy","Melbourne",0
299,1901-06-03,"R7","Geelong",9,11,65,"Sydney",3,4,22,"Corio Oval",43,1901,"Regular",7,"Home","Geelong","Sydney",43
300,1901-06-08,"R8","Carlton",5,7,37,"Fitzroy",6,8,44,"Princes Park",-7,1901,"Regular",8,"Away","Fitzroy","Carlton",7
301,1901-06-08,"R8","Collingwood",7,7,49,"Essendon",7,6,48,"Victoria Park",1,1901,"Regular",8,"Home","Collingwood","Essendon",1
302,1901-06-08,"R8","Melbourne",7,4,46,"Geelong",9,5,59,"M.C.G.",-13,1901,"Regular",8,"Away","Geelong","Melbourne",13
303,1901-06-08,"R8","Sydney",7,14,56,"St Kilda",1,1,7,"Lake Oval",49,1901,"Regular",8,"Home","Sydney","St Kilda",49
304,1901-06-22,"R9","Carlton",6,6,42,"Collingwood",9,9,63,"Princes Park",-21,1901,"Regular",9,"Away","Collingwood","Carlton",21
305,1901-06-22,"R9","Essendon",19,22,136,"St Kilda",4,5,29,"East Melbourne",107,1901,"Regular",9,"Home","Essendon","St Kilda",107
306,1901-06-22,"R9","Geelong",6,16,52,"Fitzroy",8,3,51,"Corio Oval",1,1901,"Regular",9,"Home","Geelong","Fitzroy",1
307,1901-06-22,"R9","Sydney",6,9,45,"Melbourne",9,7,61,"Lake Oval",-16,1901,"Regular",9,"Away","Melbourne","Sydney",16
308,1901-06-29,"R10","Geelong",8,15,63,"Carlton",4,7,31,"Corio Oval",32,1901,"Regular",10,"Home","Geelong","Carlton",32
309,1901-06-29,"R10","Collingwood",5,1,31,"Sydney",7,9,51,"Victoria Park",-20,1901,"Regular",10,"Away","Sydney","Collingwood",20
310,1901-06-29,"R10","Fitzroy",6,8,44,"Essendon",14,8,92,"Brunswick St",-48,1901,"Regular",10,"Away","Essendon","Fitzroy",48
311,1901-06-29,"R10","St Kilda",4,4,28,"Melbourne",4,14,38,"Junction Oval",-10,1901,"Regular",10,"Away","Melbourne","St Kilda",10
312,1901-07-06,"R11","Sydney",10,10,70,"Carlton",3,2,20,"Lake Oval",50,1901,"Regular",11,"Home","Sydney","Carlton",50
313,1901-07-06,"R11","Melbourne",5,6,36,"Collingwood",4,11,35,"M.C.G.",1,1901,"Regular",11,"Home","Melbourne","Collingwood",1
314,1901-07-06,"R11","Essendon",6,13,49,"Geelong",2,12,24,"East Melbourne",25,1901,"Regular",11,"Home","Essendon","Geelong",25
315,1901-07-06,"R11","St Kilda",4,10,34,"Fitzroy",11,7,73,"Junction Oval",-39,1901,"Regular",11,"Away","Fitzroy","St Kilda",39
316,1901-07-13,"R12","St Kilda",7,8,50,"Carlton",4,8,32,"Junction Oval",18,1901,"Regular",12,"Home","St Kilda","Carlton",18
317,1901-07-13,"R12","Collingwood",6,5,41,"Geelong",12,11,83,"Victoria Park",-42,1901,"Regular",12,"Away","Geelong","Collingwood",42
318,1901-07-13,"R12","Melbourne",6,6,42,"Essendon",4,9,33,"M.C.G.",9,1901,"Regular",12,"Home","Melbourne","Essendon",9
319,1901-07-13,"R12","Fitzroy",9,11,65,"Sydney",12,7,79,"Brunswick St",-14,1901,"Regular",12,"Away","Sydney","Fitzroy",14
320,1901-07-20,"R13","Carlton",5,6,36,"Melbourne",6,6,42,"Princes Park",-6,1901,"Regular",13,"Away","Melbourne","Carlton",6
321,1901-07-20,"R13","Fitzroy",2,7,19,"Collingwood",3,6,24,"Brunswick St",-5,1901,"Regular",13,"Away","Collingwood","Fitzroy",5
322,1901-07-20,"R13","Essendon",6,16,52,"Sydney",8,3,51,"East Melbourne",1,1901,"Regular",13,"Home","Essendon","Sydney",1
323,1901-07-20,"R13","Geelong",8,7,55,"St Kilda",4,5,29,"Corio Oval",26,1901,"Regular",13,"Home","Geelong","St Kilda",26
324,1901-07-27,"R14","Carlton",3,2,20,"Essendon",11,13,79,"Princes Park",-59,1901,"Regular",14,"Away","Essendon","Carlton",59
325,1901-07-27,"R14","Collingwood",10,20,80,"St Kilda",1,7,13,"Victoria Park",67,1901,"Regular",14,"Home","Collingwood","St Kilda",67
326,1901-07-27,"R14","Melbourne",4,5,29,"Fitzroy",2,11,23,"M.C.G.",6,1901,"Regular",14,"Home","Melbourne","Fitzroy",6
327,1901-07-27,"R14","Sydney",6,9,45,"Geelong",6,13,49,"Lake Oval",-4,1901,"Regular",14,"Away","Geelong","Sydney",4
328,1901-08-10,"R15","Carlton",3,5,23,"Geelong",6,18,54,"Princes Park",-31,1901,"Regular",15,"Away","Geelong","Carlton",31
329,1901-08-10,"R15","Collingwood",6,8,44,"Melbourne",3,10,28,"Victoria Park",16,1901,"Regular",15,"Home","Collingwood","Melbourne",16
330,1901-08-10,"R15","Sydney",1,3,9,"Essendon",10,9,69,"Lake Oval",-60,1901,"Regular",15,"Away","Essendon","Sydney",60
331,1901-08-10,"R15","St Kilda",4,3,27,"Fitzroy",14,15,99,"Junction Oval",-72,1901,"Regular",15,"Away","Fitzroy","St Kilda",72
332,1901-08-17,"R16","Essendon",14,18,102,"Carlton",5,3,33,"East Melbourne",69,1901,"Regular",16,"Home","Essendon","Carlton",69
333,1901-08-17,"R16","Fitzroy",7,6,48,"Collingwood",2,6,18,"Brunswick St",30,1901,"Regular",16,"Home","Fitzroy","Collingwood",30
334,1901-08-17,"R16","Geelong",7,12,54,"Sydney",4,6,30,"Corio Oval",24,1901,"Regular",16,"Home","Geelong","Sydney",24
335,1901-08-17,"R16","Melbourne",19,10,124,"St Kilda",3,4,22,"Lake Oval",102,1901,"Regular",16,"Home","Melbourne","St Kilda",102
336,1901-08-24,"R17","Carlton",3,6,24,"Sydney",4,13,37,"Princes Park",-13,1901,"Regular",17,"Away","Sydney","Carlton",13
337,1901-08-24,"R17","Collingwood",20,23,143,"St Kilda",2,3,15,"Victoria Park",128,1901,"Regular",17,"Home","Collingwood","St Kilda",128
338,1901-08-24,"R17","Geelong",5,3,33,"Essendon",9,12,66,"Corio Oval",-33,1901,"Regular",17,"Away","Essendon","Geelong",33
339,1901-08-24,"R17","Fitzroy",4,13,37,"Melbourne",3,6,24,"Brunswick St",13,1901,"Regular",17,"Home","Fitzroy","Melbourne",13
340,1901-08-31,"SF","Geelong",3,6,24,"Collingwood",6,9,45,"East Melbourne",-21,1901,"Finals",18,"Away","Collingwood","Geelong",21
341,1901-08-31,"SF","Essendon",6,10,46,"Fitzroy",6,9,45,"Victoria Park",1,1901,"Finals",18,"Home","Essendon","Fitzroy",1
342,1901-09-07,"GF","Essendon",6,7,43,"Collingwood",2,4,16,"Lake Oval",27,1901,"Finals",19,"Home","Essendon","Collingwood",27
343,1902-05-03,"R1","Carlton",6,4,40,"Geelong",11,12,78,"Princes Park",-38,1902,"Regular",1,"Away","Geelong","Carlton",38
344,1902-05-03,"R1","Sydney",3,7,25,"Collingwood",5,13,43,"Lake Oval",-18,1902,"Regular",1,"Away","Collingwood","Sydney",18
345,1902-05-03,"R1","Essendon",5,9,39,"Fitzroy",7,10,52,"East Melbourne",-13,1902,"Regular",1,"Away","Fitzroy","Essendon",13
346,1902-05-03,"R1","Melbourne",15,15,105,"St Kilda",7,9,51,"M.C.G.",54,1902,"Regular",1,"Home","Melbourne","St Kilda",54
347,1902-05-10,"R2","Sydney",8,13,61,"Carlton",0,8,8,"Lake Oval",53,1902,"Regular",2,"Home","Sydney","Carlton",53
348,1902-05-10,"R2","Melbourne",4,10,34,"Collingwood",8,3,51,"M.C.G.",-17,1902,"Regular",2,"Away","Collingwood","Melbourne",17
349,1902-05-10,"R2","Geelong",3,6,24,"Essendon",10,17,77,"Corio Oval",-53,1902,"Regular",2,"Away","Essendon","Geelong",53
350,1902-05-10,"R2","St Kilda",5,6,36,"Fitzroy",14,20,104,"Junction Oval",-68,1902,"Regular",2,"Away","Fitzroy","St Kilda",68
351,1902-05-17,"R3","St Kilda",2,13,25,"Carlton",4,9,33,"Junction Oval",-8,1902,"Regular",3,"Away","Carlton","St Kilda",8
352,1902-05-17,"R3","Collingwood",11,15,81,"Geelong",3,2,20,"Victoria Park",61,1902,"Regular",3,"Home","Collingwood","Geelong",61
353,1902-05-17,"R3","Essendon",7,6,48,"Melbourne",3,7,25,"East Melbourne",23,1902,"Regular",3,"Home","Essendon","Melbourne",23
354,1902-05-17,"R3","Fitzroy",8,10,58,"Sydney",8,4,52,"Brunswick St",6,1902,"Regular",3,"Home","Fitzroy","Sydney",6
355,1902-05-24,"R4","Carlton",6,13,49,"Melbourne",8,12,60,"Princes Park",-11,1902,"Regular",4,"Away","Melbourne","Carlton",11
356,1902-05-24,"R4","Collingwood",3,4,22,"Fitzroy",7,13,55,"Victoria Park",-33,1902,"Regular",4,"Away","Fitzroy","Collingwood",33
357,1902-05-24,"R4","Essendon",5,8,38,"Sydney",4,11,35,"East Melbourne",3,1902,"Regular",4,"Home","Essendon","Sydney",3
358,1902-05-24,"R4","Geelong",11,11,77,"St Kilda",5,3,33,"Corio Oval",44,1902,"Regular",4,"Home","Geelong","St Kilda",44
359,1902-05-31,"R5","Essendon",7,16,58,"Carlton",5,8,38,"East Melbourne",20,1902,"Regular",5,"Home","Essendon","Carlton",20
360,1902-05-31,"R5","St Kilda",5,5,35,"Collingwood",5,12,42,"Junction Oval",-7,1902,"Regular",5,"Away","Collingwood","St Kilda",7
361,1902-05-31,"R5","Fitzroy",7,17,59,"Melbourne",6,10,46,"Brunswick St",13,1902,"Regular",5,"Home","Fitzroy","Melbourne",13
362,1902-05-31,"R5","Geelong",5,14,44,"Sydney",3,9,27,"Corio Oval",17,1902,"Regular",5,"Home","Geelong","Sydney",17
363,1902-06-07,"R6","Carlton",4,6,30,"Fitzroy",9,14,68,"Princes Park",-38,1902,"Regular",6,"Away","Fitzroy","Carlton",38
364,1902-06-07,"R6","Collingwood",6,15,51,"Essendon",11,10,76,"Victoria Park",-25,1902,"Regular",6,"Away","Essendon","Collingwood",25
365,1902-06-07,"R6","Melbourne",2,13,25,"Geelong",3,8,26,"M.C.G.",-1,1902,"Regular",6,"Away","Geelong","Melbourne",1
366,1902-06-07,"R6","Sydney",5,13,43,"St Kilda",1,3,9,"Lake Oval",34,1902,"Regular",6,"Home","Sydney","St Kilda",34
367,1902-06-09,"R7","Collingwood",8,11,59,"Carlton",3,3,21,"Victoria Park",38,1902,"Regular",7,"Home","Collingwood","Carlton",38
368,1902-06-09,"R7","St Kilda",6,4,40,"Essendon",10,4,64,"Junction Oval",-24,1902,"Regular",7,"Away","Essendon","St Kilda",24
369,1902-06-09,"R7","Fitzroy",8,14,62,"Geelong",3,8,26,"Brunswick St",36,1902,"Regular",7,"Home","Fitzroy","Geelong",36
370,1902-06-09,"R7","Melbourne",7,5,47,"Sydney",6,10,46,"M.C.G.",1,1902,"Regular",7,"Home","Melbourne","Sydney",1
371,1902-06-14,"R8","Geelong",6,7,43,"Carlton",7,5,47,"Corio Oval",-4,1902,"Regular",8,"Away","Carlton","Geelong",4
372,1902-06-14,"R8","Collingwood",4,26,50,"Sydney",1,8,14,"Victoria Park",36,1902,"Regular",8,"Home","Collingwood","Sydney",36
373,1902-06-14,"R8","Fitzroy",5,12,42,"Essendon",7,6,48,"Brunswick St",-6,1902,"Regular",8,"Away","Essendon","Fitzroy",6
374,1902-06-14,"R8","St Kilda",3,6,24,"Melbourne",8,7,55,"Junction Oval",-31,1902,"Regular",8,"Away","Melbourne","St Kilda",31
375,1902-06-21,"R9","Carlton",4,7,31,"Sydney",2,6,18,"Princes Park",13,1902,"Regular",9,"Home","Carlton","Sydney",13
376,1902-06-21,"R9","Collingwood",7,19,61,"Melbourne",4,7,31,"Victoria Park",30,1902,"Regular",9,"Home","Collingwood","Melbourne",30
377,1902-06-21,"R9","Essendon",2,3,15,"Geelong",4,10,34,"East Melbourne",-19,1902,"Regular",9,"Away","Geelong","Essendon",19
378,1902-06-21,"R9","Fitzroy",12,8,80,"St Kilda",2,7,19,"Brunswick St",61,1902,"Regular",9,"Home","Fitzroy","St Kilda",61
379,1902-07-05,"R10","Carlton",10,12,72,"St Kilda",7,7,49,"Princes Park",23,1902,"Regular",10,"Home","Carlton","St Kilda",23
380,1902-07-05,"R10","Geelong",6,8,44,"Collingwood",12,12,84,"Corio Oval",-40,1902,"Regular",10,"Away","Collingwood","Geelong",40
381,1902-07-05,"R10","Melbourne",3,9,27,"Essendon",6,12,48,"M.C.G.",-21,1902,"Regular",10,"Away","Essendon","Melbourne",21
382,1902-07-05,"R10","Sydney",6,10,46,"Fitzroy",4,10,34,"Lake Oval",12,1902,"Regular",10,"Home","Sydney","Fitzroy",12
383,1902-07-12,"R11","Melbourne",4,12,36,"Carlton",4,9,33,"M.C.G.",3,1902,"Regular",11,"Home","Melbourne","Carlton",3
384,1902-07-12,"R11","Fitzroy",6,9,45,"Collingwood",9,14,68,"Brunswick St",-23,1902,"Regular",11,"Away","Collingwood","Fitzroy",23
385,1902-07-12,"R11","Sydney",5,6,36,"Essendon",6,7,43,"Lake Oval",-7,1902,"Regular",11,"Away","Essendon","Sydney",7
386,1902-07-12,"R11","St Kilda",4,9,33,"Geelong",7,7,49,"Junction Oval",-16,1902,"Regular",11,"Away","Geelong","St Kilda",16
387,1902-07-19,"R12","Collingwood",19,13,127,"St Kilda",1,4,10,"Victoria Park",117,1902,"Regular",12,"Home","Collingwood","St Kilda",117
388,1902-07-19,"R12","Melbourne",5,7,37,"Fitzroy",4,9,33,"M.C.G.",4,1902,"Regular",12,"Home","Melbourne","Fitzroy",4
389,1902-07-19,"R12","Sydney",7,13,55,"Geelong",6,9,45,"Lake Oval",10,1902,"Regular",12,"Home","Sydney","Geelong",10
390,1902-07-19,"R12","Carlton",4,9,33,"Essendon",1,10,16,"Princes Park",17,1902,"Regular",12,"Home","Carlton","Essendon",17
391,1902-07-26,"R13","Fitzroy",4,6,30,"Carlton",6,8,44,"Brunswick St",-14,1902,"Regular",13,"Away","Carlton","Fitzroy",14
392,1902-07-26,"R13","Essendon",5,6,36,"Collingwood",7,5,47,"East Melbourne",-11,1902,"Regular",13,"Away","Collingwood","Essendon",11
393,1902-07-26,"R13","Geelong",8,6,54,"Melbourne",3,9,27,"Corio Oval",27,1902,"Regular",13,"Home","Geelong","Melbourne",27
394,1902-07-26,"R13","St Kilda",2,10,22,"Sydney",5,7,37,"Junction Oval",-15,1902,"Regular",13,"Away","Sydney","St Kilda",15
395,1902-08-02,"R14","Carlton",2,3,15,"Collingwood",7,10,52,"Princes Park",-37,1902,"Regular",14,"Away","Collingwood","Carlton",37
396,1902-08-02,"R14","Essendon",12,12,84,"St Kilda",3,4,22,"East Melbourne",62,1902,"Regular",14,"Home","Essendon","St Kilda",62
397,1902-08-02,"R14","Geelong",5,10,40,"Fitzroy",9,7,61,"Corio Oval",-21,1902,"Regular",14,"Away","Fitzroy","Geelong",21
398,1902-08-02,"R14","Sydney",3,9,27,"Melbourne",9,9,63,"Lake Oval",-36,1902,"Regular",14,"Away","Melbourne","Sydney",36
399,1902-08-16,"R15","Melbourne",7,5,47,"Carlton",1,7,13,"M.C.G.",34,1902,"Regular",15,"Home","Melbourne","Carlton",34
400,1902-08-16,"R15","Collingwood",12,12,84,"Sydney",5,14,44,"Victoria Park",40,1902,"Regular",15,"Home","Collingwood","Sydney",40
401,1902-08-16,"R15","St Kilda",3,5,23,"Essendon",10,12,72,"Junction Oval",-49,1902,"Regular",15,"Away","Essendon","St Kilda",49
402,1902-08-16,"R15","Geelong",5,6,36,"Fitzroy",6,15,51,"Corio Oval",-15,1902,"Regular",15,"Away","Fitzroy","Geelong",15
403,1902-08-23,"R16","Carlton",6,11,47,"St Kilda",3,6,24,"Princes Park",23,1902,"Regular",16,"Home","Carlton","St Kilda",23
404,1902-08-23,"R16","Fitzroy",5,4,34,"Collingwood",13,9,87,"Brunswick St",-53,1902,"Regular",16,"Away","Collingwood","Fitzroy",53
405,1902-08-23,"R16","Essendon",11,11,77,"Melbourne",8,8,56,"East Melbourne",21,1902,"Regular",16,"Home","Essendon","Melbourne",21
406,1902-08-23,"R16","Sydney",12,12,84,"Geelong",5,9,39,"Lake Oval",45,1902,"Regular",16,"Home","Sydney","Geelong",45
407,1902-08-30,"R17","Carlton",5,10,40,"Essendon",7,4,46,"Princes Park",-6,1902,"Regular",17,"Away","Essendon","Carlton",6
408,1902-08-30,"R17","Collingwood",16,16,112,"Geelong",2,11,23,"Victoria Park",89,1902,"Regular",17,"Home","Collingwood","Geelong",89
409,1902-08-30,"R17","Fitzroy",6,10,46,"Sydney",7,8,50,"Brunswick St",-4,1902,"Regular",17,"Away","Sydney","Fitzroy",4
410,1902-08-30,"R17","Melbourne",10,19,79,"St Kilda",5,5,35,"M.C.G.",44,1902,"Regular",17,"Home","Melbourne","St Kilda",44
411,1902-09-06,"SF","Collingwood",6,12,48,"Fitzroy",9,10,64,"M.C.G.",-16,1902,"Finals",18,"Away","Fitzroy","Collingwood",16
412,1902-09-06,"SF","Essendon",9,7,61,"Melbourne",7,9,51,"Princes Park",10,1902,"Finals",18,"Home","Essendon","Melbourne",10
413,1902-09-13,"PF","Essendon",6,9,45,"Fitzroy",4,10,34,"M.C.G.",11,1902,"Finals",19,"Home","Essendon","Fitzroy",11
414,1902-09-20,"GF","Collingwood",9,6,60,"Essendon",3,9,27,"M.C.G.",33,1902,"Finals",20,"Home","Collingwood","Essendon",33
415,1903-05-02,"R1","Carlton",9,4,58,"Collingwood",5,7,37,"Princes Park",21,1903,"Regular",1,"Home","Carlton","Collingwood",21
416,1903-05-02,"R1","Essendon",3,3,21,"Fitzroy",11,7,73,"East Melbourne",-52,1903,"Regular",1,"Away","Fitzroy","Essendon",52
417,1903-05-02,"R1","St Kilda",2,8,20,"Geelong",9,18,72,"Junction Oval",-52,1903,"Regular",1,"Away","Geelong","St Kilda",52
418,1903-05-02,"R1","Sydney",6,14,50,"Melbourne",5,13,43,"Lake Oval",7,1903,"Regular",1,"Home","Sydney","Melbourne",7
419,1903-05-09,"R2","Collingwood",13,14,92,"Sydney",3,6,24,"Victoria Park",68,1903,"Regular",2,"Home","Collingwood","Sydney",68
420,1903-05-09,"R2","St Kilda",3,12,30,"Essendon",4,6,30,"Junction Oval",0,1903,"Regular",2,"Home","St Kilda","Essendon",0
421,1903-05-09,"R2","Melbourne",4,5,29,"Fitzroy",6,11,47,"M.C.G.",-18,1903,"Regular",2,"Away","Fitzroy","Melbourne",18
422,1903-05-16,"R3","Essendon",5,5,35,"Carlton",7,14,56,"East Melbourne",-21,1903,"Regular",3,"Away","Carlton","Essendon",21
423,1903-05-16,"R3","Collingwood",16,17,113,"St Kilda",5,3,33,"Victoria Park",80,1903,"Regular",3,"Home","Collingwood","St Kilda",80
424,1903-05-16,"R3","Fitzroy",12,17,89,"Sydney",3,4,22,"Brunswick St",67,1903,"Regular",3,"Home","Fitzroy","Sydney",67
425,1903-05-16,"R3","Geelong",15,10,100,"Melbourne",4,8,32,"Corio Oval",68,1903,"Regular",3,"Home","Geelong","Melbourne",68
426,1903-05-23,"R4","Carlton",12,16,88,"St Kilda",1,4,10,"Princes Park",78,1903,"Regular",4,"Home","Carlton","St Kilda",78
427,1903-05-23,"R4","Fitzroy",7,20,62,"Collingwood",6,9,45,"S.C.G.",17,1903,"Regular",4,"Home","Fitzroy","Collingwood",17
428,1903-05-23,"R4","Melbourne",3,7,25,"Essendon",4,4,28,"M.C.G.",-3,1903,"Regular",4,"Away","Essendon","Melbourne",3
429,1903-05-23,"R4","Sydney",5,7,37,"Geelong",6,11,47,"Lake Oval",-10,1903,"Regular",4,"Away","Geelong","Sydney",10
430,1903-05-30,"R5","Sydney",5,4,34,"Carlton",10,7,67,"Lake Oval",-33,1903,"Regular",5,"Away","Carlton","Sydney",33
431,1903-05-30,"R5","Collingwood",10,17,77,"Melbourne",7,4,46,"Victoria Park",31,1903,"Regular",5,"Home","Collingwood","Melbourne",31
432,1903-05-30,"R5","Essendon",10,13,73,"Geelong",5,10,40,"East Melbourne",33,1903,"Regular",5,"Home","Essendon","Geelong",33
433,1903-05-30,"R5","Fitzroy",13,17,95,"St Kilda",3,10,28,"Brunswick St",67,1903,"Regular",5,"Home","Fitzroy","St Kilda",67
434,1903-06-06,"R6","Carlton",8,8,56,"Fitzroy",4,5,29,"Princes Park",27,1903,"Regular",6,"Home","Carlton","Fitzroy",27
435,1903-06-06,"R6","Geelong",8,3,51,"Collingwood",12,12,84,"Corio Oval",-33,1903,"Regular",6,"Away","Collingwood","Geelong",33
436,1903-06-06,"R6","Essendon",5,11,41,"Sydney",6,12,48,"East Melbourne",-7,1903,"Regular",6,"Away","Sydney","Essendon",7
437,1903-06-06,"R6","St Kilda",8,9,57,"Melbourne",2,15,27,"Junction Oval",30,1903,"Regular",6,"Home","St Kilda","Melbourne",30
438,1903-06-08,"R7","Melbourne",4,8,32,"Carlton",1,2,8,"M.C.G.",24,1903,"Regular",7,"Home","Melbourne","Carlton",24
439,1903-06-08,"R7","Collingwood",4,9,33,"Essendon",2,13,25,"Victoria Park",8,1903,"Regular",7,"Home","Collingwood","Essendon",8
440,1903-06-08,"R7","Fitzroy",8,14,62,"Geelong",3,4,22,"Brunswick St",40,1903,"Regular",7,"Home","Fitzroy","Geelong",40
441,1903-06-08,"R7","Sydney",5,8,38,"St Kilda",6,11,47,"Lake Oval",-9,1903,"Regular",7,"Away","St Kilda","Sydney",9
442,1903-06-13,"R8","Collingwood",12,9,81,"Carlton",10,7,67,"Victoria Park",14,1903,"Regular",8,"Home","Collingwood","Carlton",14
443,1903-06-13,"R8","Fitzroy",8,6,54,"Essendon",3,11,29,"Brunswick St",25,1903,"Regular",8,"Home","Fitzroy","Essendon",25
444,1903-06-13,"R8","Geelong",5,9,39,"St Kilda",7,13,55,"Corio Oval",-16,1903,"Regular",8,"Away","St Kilda","Geelong",16
445,1903-06-13,"R8","Melbourne",6,6,42,"Sydney",3,17,35,"M.C.G.",7,1903,"Regular",8,"Home","Melbourne","Sydney",7
446,1903-06-20,"R9","Carlton",8,6,54,"Geelong",6,11,47,"Princes Park",7,1903,"Regular",9,"Home","Carlton","Geelong",7
447,1903-06-20,"R9","Sydney",4,11,35,"Collingwood",6,6,42,"Lake Oval",-7,1903,"Regular",9,"Away","Collingwood","Sydney",7
448,1903-06-20,"R9","Essendon",4,8,32,"St Kilda",4,5,29,"East Melbourne",3,1903,"Regular",9,"Home","Essendon","St Kilda",3
449,1903-06-20,"R9","Fitzroy",4,10,34,"Melbourne",3,8,26,"Brunswick St",8,1903,"Regular",9,"Home","Fitzroy","Melbourne",8
450,1903-07-04,"R10","Carlton",6,14,50,"Essendon",2,2,14,"Princes Park",36,1903,"Regular",10,"Home","Carlton","Essendon",36
451,1903-07-04,"R10","St Kilda",2,4,16,"Collingwood",5,11,41,"Junction Oval",-25,1903,"Regular",10,"Away","Collingwood","St Kilda",25
452,1903-07-04,"R10","Sydney",5,7,37,"Fitzroy",7,11,53,"Lake Oval",-16,1903,"Regular",10,"Away","Fitzroy","Sydney",16
453,1903-07-04,"R10","Melbourne",5,9,39,"Geelong",10,7,67,"M.C.G.",-28,1903,"Regular",10,"Away","Geelong","Melbourne",28
454,1903-07-11,"R11","St Kilda",4,3,27,"Carlton",8,14,62,"Junction Oval",-35,1903,"Regular",11,"Away","Carlton","St Kilda",35
455,1903-07-11,"R11","Collingwood",8,8,56,"Fitzroy",5,6,36,"Victoria Park",20,1903,"Regular",11,"Home","Collingwood","Fitzroy",20
456,1903-07-11,"R11","Essendon",3,16,34,"Melbourne",4,5,29,"East Melbourne",5,1903,"Regular",11,"Home","Essendon","Melbourne",5
457,1903-07-11,"R11","Geelong",9,13,67,"Sydney",3,12,30,"Corio Oval",37,1903,"Regular",11,"Home","Geelong","Sydney",37
458,1903-07-18,"R12","Carlton",7,8,50,"Sydney",2,8,20,"Princes Park",30,1903,"Regular",12,"Home","Carlton","Sydney",30
459,1903-07-18,"R12","Melbourne",4,8,32,"Collingwood",11,8,74,"M.C.G.",-42,1903,"Regular",12,"Away","Collingwood","Melbourne",42
460,1903-07-18,"R12","Geelong",13,11,89,"Essendon",6,8,44,"Corio Oval",45,1903,"Regular",12,"Home","Geelong","Essendon",45
461,1903-07-18,"R12","St Kilda",5,11,41,"Fitzroy",5,8,38,"Junction Oval",3,1903,"Regular",12,"Home","St Kilda","Fitzroy",3
462,1903-07-25,"R13","Fitzroy",8,8,56,"Carlton",3,6,24,"Brunswick St",32,1903,"Regular",13,"Home","Fitzroy","Carlton",32
463,1903-07-25,"R13","Collingwood",6,15,51,"Geelong",5,7,37,"Victoria Park",14,1903,"Regular",13,"Home","Collingwood","Geelong",14
464,1903-07-25,"R13","Sydney",5,7,37,"Essendon",7,17,59,"Lake Oval",-22,1903,"Regular",13,"Away","Essendon","Sydney",22
465,1903-07-25,"R13","Melbourne",4,8,32,"St Kilda",9,7,61,"M.C.G.",-29,1903,"Regular",13,"Away","St Kilda","Melbourne",29
466,1903-08-03,"R2","Geelong",8,7,55,"Carlton",6,9,45,"S.C.G.",10,1903,"Regular",2,"Home","Geelong","Carlton",10
467,1903-08-08,"R14","Carlton",5,11,41,"Melbourne",8,8,56,"Princes Park",-15,1903,"Regular",14,"Away","Melbourne","Carlton",15
468,1903-08-08,"R14","Essendon",7,4,46,"Collingwood",11,7,73,"East Melbourne",-27,1903,"Regular",14,"Away","Collingwood","Essendon",27
469,1903-08-08,"R14","Geelong",5,3,33,"Fitzroy",9,12,66,"Corio Oval",-33,1903,"Regular",14,"Away","Fitzroy","Geelong",33
470,1903-08-08,"R14","St Kilda",12,9,81,"Sydney",4,8,32,"Junction Oval",49,1903,"Regular",14,"Home","St Kilda","Sydney",49
471,1903-08-15,"R15","Melbourne",5,2,32,"Carlton",9,13,67,"M.C.G.",-35,1903,"Regular",15,"Away","Carlton","Melbourne",35
472,1903-08-15,"R15","Collingwood",3,12,30,"St Kilda",2,6,18,"Victoria Park",12,1903,"Regular",15,"Home","Collingwood","St Kilda",12
473,1903-08-15,"R15","Essendon",8,7,55,"Fitzroy",10,14,74,"East Melbourne",-19,1903,"Regular",15,"Away","Fitzroy","Essendon",19
474,1903-08-15,"R15","Sydney",8,8,56,"Geelong",12,14,86,"Lake Oval",-30,1903,"Regular",15,"Away","Geelong","Sydney",30
475,1903-08-22,"R16","Carlton",5,11,41,"Collingwood",6,7,43,"Princes Park",-2,1903,"Regular",16,"Away","Collingwood","Carlton",2
476,1903-08-22,"R16","Geelong",15,12,102,"Essendon",4,7,31,"Corio Oval",71,1903,"Regular",16,"Home","Geelong","Essendon",71
477,1903-08-22,"R16","Fitzroy",11,17,83,"Sydney",3,5,23,"Brunswick St",60,1903,"Regular",16,"Home","Fitzroy","Sydney",60
478,1903-08-22,"R16","St Kilda",7,12,54,"Melbourne",4,7,31,"Junction Oval",23,1903,"Regular",16,"Home","St Kilda","Melbourne",23
479,1903-08-29,"R17","St Kilda",3,10,28,"Carlton",4,7,31,"Junction Oval",-3,1903,"Regular",17,"Away","Carlton","St Kilda",3
480,1903-08-29,"R17","Collingwood",13,13,91,"Melbourne",5,10,40,"Victoria Park",51,1903,"Regular",17,"Home","Collingwood","Melbourne",51
481,1903-08-29,"R17","Essendon",14,10,94,"Sydney",5,7,37,"East Melbourne",57,1903,"Regular",17,"Home","Essendon","Sydney",57
482,1903-08-29,"R17","Geelong",3,9,27,"Fitzroy",5,4,34,"Corio Oval",-7,1903,"Regular",17,"Away","Fitzroy","Geelong",7
483,1903-09-05,"SF","Collingwood",4,3,27,"Carlton",3,5,23,"Brunswick St",4,1903,"Finals",18,"Home","Collingwood","Carlton",4
484,1903-09-05,"SF","Fitzroy",11,15,81,"Geelong",4,5,29,"M.C.G.",52,1903,"Finals",18,"Home","Fitzroy","Geelong",52
485,1903-09-12,"GF","Collingwood",4,7,31,"Fitzroy",3,11,29,"M.C.G.",2,1903,"Finals",19,"Home","Collingwood","Fitzroy",2
486,1904-05-07,"R1","Carlton",1,8,14,"Fitzroy",16,12,108,"Princes Park",-94,1904,"Regular",1,"Away","Fitzroy","Carlton",94
487,1904-05-07,"R1","Collingwood",9,15,69,"Geelong",7,9,51,"Victoria Park",18,1904,"Regular",1,"Home","Collingwood","Geelong",18
488,1904-05-07,"R1","Essendon",8,10,58,"Sydney",2,5,17,"East Melbourne",41,1904,"Regular",1,"Home","Essendon","Sydney",41
489,1904-05-07,"R1","St Kilda",12,13,85,"Melbourne",5,9,39,"Junction Oval",46,1904,"Regular",1,"Home","St Kilda","Melbourne",46
490,1904-05-14,"R2","Sydney",1,13,19,"Carlton",5,6,36,"Lake Oval",-17,1904,"Regular",2,"Away","Carlton","Sydney",17
491,1904-05-14,"R2","Melbourne",7,7,49,"Collingwood",7,13,55,"M.C.G.",-6,1904,"Regular",2,"Away","Collingwood","Melbourne",6
492,1904-05-14,"R2","Geelong",10,7,67,"Essendon",5,13,43,"Corio Oval",24,1904,"Regular",2,"Home","Geelong","Essendon",24
493,1904-05-14,"R2","Fitzroy",11,17,83,"St Kilda",5,3,33,"Brunswick St",50,1904,"Regular",2,"Home","Fitzroy","St Kilda",50
494,1904-05-21,"R3","Carlton",8,17,65,"Geelong",4,8,32,"Princes Park",33,1904,"Regular",3,"Home","Carlton","Geelong",33
495,1904-05-21,"R3","Collingwood",4,5,29,"Sydney",7,13,55,"Victoria Park",-26,1904,"Regular",3,"Away","Sydney","Collingwood",26
496,1904-05-21,"R3","St Kilda",5,3,33,"Essendon",10,9,69,"Junction Oval",-36,1904,"Regular",3,"Away","Essendon","St Kilda",36
497,1904-05-21,"R3","Melbourne",3,5,23,"Fitzroy",14,15,99,"M.C.G.",-76,1904,"Regular",3,"Away","Fitzroy","Melbourne",76
498,1904-05-28,"R4","St Kilda",4,7,31,"Carlton",6,4,40,"Junction Oval",-9,1904,"Regular",4,"Away","Carlton","St Kilda",9
499,1904-05-28,"R4","Fitzroy",4,9,33,"Collingwood",6,6,42,"Brunswick St",-9,1904,"Regular",4,"Away","Collingwood","Fitzroy",9
500,1904-05-28,"R4","Essendon",6,3,39,"Melbourne",9,17,71,"S.C.G.",-32,1904,"Regular",4,"Away","Melbourne","Essendon",32
501,1904-05-28,"R4","Geelong",6,4,40,"Sydney",6,16,52,"Corio Oval",-12,1904,"Regular",4,"Away","Sydney","Geelong",12
502,1904-06-04,"R5","Collingwood",6,12,48,"Carlton",8,5,53,"Victoria Park",-5,1904,"Regular",5,"Away","Carlton","Collingwood",5
503,1904-06-04,"R5","Essendon",6,5,41,"Fitzroy",11,17,83,"East Melbourne",-42,1904,"Regular",5,"Away","Fitzroy","Essendon",42
504,1904-06-04,"R5","Geelong",6,13,49,"St Kilda",4,10,34,"Corio Oval",15,1904,"Regular",5,"Home","Geelong","St Kilda",15
505,1904-06-04,"R5","Sydney",8,16,64,"Melbourne",5,9,39,"Lake Oval",25,1904,"Regular",5,"Home","Sydney","Melbourne",25
506,1904-06-06,"R6","Melbourne",8,10,58,"Carlton",5,5,35,"M.C.G.",23,1904,"Regular",6,"Home","Melbourne","Carlton",23
507,1904-06-06,"R6","Essendon",6,5,41,"Collingwood",6,7,43,"East Melbourne",-2,1904,"Regular",6,"Away","Collingwood","Essendon",2
508,1904-06-06,"R6","Fitzroy",12,6,78,"Geelong",6,18,54,"Brunswick St",24,1904,"Regular",6,"Home","Fitzroy","Geelong",24
509,1904-06-06,"R6","Sydney",15,10,100,"St Kilda",9,4,58,"Lake Oval",42,1904,"Regular",6,"Home","Sydney","St Kilda",42
510,1904-06-11,"R7","Carlton",7,5,47,"Essendon",7,11,53,"Princes Park",-6,1904,"Regular",7,"Away","Essendon","Carlton",6
511,1904-06-11,"R7","St Kilda",7,7,49,"Collingwood",4,10,34,"Junction Oval",15,1904,"Regular",7,"Home","St Kilda","Collingwood",15
512,1904-06-11,"R7","Fitzroy",6,9,45,"Sydney",5,14,44,"Brunswick St",1,1904,"Regular",7,"Home","Fitzroy","Sydney",1
513,1904-06-11,"R7","Geelong",9,12,66,"Melbourne",15,7,97,"Corio Oval",-31,1904,"Regular",7,"Away","Melbourne","Geelong",31
514,1904-06-25,"R8","Fitzroy",8,8,56,"Carlton",7,10,52,"Brunswick St",4,1904,"Regular",8,"Home","Fitzroy","Carlton",4
515,1904-06-25,"R8","Geelong",4,10,34,"Collingwood",8,10,58,"Corio Oval",-24,1904,"Regular",8,"Away","Collingwood","Geelong",24
516,1904-06-25,"R8","Sydney",10,9,69,"Essendon",4,5,29,"Lake Oval",40,1904,"Regular",8,"Home","Sydney","Essendon",40
517,1904-06-25,"R8","Melbourne",13,13,91,"St Kilda",4,2,26,"M.C.G.",65,1904,"Regular",8,"Home","Melbourne","St Kilda",65
518,1904-07-02,"R9","Carlton",9,7,61,"Sydney",5,7,37,"Princes Park",24,1904,"Regular",9,"Home","Carlton","Sydney",24
519,1904-07-02,"R9","Collingwood",4,5,29,"Melbourne",8,6,54,"Victoria Park",-25,1904,"Regular",9,"Away","Melbourne","Collingwood",25
520,1904-07-02,"R9","Essendon",9,12,66,"Geelong",4,4,28,"East Melbourne",38,1904,"Regular",9,"Home","Essendon","Geelong",38
521,1904-07-02,"R9","St Kilda",11,12,78,"Fitzroy",4,7,31,"Junction Oval",47,1904,"Regular",9,"Home","St Kilda","Fitzroy",47
522,1904-07-09,"R10","Geelong",4,11,35,"Carlton",5,5,35,"Corio Oval",0,1904,"Regular",10,"Home","Geelong","Carlton",0
523,1904-07-09,"R10","Sydney",5,15,45,"Collingwood",6,6,42,"Lake Oval",3,1904,"Regular",10,"Home","Sydney","Collingwood",3
524,1904-07-09,"R10","Essendon",6,8,44,"St Kilda",6,3,39,"East Melbourne",5,1904,"Regular",10,"Home","Essendon","St Kilda",5
525,1904-07-09,"R10","Fitzroy",8,10,58,"Melbourne",5,13,43,"Brunswick St",15,1904,"Regular",10,"Home","Fitzroy","Melbourne",15
526,1904-07-16,"R11","Carlton",9,7,61,"St Kilda",4,1,25,"Princes Park",36,1904,"Regular",11,"Home","Carlton","St Kilda",36
527,1904-07-16,"R11","Collingwood",7,13,55,"Fitzroy",3,6,24,"Victoria Park",31,1904,"Regular",11,"Home","Collingwood","Fitzroy",31
528,1904-07-16,"R11","Melbourne",3,12,30,"Essendon",4,11,35,"M.C.G.",-5,1904,"Regular",11,"Away","Essendon","Melbourne",5
529,1904-07-16,"R11","Sydney",6,5,41,"Geelong",4,15,39,"Lake Oval",2,1904,"Regular",11,"Home","Sydney","Geelong",2
530,1904-07-23,"R12","Carlton",6,10,46,"Collingwood",6,4,40,"Princes Park",6,1904,"Regular",12,"Home","Carlton","Collingwood",6
531,1904-07-23,"R12","Fitzroy",6,8,44,"Essendon",3,9,27,"Brunswick St",17,1904,"Regular",12,"Home","Fitzroy","Essendon",17
532,1904-07-23,"R12","St Kilda",5,5,35,"Geelong",7,16,58,"Junction Oval",-23,1904,"Regular",12,"Away","Geelong","St Kilda",23
533,1904-07-23,"R12","Melbourne",9,13,67,"Sydney",11,7,73,"M.C.G.",-6,1904,"Regular",12,"Away","Sydney","Melbourne",6
534,1904-07-30,"R13","Carlton",6,14,50,"Melbourne",4,10,34,"Princes Park",16,1904,"Regular",13,"Home","Carlton","Melbourne",16
535,1904-07-30,"R13","Collingwood",5,6,36,"Essendon",7,10,52,"Victoria Park",-16,1904,"Regular",13,"Away","Essendon","Collingwood",16
536,1904-07-30,"R13","Geelong",5,12,42,"Fitzroy",4,13,37,"Corio Oval",5,1904,"Regular",13,"Home","Geelong","Fitzroy",5
537,1904-07-30,"R13","St Kilda",6,10,46,"Sydney",10,5,65,"Junction Oval",-19,1904,"Regular",13,"Away","Sydney","St Kilda",19
538,1904-08-13,"R14","Essendon",5,5,35,"Carlton",5,9,39,"East Melbourne",-4,1904,"Regular",14,"Away","Carlton","Essendon",4
539,1904-08-13,"R14","Collingwood",14,12,96,"St Kilda",6,10,46,"Victoria Park",50,1904,"Regular",14,"Home","Collingwood","St Kilda",50
540,1904-08-13,"R14","Sydney",5,16,46,"Fitzroy",8,10,58,"Lake Oval",-12,1904,"Regular",14,"Away","Fitzroy","Sydney",12
541,1904-08-13,"R14","Melbourne",11,10,76,"Geelong",6,4,40,"M.C.G.",36,1904,"Regular",14,"Home","Melbourne","Geelong",36
542,1904-08-20,"R15","Collingwood",8,11,59,"Carlton",7,7,49,"Victoria Park",10,1904,"Regular",15,"Home","Collingwood","Carlton",10
543,1904-08-20,"R15","Essendon",8,9,57,"Geelong",5,9,39,"East Melbourne",18,1904,"Regular",15,"Home","Essendon","Geelong",18
544,1904-08-20,"R15","Fitzroy",4,14,38,"Sydney",3,15,33,"Brunswick St",5,1904,"Regular",15,"Home","Fitzroy","Sydney",5
545,1904-08-20,"R15","Melbourne",13,15,93,"St Kilda",3,3,21,"M.C.G.",72,1904,"Regular",15,"Home","Melbourne","St Kilda",72
546,1904-08-27,"R16","Carlton",1,8,14,"Melbourne",5,13,43,"Princes Park",-29,1904,"Regular",16,"Away","Melbourne","Carlton",29
547,1904-08-27,"R16","St Kilda",2,8,20,"Collingwood",12,9,81,"Junction Oval",-61,1904,"Regular",16,"Away","Collingwood","St Kilda",61
548,1904-08-27,"R16","Sydney",4,3,27,"Essendon",8,11,59,"Lake Oval",-32,1904,"Regular",16,"Away","Essendon","Sydney",32
549,1904-08-27,"R16","Geelong",4,6,30,"Fitzroy",8,5,53,"Corio Oval",-23,1904,"Regular",16,"Away","Fitzroy","Geelong",23
550,1904-09-03,"R17","Carlton",16,11,107,"St Kilda",7,7,49,"Princes Park",58,1904,"Regular",17,"Home","Carlton","St Kilda",58
551,1904-09-03,"R17","Melbourne",5,10,40,"Collingwood",7,9,51,"M.C.G.",-11,1904,"Regular",17,"Away","Collingwood","Melbourne",11
552,1904-09-03,"R17","Essendon",13,9,87,"Fitzroy",4,2,26,"East Melbourne",61,1904,"Regular",17,"Home","Essendon","Fitzroy",61
553,1904-09-03,"R17","Geelong",3,4,22,"Sydney",6,8,44,"Corio Oval",-22,1904,"Regular",17,"Away","Sydney","Geelong",22
554,1904-09-10,"SF","Carlton",6,7,43,"Essendon",6,4,40,"Victoria Park",3,1904,"Finals",18,"Home","Carlton","Essendon",3
555,1904-09-10,"SF","Fitzroy",9,7,61,"Collingwood",7,8,50,"M.C.G.",11,1904,"Finals",18,"Home","Fitzroy","Collingwood",11
556,1904-09-17,"GF","Fitzroy",9,7,61,"Carlton",5,7,37,"M.C.G.",24,1904,"Finals",19,"Home","Fitzroy","Carlton",24
557,1905-05-06,"R1","Carlton",8,12,60,"Essendon",7,10,52,"Princes Park",8,1905,"Regular",1,"Home","Carlton","Essendon",8
558,1905-05-06,"R1","Fitzroy",4,10,34,"Collingwood",3,13,31,"Brunswick St",3,1905,"Regular",1,"Home","Fitzroy","Collingwood",3
559,1905-05-06,"R1","Geelong",5,9,39,"Sydney",8,14,62,"Corio Oval",-23,1905,"Regular",1,"Away","Sydney","Geelong",23
560,1905-05-06,"R1","Melbourne",9,8,62,"St Kilda",6,10,46,"M.C.G.",16,1905,"Regular",1,"Home","Melbourne","St Kilda",16
561,1905-05-13,"R2","Collingwood",10,10,70,"Carlton",4,14,38,"Victoria Park",32,1905,"Regular",2,"Home","Collingwood","Carlton",32
562,1905-05-13,"R2","Essendon",12,10,82,"Geelong",7,6,48,"East Melbourne",34,1905,"Regular",2,"Home","Essendon","Geelong",34
563,1905-05-13,"R2","St Kilda",4,9,33,"Fitzroy",9,10,64,"Junction Oval",-31,1905,"Regular",2,"Away","Fitzroy","St Kilda",31
564,1905-05-13,"R2","Sydney",11,7,73,"Melbourne",10,7,67,"Lake Oval",6,1905,"Regular",2,"Home","Sydney","Melbourne",6
565,1905-05-20,"R3","Sydney",5,15,45,"Carlton",7,13,55,"Lake Oval",-10,1905,"Regular",3,"Away","Carlton","Sydney",10
566,1905-05-20,"R3","St Kilda",10,10,70,"Collingwood",18,10,118,"Junction Oval",-48,1905,"Regular",3,"Away","Collingwood","St Kilda",48
567,1905-05-20,"R3","Melbourne",8,14,62,"Essendon",5,9,39,"M.C.G.",23,1905,"Regular",3,"Home","Melbourne","Essendon",23
568,1905-05-20,"R3","Fitzroy",10,16,76,"Geelong",4,11,35,"Brunswick St",41,1905,"Regular",3,"Home","Fitzroy","Geelong",41
569,1905-05-27,"R4","Carlton",5,7,37,"Fitzroy",10,13,73,"Princes Park",-36,1905,"Regular",4,"Away","Fitzroy","Carlton",36
570,1905-05-27,"R4","Collingwood",5,16,46,"Melbourne",4,7,31,"Victoria Park",15,1905,"Regular",4,"Home","Collingwood","Melbourne",15
571,1905-05-27,"R4","Essendon",14,11,95,"Sydney",5,9,39,"East Melbourne",56,1905,"Regular",4,"Home","Essendon","Sydney",56
572,1905-05-27,"R4","Geelong",5,13,43,"St Kilda",7,4,46,"Corio Oval",-3,1905,"Regular",4,"Away","St Kilda","Geelong",3
573,1905-06-03,"R5","Collingwood",12,9,81,"Sydney",2,10,22,"Victoria Park",59,1905,"Regular",5,"Home","Collingwood","Sydney",59
574,1905-06-03,"R5","Melbourne",3,12,30,"Fitzroy",5,8,38,"M.C.G.",-8,1905,"Regular",5,"Away","Fitzroy","Melbourne",8
575,1905-06-05,"R5","Carlton",5,10,40,"Geelong",4,4,28,"Princes Park",12,1905,"Regular",5,"Home","Carlton","Geelong",12
576,1905-06-05,"R5","St Kilda",5,9,39,"Essendon",7,12,54,"Junction Oval",-15,1905,"Regular",5,"Away","Essendon","St Kilda",15
577,1905-06-10,"R6","Melbourne",5,8,38,"Carlton",6,5,41,"M.C.G.",-3,1905,"Regular",6,"Away","Carlton","Melbourne",3
578,1905-06-10,"R6","Geelong",4,3,27,"Collingwood",6,10,46,"Corio Oval",-19,1905,"Regular",6,"Away","Collingwood","Geelong",19
579,1905-06-10,"R6","Fitzroy",5,5,35,"Essendon",3,10,28,"Brunswick St",7,1905,"Regular",6,"Home","Fitzroy","Essendon",7
580,1905-06-10,"R6","Sydney",6,11,47,"St Kilda",3,6,24,"Lake Oval",23,1905,"Regular",6,"Home","Sydney","St Kilda",23
581,1905-06-17,"R7","St Kilda",3,7,25,"Carlton",8,15,63,"Junction Oval",-38,1905,"Regular",7,"Away","Carlton","St Kilda",38
582,1905-06-17,"R7","Essendon",6,7,43,"Collingwood",10,12,72,"East Melbourne",-29,1905,"Regular",7,"Away","Collingwood","Essendon",29
583,1905-06-17,"R7","Fitzroy",9,14,68,"Sydney",6,6,42,"Brunswick St",26,1905,"Regular",7,"Home","Fitzroy","Sydney",26
584,1905-06-17,"R7","Geelong",7,14,56,"Melbourne",7,12,54,"Corio Oval",2,1905,"Regular",7,"Home","Geelong","Melbourne",2
585,1905-07-01,"R8","Essendon",7,20,62,"Carlton",8,12,60,"East Melbourne",2,1905,"Regular",8,"Home","Essendon","Carlton",2
586,1905-07-01,"R8","Collingwood",5,11,41,"Fitzroy",3,1,19,"Victoria Park",22,1905,"Regular",8,"Home","Collingwood","Fitzroy",22
587,1905-07-01,"R8","Sydney",4,5,29,"Geelong",6,7,43,"Lake Oval",-14,1905,"Regular",8,"Away","Geelong","Sydney",14
588,1905-07-01,"R8","St Kilda",8,6,54,"Melbourne",7,9,51,"Junction Oval",3,1905,"Regular",8,"Home","St Kilda","Melbourne",3
589,1905-07-08,"R9","Carlton",6,8,44,"Collingwood",8,11,59,"Princes Park",-15,1905,"Regular",9,"Away","Collingwood","Carlton",15
590,1905-07-08,"R9","Geelong",9,8,62,"Essendon",6,12,48,"Corio Oval",14,1905,"Regular",9,"Home","Geelong","Essendon",14
591,1905-07-08,"R9","Fitzroy",14,7,91,"St Kilda",6,4,40,"Brunswick St",51,1905,"Regular",9,"Home","Fitzroy","St Kilda",51
592,1905-07-08,"R9","Melbourne",3,8,26,"Sydney",8,10,58,"M.C.G.",-32,1905,"Regular",9,"Away","Sydney","Melbourne",32
593,1905-07-15,"R10","Carlton",7,16,58,"Sydney",8,13,61,"Princes Park",-3,1905,"Regular",10,"Away","Sydney","Carlton",3
594,1905-07-15,"R10","Collingwood",13,19,97,"St Kilda",3,9,27,"Victoria Park",70,1905,"Regular",10,"Home","Collingwood","St Kilda",70
595,1905-07-15,"R10","Essendon",8,17,65,"Melbourne",5,11,41,"East Melbourne",24,1905,"Regular",10,"Home","Essendon","Melbourne",24
596,1905-07-15,"R10","Geelong",9,8,62,"Fitzroy",2,15,27,"Corio Oval",35,1905,"Regular",10,"Home","Geelong","Fitzroy",35
597,1905-07-22,"R11","Fitzroy",5,9,39,"Carlton",6,5,41,"Brunswick St",-2,1905,"Regular",11,"Away","Carlton","Fitzroy",2
598,1905-07-22,"R11","Melbourne",6,5,41,"Collingwood",9,20,74,"M.C.G.",-33,1905,"Regular",11,"Away","Collingwood","Melbourne",33
599,1905-07-22,"R11","Sydney",7,8,50,"Essendon",6,13,49,"Lake Oval",1,1905,"Regular",11,"Home","Sydney","Essendon",1
600,1905-07-22,"R11","St Kilda",3,5,23,"Geelong",6,12,48,"Junction Oval",-25,1905,"Regular",11,"Away","Geelong","St Kilda",25
601,1905-07-29,"R12","Geelong",6,5,41,"Carlton",6,11,47,"Corio Oval",-6,1905,"Regular",12,"Away","Carlton","Geelong",6
602,1905-07-29,"R12","Sydney",3,3,21,"Collingwood",4,5,29,"Lake Oval",-8,1905,"Regular",12,"Away","Collingwood","Sydney",8
603,1905-07-29,"R12","Essendon",9,16,70,"St Kilda",3,9,27,"East Melbourne",43,1905,"Regular",12,"Home","Essendon","St Kilda",43
604,1905-07-29,"R12","Fitzroy",5,7,37,"Melbourne",2,6,18,"Brunswick St",19,1905,"Regular",12,"Home","Fitzroy","Melbourne",19
605,1905-08-05,"R13","Carlton",12,10,82,"Melbourne",2,8,20,"Princes Park",62,1905,"Regular",13,"Home","Carlton","Melbourne",62
606,1905-08-05,"R13","Collingwood",7,8,50,"Geelong",4,12,36,"Victoria Park",14,1905,"Regular",13,"Home","Collingwood","Geelong",14
607,1905-08-05,"R13","Essendon",3,11,29,"Fitzroy",5,12,42,"East Melbourne",-13,1905,"Regular",13,"Away","Fitzroy","Essendon",13
608,1905-08-05,"R13","St Kilda",5,11,41,"Sydney",5,9,39,"Junction Oval",2,1905,"Regular",13,"Home","St Kilda","Sydney",2
609,1905-08-19,"R14","Carlton",9,19,73,"St Kilda",3,5,23,"Princes Park",50,1905,"Regular",14,"Home","Carlton","St Kilda",50
610,1905-08-19,"R14","Collingwood",7,11,53,"Essendon",10,6,66,"Victoria Park",-13,1905,"Regular",14,"Away","Essendon","Collingwood",13
611,1905-08-19,"R14","Sydney",7,8,50,"Fitzroy",7,8,50,"Lake Oval",0,1905,"Regular",14,"Home","Sydney","Fitzroy",0
612,1905-08-19,"R14","Melbourne",13,12,90,"Geelong",7,13,55,"M.C.G.",35,1905,"Regular",14,"Home","Melbourne","Geelong",35
613,1905-08-26,"R15","Collingwood",9,12,66,"Carlton",6,13,49,"Victoria Park",17,1905,"Regular",15,"Home","Collingwood","Carlton",17
614,1905-08-26,"R15","Essendon",10,13,73,"Geelong",3,11,29,"East Melbourne",44,1905,"Regular",15,"Home","Essendon","Geelong",44
615,1905-08-26,"R15","Fitzroy",6,9,45,"St Kilda",4,7,31,"Brunswick St",14,1905,"Regular",15,"Home","Fitzroy","St Kilda",14
616,1905-08-26,"R15","Sydney",13,11,89,"Melbourne",5,10,40,"Lake Oval",49,1905,"Regular",15,"Home","Sydney","Melbourne",49
617,1905-09-02,"R16","Carlton",12,20,92,"Sydney",7,7,49,"Princes Park",43,1905,"Regular",16,"Home","Carlton","Sydney",43
618,1905-09-02,"R16","Melbourne",3,9,27,"Collingwood",7,18,60,"M.C.G.",-33,1905,"Regular",16,"Away","Collingwood","Melbourne",33
619,1905-09-02,"R16","St Kilda",8,6,54,"Essendon",12,12,84,"Junction Oval",-30,1905,"Regular",16,"Away","Essendon","St Kilda",30
620,1905-09-02,"R16","Geelong",10,8,68,"Fitzroy",9,12,66,"Corio Oval",2,1905,"Regular",16,"Home","Geelong","Fitzroy",2
621,1905-09-09,"R17","Melbourne",5,8,38,"Carlton",18,17,125,"M.C.G.",-87,1905,"Regular",17,"Away","Carlton","Melbourne",87
622,1905-09-09,"R17","Collingwood",17,16,118,"Sydney",5,10,40,"Victoria Park",78,1905,"Regular",17,"Home","Collingwood","Sydney",78
623,1905-09-09,"R17","Essendon",4,13,37,"Fitzroy",11,14,80,"East Melbourne",-43,1905,"Regular",17,"Away","Fitzroy","Essendon",43
624,1905-09-09,"R17","St Kilda",12,15,87,"Geelong",3,9,27,"Junction Oval",60,1905,"Regular",17,"Home","St Kilda","Geelong",60
625,1905-09-16,"SF","Collingwood",4,6,30,"Carlton",11,10,76,"M.C.G.",-46,1905,"Finals",18,"Away","Carlton","Collingwood",46
626,1905-09-16,"SF","Fitzroy",12,7,79,"Essendon",4,12,36,"Princes Park",43,1905,"Finals",18,"Home","Fitzroy","Essendon",43
627,1905-09-23,"PF","Fitzroy",11,6,72,"Carlton",6,9,45,"M.C.G.",27,1905,"Finals",19,"Home","Fitzroy","Carlton",27
628,1905-09-30,"GF","Collingwood",2,5,17,"Fitzroy",4,6,30,"M.C.G.",-13,1905,"Finals",20,"Away","Fitzroy","Collingwood",13
629,1906-05-05,"R1","Carlton",12,11,83,"Melbourne",8,8,56,"Princes Park",27,1906,"Regular",1,"Home","Carlton","Melbourne",27
630,1906-05-05,"R1","Collingwood",12,19,91,"Geelong",5,7,37,"Victoria Park",54,1906,"Regular",1,"Home","Collingwood","Geelong",54
631,1906-05-05,"R1","Essendon",8,12,60,"Sydney",9,13,67,"East Melbourne",-7,1906,"Regular",1,"Away","Sydney","Essendon",7
632,1906-05-05,"R1","Fitzroy",8,20,68,"St Kilda",1,8,14,"Brunswick St",54,1906,"Regular",1,"Home","Fitzroy","St Kilda",54
633,1906-05-12,"R2","St Kilda",5,5,35,"Carlton",15,10,100,"Junction Oval",-65,1906,"Regular",2,"Away","Carlton","St Kilda",65
634,1906-05-12,"R2","Sydney",12,5,77,"Collingwood",8,9,57,"Lake Oval",20,1906,"Regular",2,"Home","Sydney","Collingwood",20
635,1906-05-12,"R2","Geelong",5,12,42,"Essendon",11,14,80,"Corio Oval",-38,1906,"Regular",2,"Away","Essendon","Geelong",38
636,1906-05-12,"R2","Melbourne",8,5,53,"Fitzroy",10,13,73,"M.C.G.",-20,1906,"Regular",2,"Away","Fitzroy","Melbourne",20
637,1906-05-19,"R3","Carlton",16,10,106,"Geelong",6,7,43,"Princes Park",63,1906,"Regular",3,"Home","Carlton","Geelong",63
638,1906-05-19,"R3","Fitzroy",7,7,49,"Collingwood",14,8,92,"Brunswick St",-43,1906,"Regular",3,"Away","Collingwood","Fitzroy",43
639,1906-05-19,"R3","Essendon",10,16,76,"Melbourne",6,6,42,"East Melbourne",34,1906,"Regular",3,"Home","Essendon","Melbourne",34
640,1906-05-19,"R3","Sydney",10,14,74,"St Kilda",9,7,61,"Lake Oval",13,1906,"Regular",3,"Home","Sydney","St Kilda",13
641,1906-05-26,"R4","Collingwood",4,13,37,"Carlton",8,9,57,"Victoria Park",-20,1906,"Regular",4,"Away","Carlton","Collingwood",20
642,1906-05-26,"R4","St Kilda",6,8,44,"Essendon",1,7,13,"Junction Oval",31,1906,"Regular",4,"Home","St Kilda","Essendon",31
643,1906-05-26,"R4","Geelong",4,7,31,"Fitzroy",8,9,57,"Corio Oval",-26,1906,"Regular",4,"Away","Fitzroy","Geelong",26
644,1906-05-26,"R4","Melbourne",5,9,39,"Sydney",5,4,34,"M.C.G.",5,1906,"Regular",4,"Home","Melbourne","Sydney",5
645,1906-06-02,"R5","St Kilda",4,7,31,"Collingwood",13,11,89,"Junction Oval",-58,1906,"Regular",5,"Away","Collingwood","St Kilda",58
646,1906-06-02,"R5","Essendon",6,15,51,"Fitzroy",6,10,46,"East Melbourne",5,1906,"Regular",5,"Home","Essendon","Fitzroy",5
647,1906-06-04,"R5","Carlton",10,9,69,"Sydney",10,5,65,"Princes Park",4,1906,"Regular",5,"Home","Carlton","Sydney",4
648,1906-06-04,"R5","Melbourne",8,8,56,"Geelong",11,9,75,"M.C.G.",-19,1906,"Regular",5,"Away","Geelong","Melbourne",19
649,1906-06-09,"R6","Fitzroy",6,8,44,"Carlton",7,14,56,"Brunswick St",-12,1906,"Regular",6,"Away","Carlton","Fitzroy",12
650,1906-06-09,"R6","Essendon",9,12,66,"Collingwood",6,13,49,"East Melbourne",17,1906,"Regular",6,"Home","Essendon","Collingwood",17
651,1906-06-09,"R6","Geelong",8,13,61,"Sydney",3,13,31,"Corio Oval",30,1906,"Regular",6,"Home","Geelong","Sydney",30
652,1906-06-09,"R6","St Kilda",13,16,94,"Melbourne",6,9,45,"Junction Oval",49,1906,"Regular",6,"Home","St Kilda","Melbourne",49
653,1906-06-16,"R7","Carlton",4,15,39,"Essendon",10,14,74,"Princes Park",-35,1906,"Regular",7,"Away","Essendon","Carlton",35
654,1906-06-16,"R7","Collingwood",13,12,90,"Melbourne",6,10,46,"Victoria Park",44,1906,"Regular",7,"Home","Collingwood","Melbourne",44
655,1906-06-16,"R7","Sydney",5,10,40,"Fitzroy",9,8,62,"Lake Oval",-22,1906,"Regular",7,"Away","Fitzroy","Sydney",22
656,1906-06-16,"R7","Geelong",6,5,41,"St Kilda",4,13,37,"Corio Oval",4,1906,"Regular",7,"Home","Geelong","St Kilda",4
657,1906-06-30,"R8","Melbourne",3,7,25,"Carlton",9,16,70,"M.C.G.",-45,1906,"Regular",8,"Away","Carlton","Melbourne",45
658,1906-06-30,"R8","Geelong",9,7,61,"Collingwood",11,9,75,"Corio Oval",-14,1906,"Regular",8,"Away","Collingwood","Geelong",14
659,1906-06-30,"R8","Sydney",3,8,26,"Essendon",8,11,59,"Lake Oval",-33,1906,"Regular",8,"Away","Essendon","Sydney",33
660,1906-06-30,"R8","St Kilda",2,8,20,"Fitzroy",3,7,25,"Junction Oval",-5,1906,"Regular",8,"Away","Fitzroy","St Kilda",5
661,1906-07-07,"R9","Carlton",6,13,49,"St Kilda",3,7,25,"Princes Park",24,1906,"Regular",9,"Home","Carlton","St Kilda",24
662,1906-07-07,"R9","Collingwood",14,14,98,"Sydney",5,8,38,"Victoria Park",60,1906,"Regular",9,"Home","Collingwood","Sydney",60
663,1906-07-07,"R9","Essendon",16,16,112,"Geelong",5,11,41,"East Melbourne",71,1906,"Regular",9,"Home","Essendon","Geelong",71
664,1906-07-07,"R9","Fitzroy",11,25,91,"Melbourne",5,9,39,"Brunswick St",52,1906,"Regular",9,"Home","Fitzroy","Melbourne",52
665,1906-07-14,"R10","Geelong",5,6,36,"Carlton",8,15,63,"Corio Oval",-27,1906,"Regular",10,"Away","Carlton","Geelong",27
666,1906-07-14,"R10","Collingwood",6,8,44,"Fitzroy",13,10,88,"Victoria Park",-44,1906,"Regular",10,"Away","Fitzroy","Collingwood",44
667,1906-07-14,"R10","Melbourne",4,5,29,"Essendon",13,17,95,"M.C.G.",-66,1906,"Regular",10,"Away","Essendon","Melbourne",66
668,1906-07-14,"R10","St Kilda",4,11,35,"Sydney",4,4,28,"Junction Oval",7,1906,"Regular",10,"Home","St Kilda","Sydney",7
669,1906-07-21,"R11","Carlton",11,14,80,"Collingwood",6,7,43,"Princes Park",37,1906,"Regular",11,"Home","Carlton","Collingwood",37
670,1906-07-21,"R11","Essendon",4,11,35,"St Kilda",4,9,33,"East Melbourne",2,1906,"Regular",11,"Home","Essendon","St Kilda",2
671,1906-07-21,"R11","Fitzroy",9,13,67,"Geelong",5,7,37,"Brunswick St",30,1906,"Regular",11,"Home","Fitzroy","Geelong",30
672,1906-07-21,"R11","Sydney",12,11,83,"Melbourne",4,3,27,"Lake Oval",56,1906,"Regular",11,"Home","Sydney","Melbourne",56
673,1906-07-28,"R12","Sydney",12,12,84,"Carlton",7,3,45,"Lake Oval",39,1906,"Regular",12,"Home","Sydney","Carlton",39
674,1906-07-28,"R12","Collingwood",11,16,82,"St Kilda",2,8,20,"Victoria Park",62,1906,"Regular",12,"Home","Collingwood","St Kilda",62
675,1906-07-28,"R12","Fitzroy",4,6,30,"Essendon",5,8,38,"Brunswick St",-8,1906,"Regular",12,"Away","Essendon","Fitzroy",8
676,1906-07-28,"R12","Geelong",6,21,57,"Melbourne",6,10,46,"Corio Oval",11,1906,"Regular",12,"Home","Geelong","Melbourne",11
677,1906-08-04,"R13","Collingwood",9,15,69,"Essendon",5,7,37,"Victoria Park",32,1906,"Regular",13,"Home","Collingwood","Essendon",32
678,1906-08-04,"R13","Sydney",14,17,101,"Geelong",5,8,38,"Lake Oval",63,1906,"Regular",13,"Home","Sydney","Geelong",63
679,1906-08-11,"R13","Carlton",5,3,33,"Fitzroy",4,14,38,"Princes Park",-5,1906,"Regular",13,"Away","Fitzroy","Carlton",5
680,1906-08-11,"R13","Melbourne",5,10,40,"St Kilda",10,13,73,"M.C.G.",-33,1906,"Regular",13,"Away","St Kilda","Melbourne",33
681,1906-08-18,"R14","Essendon",4,12,36,"Carlton",10,12,72,"East Melbourne",-36,1906,"Regular",14,"Away","Carlton","Essendon",36
682,1906-08-18,"R14","Melbourne",6,5,41,"Collingwood",15,14,104,"M.C.G.",-63,1906,"Regular",14,"Away","Collingwood","Melbourne",63
683,1906-08-18,"R14","Fitzroy",13,11,89,"Sydney",5,12,42,"Brunswick St",47,1906,"Regular",14,"Home","Fitzroy","Sydney",47
684,1906-08-18,"R14","St Kilda",10,21,81,"Geelong",3,13,31,"Junction Oval",50,1906,"Regular",14,"Home","St Kilda","Geelong",50
685,1906-08-25,"R15","Carlton",10,12,72,"Essendon",8,6,54,"Princes Park",18,1906,"Regular",15,"Home","Carlton","Essendon",18
686,1906-08-25,"R15","Collingwood",11,12,78,"St Kilda",7,19,61,"Victoria Park",17,1906,"Regular",15,"Home","Collingwood","St Kilda",17
687,1906-08-25,"R15","Melbourne",2,1,13,"Fitzroy",17,18,120,"M.C.G.",-107,1906,"Regular",15,"Away","Fitzroy","Melbourne",107
688,1906-08-25,"R15","Sydney",10,10,70,"Geelong",7,7,49,"Lake Oval",21,1906,"Regular",15,"Home","Sydney","Geelong",21
689,1906-09-01,"R16","Geelong",4,5,29,"Carlton",13,13,91,"Corio Oval",-62,1906,"Regular",16,"Away","Carlton","Geelong",62
690,1906-09-01,"R16","Fitzroy",5,8,38,"Collingwood",3,9,27,"Brunswick St",11,1906,"Regular",16,"Home","Fitzroy","Collingwood",11
691,1906-09-01,"R16","Essendon",3,13,31,"Sydney",10,6,66,"East Melbourne",-35,1906,"Regular",16,"Away","Sydney","Essendon",35
692,1906-09-01,"R16","St Kilda",10,12,72,"Melbourne",4,9,33,"Junction Oval",39,1906,"Regular",16,"Home","St Kilda","Melbourne",39
693,1906-09-08,"R17","Sydney",4,15,39,"Carlton",12,14,86,"Lake Oval",-47,1906,"Regular",17,"Away","Carlton","Sydney",47
694,1906-09-08,"R17","Melbourne",7,9,51,"Collingwood",15,17,107,"M.C.G.",-56,1906,"Regular",17,"Away","Collingwood","Melbourne",56
695,1906-09-08,"R17","Geelong",9,12,66,"Essendon",5,12,42,"Corio Oval",24,1906,"Regular",17,"Home","Geelong","Essendon",24
696,1906-09-08,"R17","St Kilda",8,12,60,"Fitzroy",11,7,73,"Junction Oval",-13,1906,"Regular",17,"Away","Fitzroy","St Kilda",13
697,1906-09-15,"SF","Carlton",9,10,64,"Collingwood",8,6,54,"Brunswick St",10,1906,"Finals",18,"Home","Carlton","Collingwood",10
698,1906-09-15,"SF","Fitzroy",10,12,72,"Essendon",5,6,36,"M.C.G.",36,1906,"Finals",18,"Home","Fitzroy","Essendon",36
699,1906-09-22,"GF","Carlton",15,4,94,"Fitzroy",6,9,45,"M.C.G.",49,1906,"Finals",19,"Home","Carlton","Fitzroy",49
700,1907-04-27,"R1","Carlton",4,6,30,"St Kilda",8,8,56,"Princes Park",-26,1907,"Regular",1,"Away","St Kilda","Carlton",26
701,1907-04-27,"R1","Collingwood",6,11,47,"Fitzroy",5,9,39,"Victoria Park",8,1907,"Regular",1,"Home","Collingwood","Fitzroy",8
702,1907-04-27,"R1","Essendon",14,15,99,"Geelong",9,2,56,"East Melbourne",43,1907,"Regular",1,"Home","Essendon","Geelong",43
703,1907-04-27,"R1","Sydney",6,5,41,"Melbourne",9,6,60,"Lake Oval",-19,1907,"Regular",1,"Away","Melbourne","Sydney",19
704,1907-05-04,"R2","Geelong",3,9,27,"Carlton",8,14,62,"Corio Oval",-35,1907,"Regular",2,"Away","Carlton","Geelong",35
705,1907-05-04,"R2","St Kilda",8,14,62,"Collingwood",8,6,54,"Junction Oval",8,1907,"Regular",2,"Home","St Kilda","Collingwood",8
706,1907-05-04,"R2","Melbourne",5,11,41,"Essendon",6,12,48,"M.C.G.",-7,1907,"Regular",2,"Away","Essendon","Melbourne",7
707,1907-05-04,"R2","Fitzroy",7,15,57,"Sydney",7,5,47,"Brunswick St",10,1907,"Regular",2,"Home","Fitzroy","Sydney",10
708,1907-05-11,"R3","Melbourne",7,5,47,"Carlton",12,14,86,"M.C.G.",-39,1907,"Regular",3,"Away","Carlton","Melbourne",39
709,1907-05-11,"R3","Sydney",9,12,66,"Collingwood",5,8,38,"Lake Oval",28,1907,"Regular",3,"Home","Sydney","Collingwood",28
710,1907-05-11,"R3","St Kilda",9,13,67,"Essendon",5,7,37,"Junction Oval",30,1907,"Regular",3,"Home","St Kilda","Essendon",30
711,1907-05-11,"R3","Fitzroy",9,10,64,"Geelong",12,5,77,"Brunswick St",-13,1907,"Regular",3,"Away","Geelong","Fitzroy",13
712,1907-05-18,"R4","Carlton",10,17,77,"Fitzroy",3,7,25,"Princes Park",52,1907,"Regular",4,"Home","Carlton","Fitzroy",52
713,1907-05-18,"R4","Collingwood",4,10,34,"Melbourne",6,10,46,"Victoria Park",-12,1907,"Regular",4,"Away","Melbourne","Collingwood",12
714,1907-05-18,"R4","Essendon",6,8,44,"Sydney",6,11,47,"East Melbourne",-3,1907,"Regular",4,"Away","Sydney","Essendon",3
715,1907-05-18,"R4","Geelong",7,4,46,"St Kilda",11,16,82,"Corio Oval",-36,1907,"Regular",4,"Away","St Kilda","Geelong",36
716,1907-05-25,"R5","Carlton",5,16,46,"Sydney",9,7,61,"Princes Park",-15,1907,"Regular",5,"Away","Sydney","Carlton",15
717,1907-05-25,"R5","Essendon",5,8,38,"Collingwood",6,11,47,"East Melbourne",-9,1907,"Regular",5,"Away","Collingwood","Essendon",9
718,1907-05-25,"R5","St Kilda",13,9,87,"Fitzroy",9,10,64,"Junction Oval",23,1907,"Regular",5,"Home","St Kilda","Fitzroy",23
719,1907-05-25,"R5","Geelong",9,5,59,"Melbourne",7,9,51,"Corio Oval",8,1907,"Regular",5,"Home","Geelong","Melbourne",8
720,1907-06-01,"R6","Collingwood",4,6,30,"Carlton",4,17,41,"Victoria Park",-11,1907,"Regular",6,"Away","Carlton","Collingwood",11
721,1907-06-01,"R6","Melbourne",7,9,51,"St Kilda",15,18,108,"M.C.G.",-57,1907,"Regular",6,"Away","St Kilda","Melbourne",57
722,1907-06-03,"R6","Fitzroy",10,7,67,"Essendon",4,12,36,"Brunswick St",31,1907,"Regular",6,"Home","Fitzroy","Essendon",31
723,1907-06-03,"R6","Sydney",6,9,45,"Geelong",4,9,33,"Lake Oval",12,1907,"Regular",6,"Home","Sydney","Geelong",12
724,1907-06-15,"R7","Carlton",15,14,104,"Essendon",7,8,50,"Princes Park",54,1907,"Regular",7,"Home","Carlton","Essendon",54
725,1907-06-15,"R7","Geelong",3,14,32,"Collingwood",5,8,38,"Corio Oval",-6,1907,"Regular",7,"Away","Collingwood","Geelong",6
726,1907-06-15,"R7","Melbourne",8,7,55,"Fitzroy",6,11,47,"M.C.G.",8,1907,"Regular",7,"Home","Melbourne","Fitzroy",8
727,1907-06-15,"R7","St Kilda",4,8,32,"Sydney",7,2,44,"Junction Oval",-12,1907,"Regular",7,"Away","Sydney","St Kilda",12
728,1907-06-22,"R8","St Kilda",3,15,33,"Carlton",8,14,62,"Junction Oval",-29,1907,"Regular",8,"Away","Carlton","St Kilda",29
729,1907-06-22,"R8","Fitzroy",11,3,69,"Collingwood",11,12,78,"Brunswick St",-9,1907,"Regular",8,"Away","Collingwood","Fitzroy",9
730,1907-06-22,"R8","Geelong",7,11,53,"Essendon",3,10,28,"Corio Oval",25,1907,"Regular",8,"Home","Geelong","Essendon",25
731,1907-06-22,"R8","Melbourne",7,10,52,"Sydney",5,10,40,"M.C.G.",12,1907,"Regular",8,"Home","Melbourne","Sydney",12
732,1907-06-29,"R9","Carlton",5,9,39,"Geelong",7,4,46,"Princes Park",-7,1907,"Regular",9,"Away","Geelong","Carlton",7
733,1907-06-29,"R9","Collingwood",9,13,67,"St Kilda",7,10,52,"Victoria Park",15,1907,"Regular",9,"Home","Collingwood","St Kilda",15
734,1907-06-29,"R9","Essendon",5,13,43,"Melbourne",3,10,28,"East Melbourne",15,1907,"Regular",9,"Home","Essendon","Melbourne",15
735,1907-06-29,"R9","Sydney",6,8,44,"Fitzroy",7,10,52,"Lake Oval",-8,1907,"Regular",9,"Away","Fitzroy","Sydney",8
736,1907-07-06,"R10","Carlton",9,16,70,"Melbourne",8,6,54,"Princes Park",16,1907,"Regular",10,"Home","Carlton","Melbourne",16
737,1907-07-06,"R10","Collingwood",8,9,57,"Sydney",7,8,50,"Victoria Park",7,1907,"Regular",10,"Home","Collingwood","Sydney",7
738,1907-07-06,"R10","Essendon",5,7,37,"St Kilda",9,11,65,"East Melbourne",-28,1907,"Regular",10,"Away","St Kilda","Essendon",28
739,1907-07-06,"R10","Geelong",10,11,71,"Fitzroy",4,8,32,"Corio Oval",39,1907,"Regular",10,"Home","Geelong","Fitzroy",39
740,1907-07-13,"R11","Fitzroy",3,8,26,"Carlton",15,14,104,"Brunswick St",-78,1907,"Regular",11,"Away","Carlton","Fitzroy",78
741,1907-07-13,"R11","Melbourne",2,10,22,"Collingwood",15,11,101,"M.C.G.",-79,1907,"Regular",11,"Away","Collingwood","Melbourne",79
742,1907-07-13,"R11","Sydney",8,11,59,"Essendon",6,11,47,"Lake Oval",12,1907,"Regular",11,"Home","Sydney","Essendon",12
743,1907-07-13,"R11","St Kilda",6,18,54,"Geelong",9,5,59,"Junction Oval",-5,1907,"Regular",11,"Away","Geelong","St Kilda",5
744,1907-07-20,"R12","Sydney",3,9,27,"Carlton",4,12,36,"Lake Oval",-9,1907,"Regular",12,"Away","Carlton","Sydney",9
745,1907-07-20,"R12","Collingwood",10,10,70,"Essendon",3,5,23,"Victoria Park",47,1907,"Regular",12,"Home","Collingwood","Essendon",47
746,1907-07-20,"R12","Fitzroy",3,7,25,"St Kilda",3,5,23,"Brunswick St",2,1907,"Regular",12,"Home","Fitzroy","St Kilda",2
747,1907-07-20,"R12","Melbourne",6,13,49,"Geelong",4,10,34,"M.C.G.",15,1907,"Regular",12,"Home","Melbourne","Geelong",15
748,1907-08-03,"R13","Carlton",5,15,45,"Collingwood",5,4,34,"Princes Park",11,1907,"Regular",13,"Home","Carlton","Collingwood",11
749,1907-08-03,"R13","Essendon",8,10,58,"Fitzroy",3,13,31,"East Melbourne",27,1907,"Regular",13,"Home","Essendon","Fitzroy",27
750,1907-08-03,"R13","Geelong",6,6,42,"Sydney",7,8,50,"Corio Oval",-8,1907,"Regular",13,"Away","Sydney","Geelong",8
751,1907-08-03,"R13","St Kilda",4,6,30,"Melbourne",7,5,47,"Junction Oval",-17,1907,"Regular",13,"Away","Melbourne","St Kilda",17
752,1907-08-10,"R14","Essendon",3,7,25,"Carlton",10,18,78,"East Melbourne",-53,1907,"Regular",14,"Away","Carlton","Essendon",53
753,1907-08-10,"R14","Collingwood",15,6,96,"Geelong",8,9,57,"Victoria Park",39,1907,"Regular",14,"Home","Collingwood","Geelong",39
754,1907-08-10,"R14","Fitzroy",5,9,39,"Melbourne",6,19,55,"Brunswick St",-16,1907,"Regular",14,"Away","Melbourne","Fitzroy",16
755,1907-08-10,"R14","Sydney",8,16,64,"St Kilda",5,14,44,"Lake Oval",20,1907,"Regular",14,"Home","Sydney","St Kilda",20
756,1907-08-17,"R15","Sydney",8,9,57,"Carlton",4,16,40,"Lake Oval",17,1907,"Regular",15,"Home","Sydney","Carlton",17
757,1907-08-17,"R15","St Kilda",8,19,67,"Collingwood",3,8,26,"Junction Oval",41,1907,"Regular",15,"Home","St Kilda","Collingwood",41
758,1907-08-17,"R15","Essendon",10,11,71,"Melbourne",8,8,56,"East Melbourne",15,1907,"Regular",15,"Home","Essendon","Melbourne",15
759,1907-08-17,"R15","Fitzroy",12,16,88,"Geelong",5,8,38,"Brunswick St",50,1907,"Regular",15,"Home","Fitzroy","Geelong",50
760,1907-08-24,"R16","Carlton",11,12,78,"Essendon",7,5,47,"Princes Park",31,1907,"Regular",16,"Home","Carlton","Essendon",31
761,1907-08-24,"R16","Collingwood",11,16,82,"Fitzroy",15,4,94,"Victoria Park",-12,1907,"Regular",16,"Away","Fitzroy","Collingwood",12
762,1907-08-24,"R16","Geelong",5,8,38,"St Kilda",4,17,41,"Corio Oval",-3,1907,"Regular",16,"Away","St Kilda","Geelong",3
763,1907-08-24,"R16","Melbourne",7,8,50,"Sydney",10,14,74,"M.C.G.",-24,1907,"Regular",16,"Away","Sydney","Melbourne",24
764,1907-08-31,"R17","Carlton",9,8,62,"Melbourne",4,12,36,"Princes Park",26,1907,"Regular",17,"Home","Carlton","Melbourne",26
765,1907-08-31,"R17","Collingwood",9,17,71,"Geelong",12,4,76,"Victoria Park",-5,1907,"Regular",17,"Away","Geelong","Collingwood",5
766,1907-08-31,"R17","Essendon",6,7,43,"Sydney",15,9,99,"East Melbourne",-56,1907,"Regular",17,"Away","Sydney","Essendon",56
767,1907-08-31,"R17","St Kilda",3,14,32,"Fitzroy",6,9,45,"Junction Oval",-13,1907,"Regular",17,"Away","Fitzroy","St Kilda",13
768,1907-09-07,"SF","Sydney",12,10,82,"Collingwood",6,12,48,"M.C.G.",34,1907,"Finals",18,"Home","Sydney","Collingwood",34
769,1907-09-14,"SF","Carlton",13,13,91,"St Kilda",4,11,35,"M.C.G.",56,1907,"Finals",18,"Home","Carlton","St Kilda",56
770,1907-09-21,"GF","Carlton",6,14,50,"Sydney",6,9,45,"M.C.G.",5,1907,"Finals",19,"Home","Carlton","Sydney",5
771,1908-05-02,"R1","Carlton",6,12,48,"St Kilda",3,4,22,"Princes Park",26,1908,"Regular",1,"Home","Carlton","St Kilda",26
772,1908-05-02,"R1","Geelong",12,13,85,"Collingwood",5,8,38,"Corio Oval",47,1908,"Regular",1,"Home","Geelong","Collingwood",47
773,1908-05-02,"R1","Essendon",14,11,95,"University",3,11,29,"East Melbourne",66,1908,"Regular",1,"Home","Essendon","University",66
774,1908-05-02,"R1","Fitzroy",6,8,44,"Sydney",7,11,53,"Brunswick St",-9,1908,"Regular",1,"Away","Sydney","Fitzroy",9
775,1908-05-02,"R1","Richmond",8,14,62,"Melbourne",7,9,51,"Punt Rd",11,1908,"Regular",1,"Home","Richmond","Melbourne",11
776,1908-05-09,"R2","Melbourne",6,8,44,"Carlton",9,8,62,"M.C.G.",-18,1908,"Regular",2,"Away","Carlton","Melbourne",18
777,1908-05-09,"R2","Collingwood",3,14,32,"Fitzroy",9,9,63,"Victoria Park",-31,1908,"Regular",2,"Away","Fitzroy","Collingwood",31
778,1908-05-09,"R2","St Kilda",7,6,48,"Essendon",12,14,86,"Junction Oval",-38,1908,"Regular",2,"Away","Essendon","St Kilda",38
779,1908-05-09,"R2","Sydney",7,9,51,"Geelong",4,8,32,"Lake Oval",19,1908,"Regular",2,"Home","Sydney","Geelong",19
780,1908-05-09,"R2","University",14,10,94,"Richmond",12,4,76,"East Melbourne",18,1908,"Regular",2,"Home","University","Richmond",18
781,1908-05-16,"R3","Carlton",5,13,43,"Essendon",4,8,32,"Princes Park",11,1908,"Regular",3,"Home","Carlton","Essendon",11
782,1908-05-16,"R3","University",7,12,54,"Collingwood",8,14,62,"East Melbourne",-8,1908,"Regular",3,"Away","Collingwood","University",8
783,1908-05-16,"R3","Richmond",7,13,55,"Fitzroy",11,14,80,"Punt Rd",-25,1908,"Regular",3,"Away","Fitzroy","Richmond",25
784,1908-05-16,"R3","Geelong",7,8,50,"Melbourne",10,12,72,"Corio Oval",-22,1908,"Regular",3,"Away","Melbourne","Geelong",22
785,1908-05-16,"R3","Sydney",4,2,26,"St Kilda",7,13,55,"Lake Oval",-29,1908,"Regular",3,"Away","St Kilda","Sydney",29
786,1908-05-23,"R4","Collingwood",5,9,39,"Carlton",10,7,67,"Victoria Park",-28,1908,"Regular",4,"Away","Carlton","Collingwood",28
787,1908-05-23,"R4","Essendon",11,16,82,"Richmond",6,9,45,"East Melbourne",37,1908,"Regular",4,"Home","Essendon","Richmond",37
788,1908-05-23,"R4","Fitzroy",7,18,60,"Geelong",6,8,44,"Brunswick St",16,1908,"Regular",4,"Home","Fitzroy","Geelong",16
789,1908-05-23,"R4","Melbourne",12,3,75,"Sydney",10,13,73,"M.C.G.",2,1908,"Regular",4,"Home","Melbourne","Sydney",2
790,1908-05-23,"R4","St Kilda",5,10,40,"University",8,6,54,"Junction Oval",-14,1908,"Regular",4,"Away","University","St Kilda",14
791,1908-05-30,"R5","Carlton",10,12,72,"Fitzroy",5,10,40,"Princes Park",32,1908,"Regular",5,"Home","Carlton","Fitzroy",32
792,1908-05-30,"R5","Essendon",10,9,69,"Collingwood",9,10,64,"East Melbourne",5,1908,"Regular",5,"Home","Essendon","Collingwood",5
793,1908-05-30,"R5","Richmond",8,17,65,"Geelong",8,11,59,"Punt Rd",6,1908,"Regular",5,"Home","Richmond","Geelong",6
794,1908-05-30,"R5","St Kilda",9,12,66,"Melbourne",2,13,25,"Junction Oval",41,1908,"Regular",5,"Home","St Kilda","Melbourne",41
795,1908-05-30,"R5","Sydney",12,4,76,"University",9,11,65,"Lake Oval",11,1908,"Regular",5,"Home","Sydney","University",11
796,1908-06-06,"R6","Sydney",7,9,51,"Carlton",8,5,53,"Lake Oval",-2,1908,"Regular",6,"Away","Carlton","Sydney",2
797,1908-06-06,"R6","Collingwood",12,7,79,"Richmond",9,10,64,"Victoria Park",15,1908,"Regular",6,"Home","Collingwood","Richmond",15
798,1908-06-06,"R6","Fitzroy",5,8,38,"Essendon",5,12,42,"Brunswick St",-4,1908,"Regular",6,"Away","Essendon","Fitzroy",4
799,1908-06-06,"R6","Geelong",5,9,39,"St Kilda",6,6,42,"Corio Oval",-3,1908,"Regular",6,"Away","St Kilda","Geelong",3
800,1908-06-06,"R6","University",12,7,79,"Melbourne",1,13,19,"East Melbourne",60,1908,"Regular",6,"Home","University","Melbourne",60
801,1908-06-08,"R7","Carlton",13,14,92,"Geelong",2,13,25,"Princes Park",67,1908,"Regular",7,"Home","Carlton","Geelong",67
802,1908-06-08,"R7","St Kilda",12,11,83,"Collingwood",5,12,42,"Junction Oval",41,1908,"Regular",7,"Home","St Kilda","Collingwood",41
803,1908-06-08,"R7","Melbourne",10,6,66,"Essendon",10,12,72,"M.C.G.",-6,1908,"Regular",7,"Away","Essendon","Melbourne",6
804,1908-06-08,"R7","University",9,7,61,"Fitzroy",12,12,84,"East Melbourne",-23,1908,"Regular",7,"Away","Fitzroy","University",23
805,1908-06-08,"R7","Richmond",9,9,63,"Sydney",11,11,77,"Punt Rd",-14,1908,"Regular",7,"Away","Sydney","Richmond",14
806,1908-06-13,"R8","Carlton",17,13,115,"Richmond",2,15,27,"Princes Park",88,1908,"Regular",8,"Home","Carlton","Richmond",88
807,1908-06-13,"R8","Collingwood",8,8,56,"Melbourne",4,8,32,"Victoria Park",24,1908,"Regular",8,"Home","Collingwood","Melbourne",24
808,1908-06-13,"R8","Essendon",8,11,59,"Sydney",6,9,45,"East Melbourne",14,1908,"Regular",8,"Home","Essendon","Sydney",14
809,1908-06-13,"R8","Fitzroy",7,6,48,"St Kilda",12,9,81,"Brunswick St",-33,1908,"Regular",8,"Away","St Kilda","Fitzroy",33
810,1908-06-13,"R8","Geelong",4,11,35,"University",5,9,39,"Corio Oval",-4,1908,"Regular",8,"Away","University","Geelong",4
811,1908-06-20,"R9","University",6,15,51,"Carlton",7,15,57,"East Melbourne",-6,1908,"Regular",9,"Away","Carlton","University",6
812,1908-06-20,"R9","Sydney",9,11,65,"Collingwood",6,8,44,"Lake Oval",21,1908,"Regular",9,"Home","Sydney","Collingwood",21
813,1908-06-20,"R9","Geelong",3,7,25,"Essendon",7,9,51,"Corio Oval",-26,1908,"Regular",9,"Away","Essendon","Geelong",26
814,1908-06-20,"R9","Melbourne",4,4,28,"Fitzroy",3,7,25,"M.C.G.",3,1908,"Regular",9,"Home","Melbourne","Fitzroy",3
815,1908-06-20,"R9","St Kilda",9,5,59,"Richmond",3,15,33,"Junction Oval",26,1908,"Regular",9,"Home","St Kilda","Richmond",26
816,1908-06-27,"R10","St Kilda",6,5,41,"Carlton",10,12,72,"Junction Oval",-31,1908,"Regular",10,"Away","Carlton","St Kilda",31
817,1908-06-27,"R10","Collingwood",9,12,66,"Geelong",7,4,46,"Victoria Park",20,1908,"Regular",10,"Home","Collingwood","Geelong",20
818,1908-06-27,"R10","University",6,10,46,"Essendon",7,14,56,"East Melbourne",-10,1908,"Regular",10,"Away","Essendon","University",10
819,1908-06-27,"R10","Sydney",2,19,31,"Fitzroy",2,6,18,"Lake Oval",13,1908,"Regular",10,"Home","Sydney","Fitzroy",13
820,1908-06-27,"R10","Melbourne",11,16,82,"Richmond",1,6,12,"M.C.G.",70,1908,"Regular",10,"Home","Melbourne","Richmond",70
821,1908-07-04,"R11","Carlton",8,15,63,"Melbourne",4,7,31,"Princes Park",32,1908,"Regular",11,"Home","Carlton","Melbourne",32
822,1908-07-04,"R11","Fitzroy",6,6,42,"Collingwood",7,2,44,"Brunswick St",-2,1908,"Regular",11,"Away","Collingwood","Fitzroy",2
823,1908-07-04,"R11","Essendon",5,10,40,"St Kilda",8,9,57,"East Melbourne",-17,1908,"Regular",11,"Away","St Kilda","Essendon",17
824,1908-07-04,"R11","Geelong",9,4,58,"Sydney",9,12,66,"Corio Oval",-8,1908,"Regular",11,"Away","Sydney","Geelong",8
825,1908-07-04,"R11","Richmond",11,5,71,"University",8,14,62,"Punt Rd",9,1908,"Regular",11,"Home","Richmond","University",9
826,1908-07-11,"R12","Essendon",6,6,42,"Carlton",4,5,29,"East Melbourne",13,1908,"Regular",12,"Home","Essendon","Carlton",13
827,1908-07-11,"R12","Collingwood",3,13,31,"University",2,2,14,"Victoria Park",17,1908,"Regular",12,"Home","Collingwood","University",17
828,1908-07-11,"R12","Fitzroy",4,9,33,"Richmond",5,4,34,"Brunswick St",-1,1908,"Regular",12,"Away","Richmond","Fitzroy",1
829,1908-07-11,"R12","Melbourne",9,12,66,"Geelong",7,6,48,"M.C.G.",18,1908,"Regular",12,"Home","Melbourne","Geelong",18
830,1908-07-11,"R12","St Kilda",5,4,34,"Sydney",4,5,29,"Junction Oval",5,1908,"Regular",12,"Home","St Kilda","Sydney",5
831,1908-07-18,"R13","Carlton",10,17,77,"Collingwood",5,7,37,"Princes Park",40,1908,"Regular",13,"Home","Carlton","Collingwood",40
832,1908-07-18,"R13","Richmond",7,3,45,"Essendon",9,14,68,"Punt Rd",-23,1908,"Regular",13,"Away","Essendon","Richmond",23
833,1908-07-18,"R13","Geelong",7,14,56,"Fitzroy",11,8,74,"Corio Oval",-18,1908,"Regular",13,"Away","Fitzroy","Geelong",18
834,1908-07-18,"R13","Sydney",5,10,40,"Melbourne",11,8,74,"Lake Oval",-34,1908,"Regular",13,"Away","Melbourne","Sydney",34
835,1908-07-18,"R13","University",7,14,56,"St Kilda",5,13,43,"East Melbourne",13,1908,"Regular",13,"Home","University","St Kilda",13
836,1908-07-25,"R14","Fitzroy",4,9,33,"Carlton",6,8,44,"Brunswick St",-11,1908,"Regular",14,"Away","Carlton","Fitzroy",11
837,1908-07-25,"R14","Collingwood",8,12,60,"Essendon",8,8,56,"Victoria Park",4,1908,"Regular",14,"Home","Collingwood","Essendon",4
838,1908-07-25,"R14","Geelong",6,17,53,"Richmond",5,8,38,"Corio Oval",15,1908,"Regular",14,"Home","Geelong","Richmond",15
839,1908-07-25,"R14","Melbourne",16,11,107,"St Kilda",8,3,51,"M.C.G.",56,1908,"Regular",14,"Home","Melbourne","St Kilda",56
840,1908-07-25,"R14","University",11,7,73,"Sydney",10,11,71,"East Melbourne",2,1908,"Regular",14,"Home","University","Sydney",2
841,1908-08-01,"R15","Carlton",8,19,67,"Sydney",6,5,41,"Princes Park",26,1908,"Regular",15,"Home","Carlton","Sydney",26
842,1908-08-01,"R15","Richmond",11,8,74,"Collingwood",10,9,69,"Punt Rd",5,1908,"Regular",15,"Home","Richmond","Collingwood",5
843,1908-08-01,"R15","Essendon",8,13,61,"Fitzroy",7,8,50,"East Melbourne",11,1908,"Regular",15,"Home","Essendon","Fitzroy",11
844,1908-08-01,"R15","St Kilda",17,5,107,"Geelong",5,8,38,"Junction Oval",69,1908,"Regular",15,"Home","St Kilda","Geelong",69
845,1908-08-01,"R15","Melbourne",7,12,54,"University",8,10,58,"M.C.G.",-4,1908,"Regular",15,"Away","University","Melbourne",4
846,1908-08-08,"R16","Geelong",5,9,39,"Carlton",6,13,49,"Corio Oval",-10,1908,"Regular",16,"Away","Carlton","Geelong",10
847,1908-08-08,"R16","Collingwood",10,10,70,"St Kilda",7,9,51,"Victoria Park",19,1908,"Regular",16,"Home","Collingwood","St Kilda",19
848,1908-08-08,"R16","Essendon",17,17,119,"Melbourne",8,11,59,"East Melbourne",60,1908,"Regular",16,"Home","Essendon","Melbourne",60
849,1908-08-08,"R16","Fitzroy",13,16,94,"University",11,7,73,"Brunswick St",21,1908,"Regular",16,"Home","Fitzroy","University",21
850,1908-08-08,"R16","Sydney",18,12,120,"Richmond",4,4,28,"Lake Oval",92,1908,"Regular",16,"Home","Sydney","Richmond",92
851,1908-08-15,"R17","Richmond",4,17,41,"Carlton",6,12,48,"Punt Rd",-7,1908,"Regular",17,"Away","Carlton","Richmond",7
852,1908-08-15,"R17","Melbourne",4,8,32,"Collingwood",6,9,45,"M.C.G.",-13,1908,"Regular",17,"Away","Collingwood","Melbourne",13
853,1908-08-15,"R17","Sydney",5,8,38,"Essendon",3,14,32,"Lake Oval",6,1908,"Regular",17,"Home","Sydney","Essendon",6
854,1908-08-15,"R17","St Kilda",4,7,31,"Fitzroy",3,4,22,"Junction Oval",9,1908,"Regular",17,"Home","St Kilda","Fitzroy",9
855,1908-08-15,"R17","University",13,18,96,"Geelong",6,8,44,"East Melbourne",52,1908,"Regular",17,"Home","University","Geelong",52
856,1908-09-05,"R18","Carlton",10,7,67,"University",4,4,28,"Princes Park",39,1908,"Regular",18,"Home","Carlton","University",39
857,1908-09-05,"R18","Collingwood",12,16,88,"Sydney",3,4,22,"Victoria Park",66,1908,"Regular",18,"Home","Collingwood","Sydney",66
858,1908-09-05,"R18","Essendon",13,20,98,"Geelong",3,9,27,"East Melbourne",71,1908,"Regular",18,"Home","Essendon","Geelong",71
859,1908-09-05,"R18","Fitzroy",11,18,84,"Melbourne",1,4,10,"Brunswick St",74,1908,"Regular",18,"Home","Fitzroy","Melbourne",74
860,1908-09-05,"R18","Richmond",16,11,107,"St Kilda",6,8,44,"Punt Rd",63,1908,"Regular",18,"Home","Richmond","St Kilda",63
861,1908-09-12,"SF","Essendon",9,14,68,"Collingwood",5,3,33,"M.C.G.",35,1908,"Finals",19,"Home","Essendon","Collingwood",35
862,1908-09-19,"SF","Carlton",12,12,84,"St Kilda",3,8,26,"M.C.G.",58,1908,"Finals",19,"Home","Carlton","St Kilda",58
863,1908-09-26,"GF","Carlton",5,5,35,"Essendon",3,8,26,"M.C.G.",9,1908,"Finals",20,"Home","Carlton","Essendon",9
864,1909-05-01,"R1","Carlton",3,14,32,"University",6,11,47,"Princes Park",-15,1909,"Regular",1,"Away","University","Carlton",15
865,1909-05-01,"R1","Collingwood",9,7,61,"Fitzroy",10,12,72,"Victoria Park",-11,1909,"Regular",1,"Away","Fitzroy","Collingwood",11
866,1909-05-01,"R1","Essendon",6,18,54,"St Kilda",6,8,44,"East Melbourne",10,1909,"Regular",1,"Home","Essendon","St Kilda",10
867,1909-05-01,"R1","Geelong",6,8,44,"Sydney",8,5,53,"Corio Oval",-9,1909,"Regular",1,"Away","Sydney","Geelong",9
868,1909-05-01,"R1","Richmond",9,9,63,"Melbourne",11,8,74,"Punt Rd",-11,1909,"Regular",1,"Away","Melbourne","Richmond",11
869,1909-05-08,"R2","Sydney",7,3,45,"Carlton",4,4,28,"Lake Oval",17,1909,"Regular",2,"Home","Sydney","Carlton",17
870,1909-05-08,"R2","St Kilda",3,5,23,"Collingwood",3,11,29,"Junction Oval",-6,1909,"Regular",2,"Away","Collingwood","St Kilda",6
871,1909-05-08,"R2","Melbourne",7,5,47,"Essendon",9,13,67,"M.C.G.",-20,1909,"Regular",2,"Away","Essendon","Melbourne",20
872,1909-05-08,"R2","Fitzroy",12,16,88,"Geelong",3,10,28,"Brunswick St",60,1909,"Regular",2,"Home","Fitzroy","Geelong",60
873,1909-05-08,"R2","University",5,7,37,"Richmond",6,6,42,"East Melbourne",-5,1909,"Regular",2,"Away","Richmond","University",5
874,1909-05-15,"R3","Carlton",7,8,50,"Collingwood",4,9,33,"Princes Park",17,1909,"Regular",3,"Home","Carlton","Collingwood",17
875,1909-05-15,"R3","Essendon",8,18,66,"Geelong",9,5,59,"East Melbourne",7,1909,"Regular",3,"Home","Essendon","Geelong",7
876,1909-05-15,"R3","Richmond",4,13,37,"Fitzroy",9,14,68,"Punt Rd",-31,1909,"Regular",3,"Away","Fitzroy","Richmond",31
877,1909-05-15,"R3","Sydney",12,16,88,"Melbourne",3,6,24,"Lake Oval",64,1909,"Regular",3,"Home","Sydney","Melbourne",64
878,1909-05-15,"R3","St Kilda",5,12,42,"University",2,9,21,"Junction Oval",21,1909,"Regular",3,"Home","St Kilda","University",21
879,1909-05-22,"R4","Geelong",12,13,85,"Carlton",8,13,61,"Corio Oval",24,1909,"Regular",4,"Home","Geelong","Carlton",24
880,1909-05-22,"R4","Collingwood",12,13,85,"Richmond",7,7,49,"Victoria Park",36,1909,"Regular",4,"Home","Collingwood","Richmond",36
881,1909-05-22,"R4","Essendon",8,11,59,"University",9,14,68,"East Melbourne",-9,1909,"Regular",4,"Away","University","Essendon",9
882,1909-05-22,"R4","Fitzroy",5,7,37,"Sydney",11,10,76,"Brunswick St",-39,1909,"Regular",4,"Away","Sydney","Fitzroy",39
883,1909-05-22,"R4","Melbourne",6,15,51,"St Kilda",6,4,40,"M.C.G.",11,1909,"Regular",4,"Home","Melbourne","St Kilda",11
884,1909-05-29,"R5","Melbourne",8,9,57,"Carlton",12,8,80,"M.C.G.",-23,1909,"Regular",5,"Away","Carlton","Melbourne",23
885,1909-05-29,"R5","Sydney",6,10,46,"Collingwood",3,8,26,"Lake Oval",20,1909,"Regular",5,"Home","Sydney","Collingwood",20
886,1909-05-29,"R5","Fitzroy",5,7,37,"Essendon",8,13,61,"Brunswick St",-24,1909,"Regular",5,"Away","Essendon","Fitzroy",24
887,1909-05-29,"R5","University",9,9,63,"Geelong",3,10,28,"East Melbourne",35,1909,"Regular",5,"Home","University","Geelong",35
888,1909-05-29,"R5","St Kilda",7,8,50,"Richmond",11,4,70,"Junction Oval",-20,1909,"Regular",5,"Away","Richmond","St Kilda",20
889,1909-06-05,"R6","Carlton",6,12,48,"Fitzroy",5,9,39,"Princes Park",9,1909,"Regular",6,"Home","Carlton","Fitzroy",9
890,1909-06-05,"R6","Collingwood",10,13,73,"Essendon",4,7,31,"Victoria Park",42,1909,"Regular",6,"Home","Collingwood","Essendon",42
891,1909-06-05,"R6","Geelong",6,12,48,"St Kilda",6,13,49,"Corio Oval",-1,1909,"Regular",6,"Away","St Kilda","Geelong",1
892,1909-06-05,"R6","University",6,10,46,"Melbourne",9,11,65,"East Melbourne",-19,1909,"Regular",6,"Away","Melbourne","University",19
893,1909-06-05,"R6","Richmond",10,11,71,"Sydney",8,10,58,"Punt Rd",13,1909,"Regular",6,"Home","Richmond","Sydney",13
894,1909-06-07,"R7","Carlton",10,12,72,"Richmond",6,7,43,"Princes Park",29,1909,"Regular",7,"Home","Carlton","Richmond",29
895,1909-06-07,"R7","Collingwood",8,17,65,"University",4,5,29,"Victoria Park",36,1909,"Regular",7,"Home","Collingwood","University",36
896,1909-06-07,"R7","Essendon",9,8,62,"Sydney",9,9,63,"East Melbourne",-1,1909,"Regular",7,"Away","Sydney","Essendon",1
897,1909-06-07,"R7","St Kilda",4,11,35,"Fitzroy",11,10,76,"Junction Oval",-41,1909,"Regular",7,"Away","Fitzroy","St Kilda",41
898,1909-06-07,"R7","Melbourne",18,9,117,"Geelong",5,8,38,"M.C.G.",79,1909,"Regular",7,"Home","Melbourne","Geelong",79
899,1909-06-12,"R8","St Kilda",5,10,40,"Carlton",10,9,69,"Junction Oval",-29,1909,"Regular",8,"Away","Carlton","St Kilda",29
900,1909-06-12,"R8","Geelong",5,10,40,"Collingwood",10,8,68,"Corio Oval",-28,1909,"Regular",8,"Away","Collingwood","Geelong",28
901,1909-06-12,"R8","Essendon",8,7,55,"Richmond",8,15,63,"East Melbourne",-8,1909,"Regular",8,"Away","Richmond","Essendon",8
902,1909-06-12,"R8","Fitzroy",5,12,42,"Melbourne",8,7,55,"Brunswick St",-13,1909,"Regular",8,"Away","Melbourne","Fitzroy",13
903,1909-06-12,"R8","Sydney",11,15,81,"University",2,6,18,"Lake Oval",63,1909,"Regular",8,"Home","Sydney","University",63
904,1909-06-19,"R9","Carlton",6,14,50,"Essendon",4,9,33,"Princes Park",17,1909,"Regular",9,"Home","Carlton","Essendon",17
905,1909-06-19,"R9","Richmond",4,15,39,"Geelong",5,7,37,"Punt Rd",2,1909,"Regular",9,"Home","Richmond","Geelong",2
906,1909-06-19,"R9","Sydney",14,13,97,"St Kilda",2,8,20,"Lake Oval",77,1909,"Regular",9,"Home","Sydney","St Kilda",77
907,1909-06-26,"R9","Melbourne",10,5,65,"Collingwood",10,5,65,"M.C.G.",0,1909,"Regular",9,"Home","Melbourne","Collingwood",0
908,1909-06-26,"R9","University",8,20,68,"Fitzroy",3,10,28,"East Melbourne",40,1909,"Regular",9,"Home","University","Fitzroy",40
909,1909-07-03,"R10","University",7,7,49,"Carlton",10,9,69,"East Melbourne",-20,1909,"Regular",10,"Away","Carlton","University",20
910,1909-07-03,"R10","Fitzroy",2,9,21,"Collingwood",6,16,52,"Brunswick St",-31,1909,"Regular",10,"Away","Collingwood","Fitzroy",31
911,1909-07-03,"R10","St Kilda",6,6,42,"Essendon",9,18,72,"Junction Oval",-30,1909,"Regular",10,"Away","Essendon","St Kilda",30
912,1909-07-03,"R10","Sydney",17,9,111,"Geelong",4,7,31,"Lake Oval",80,1909,"Regular",10,"Home","Sydney","Geelong",80
913,1909-07-03,"R10","Melbourne",12,10,82,"Richmond",2,3,15,"M.C.G.",67,1909,"Regular",10,"Home","Melbourne","Richmond",67
914,1909-07-10,"R11","Carlton",9,14,68,"Sydney",6,8,44,"Princes Park",24,1909,"Regular",11,"Home","Carlton","Sydney",24
915,1909-07-10,"R11","Collingwood",11,18,84,"St Kilda",6,8,44,"Victoria Park",40,1909,"Regular",11,"Home","Collingwood","St Kilda",40
916,1909-07-10,"R11","Essendon",5,10,40,"Melbourne",3,12,30,"East Melbourne",10,1909,"Regular",11,"Home","Essendon","Melbourne",10
917,1909-07-10,"R11","Geelong",9,7,61,"Fitzroy",13,9,87,"Corio Oval",-26,1909,"Regular",11,"Away","Fitzroy","Geelong",26
918,1909-07-10,"R11","Richmond",7,8,50,"University",11,15,81,"Punt Rd",-31,1909,"Regular",11,"Away","University","Richmond",31
919,1909-07-17,"R12","Collingwood",5,7,37,"Carlton",5,6,36,"Victoria Park",1,1909,"Regular",12,"Home","Collingwood","Carlton",1
920,1909-07-17,"R12","Geelong",6,9,45,"Essendon",12,8,80,"Corio Oval",-35,1909,"Regular",12,"Away","Essendon","Geelong",35
921,1909-07-17,"R12","Fitzroy",9,14,68,"Richmond",3,7,25,"Brunswick St",43,1909,"Regular",12,"Home","Fitzroy","Richmond",43
922,1909-07-17,"R12","Melbourne",3,6,24,"Sydney",6,9,45,"M.C.G.",-21,1909,"Regular",12,"Away","Sydney","Melbourne",21
923,1909-07-17,"R12","University",11,14,80,"St Kilda",4,2,26,"East Melbourne",54,1909,"Regular",12,"Home","University","St Kilda",54
924,1909-07-24,"R13","Carlton",19,16,130,"Geelong",10,10,70,"Princes Park",60,1909,"Regular",13,"Home","Carlton","Geelong",60
925,1909-07-24,"R13","Richmond",5,7,37,"Collingwood",8,24,72,"Punt Rd",-35,1909,"Regular",13,"Away","Collingwood","Richmond",35
926,1909-07-24,"R13","University",4,19,43,"Essendon",11,9,75,"East Melbourne",-32,1909,"Regular",13,"Away","Essendon","University",32
927,1909-07-24,"R13","Sydney",4,6,30,"Fitzroy",5,14,44,"Lake Oval",-14,1909,"Regular",13,"Away","Fitzroy","Sydney",14
928,1909-07-24,"R13","St Kilda",5,11,41,"Melbourne",12,7,79,"Junction Oval",-38,1909,"Regular",13,"Away","Melbourne","St Kilda",38
929,1909-07-31,"R14","Carlton",10,21,81,"Melbourne",4,6,30,"Princes Park",51,1909,"Regular",14,"Home","Carlton","Melbourne",51
930,1909-07-31,"R14","Collingwood",8,6,54,"Sydney",6,7,43,"Victoria Park",11,1909,"Regular",14,"Home","Collingwood","Sydney",11
931,1909-07-31,"R14","Essendon",10,9,69,"Fitzroy",7,7,49,"East Melbourne",20,1909,"Regular",14,"Home","Essendon","Fitzroy",20
932,1909-07-31,"R14","Geelong",6,11,47,"University",12,15,87,"Corio Oval",-40,1909,"Regular",14,"Away","University","Geelong",40
933,1909-07-31,"R14","Richmond",9,11,65,"St Kilda",6,13,49,"Punt Rd",16,1909,"Regular",14,"Home","Richmond","St Kilda",16
934,1909-08-07,"R15","Essendon",14,14,98,"Collingwood",6,6,42,"East Melbourne",56,1909,"Regular",15,"Home","Essendon","Collingwood",56
935,1909-08-07,"R15","St Kilda",3,8,26,"Geelong",2,10,22,"Junction Oval",4,1909,"Regular",15,"Home","St Kilda","Geelong",4
936,1909-08-14,"R15","Fitzroy",2,9,21,"Carlton",11,6,72,"Brunswick St",-51,1909,"Regular",15,"Away","Carlton","Fitzroy",51
937,1909-08-14,"R15","Melbourne",4,4,28,"University",2,15,27,"M.C.G.",1,1909,"Regular",15,"Home","Melbourne","University",1
938,1909-08-14,"R15","Sydney",18,11,119,"Richmond",3,8,26,"Lake Oval",93,1909,"Regular",15,"Home","Sydney","Richmond",93
939,1909-08-21,"R16","Richmond",9,6,60,"Carlton",14,16,100,"Punt Rd",-40,1909,"Regular",16,"Away","Carlton","Richmond",40
940,1909-08-21,"R16","University",5,9,39,"Collingwood",5,9,39,"East Melbourne",0,1909,"Regular",16,"Home","University","Collingwood",0
941,1909-08-21,"R16","Sydney",6,5,41,"Essendon",5,7,37,"Lake Oval",4,1909,"Regular",16,"Home","Sydney","Essendon",4
942,1909-08-21,"R16","Fitzroy",11,11,77,"St Kilda",5,1,31,"Brunswick St",46,1909,"Regular",16,"Home","Fitzroy","St Kilda",46
943,1909-08-21,"R16","Geelong",6,9,45,"Melbourne",9,14,68,"Corio Oval",-23,1909,"Regular",16,"Away","Melbourne","Geelong",23
944,1909-08-28,"R17","Carlton",11,13,79,"St Kilda",5,3,33,"Princes Park",46,1909,"Regular",17,"Home","Carlton","St Kilda",46
945,1909-08-28,"R17","Collingwood",11,11,77,"Geelong",4,8,32,"Victoria Park",45,1909,"Regular",17,"Home","Collingwood","Geelong",45
946,1909-08-28,"R17","Richmond",5,9,39,"Essendon",12,11,83,"Punt Rd",-44,1909,"Regular",17,"Away","Essendon","Richmond",44
947,1909-08-28,"R17","Melbourne",9,7,61,"Fitzroy",4,7,31,"M.C.G.",30,1909,"Regular",17,"Home","Melbourne","Fitzroy",30
948,1909-08-28,"R17","University",5,9,39,"Sydney",9,11,65,"East Melbourne",-26,1909,"Regular",17,"Away","Sydney","University",26
949,1909-09-04,"R18","Essendon",4,10,34,"Carlton",6,13,49,"East Melbourne",-15,1909,"Regular",18,"Away","Carlton","Essendon",15
950,1909-09-04,"R18","Collingwood",15,18,108,"Melbourne",9,12,66,"Victoria Park",42,1909,"Regular",18,"Home","Collingwood","Melbourne",42
951,1909-09-04,"R18","Fitzroy",9,6,60,"University",8,12,60,"Brunswick St",0,1909,"Regular",18,"Home","Fitzroy","University",0
952,1909-09-04,"R18","Geelong",13,14,92,"Richmond",4,7,31,"Corio Oval",61,1909,"Regular",18,"Home","Geelong","Richmond",61
953,1909-09-04,"R18","St Kilda",5,5,35,"Sydney",7,15,57,"Junction Oval",-22,1909,"Regular",18,"Away","Sydney","St Kilda",22
954,1909-09-11,"SF","Carlton",14,8,92,"Essendon",9,2,56,"M.C.G.",36,1909,"Finals",19,"Home","Carlton","Essendon",36
955,1909-09-18,"SF","Sydney",10,8,68,"Collingwood",6,11,47,"M.C.G.",21,1909,"Finals",19,"Home","Sydney","Collingwood",21
956,1909-09-25,"PF","Sydney",7,5,47,"Carlton",10,9,69,"M.C.G.",-22,1909,"Finals",20,"Away","Carlton","Sydney",22
957,1909-10-02,"GF","Sydney",4,14,38,"Carlton",4,12,36,"M.C.G.",2,1909,"Finals",21,"Home","Sydney","Carlton",2
958,1910-04-30,"R1","Carlton",9,9,63,"Collingwood",5,5,35,"Princes Park",28,1910,"Regular",1,"Home","Carlton","Collingwood",28
959,1910-04-30,"R1","Essendon",3,18,36,"Fitzroy",9,10,64,"East Melbourne",-28,1910,"Regular",1,"Away","Fitzroy","Essendon",28
960,1910-04-30,"R1","Melbourne",6,6,42,"Geelong",13,21,99,"M.C.G.",-57,1910,"Regular",1,"Away","Geelong","Melbourne",57
961,1910-04-30,"R1","Sydney",11,12,78,"Richmond",4,8,32,"Lake Oval",46,1910,"Regular",1,"Home","Sydney","Richmond",46
962,1910-04-30,"R1","St Kilda",3,12,30,"University",7,10,52,"Junction Oval",-22,1910,"Regular",1,"Away","University","St Kilda",22
963,1910-05-14,"R2","Geelong",6,9,45,"Carlton",10,15,75,"Corio Oval",-30,1910,"Regular",2,"Away","Carlton","Geelong",30
964,1910-05-14,"R2","Collingwood",13,9,87,"Sydney",5,16,46,"Victoria Park",41,1910,"Regular",2,"Home","Collingwood","Sydney",41
965,1910-05-14,"R2","University",8,10,58,"Essendon",15,17,107,"East Melbourne",-49,1910,"Regular",2,"Away","Essendon","University",49
966,1910-05-14,"R2","Fitzroy",14,15,99,"St Kilda",4,12,36,"Brunswick St",63,1910,"Regular",2,"Home","Fitzroy","St Kilda",63
967,1910-05-14,"R2","Richmond",16,18,114,"Melbourne",5,7,37,"Punt Rd",77,1910,"Regular",2,"Home","Richmond","Melbourne",77
968,1910-05-21,"R3","Melbourne",5,6,36,"Carlton",9,15,69,"M.C.G.",-33,1910,"Regular",3,"Away","Carlton","Melbourne",33
969,1910-05-21,"R3","Collingwood",13,13,91,"St Kilda",2,6,18,"Victoria Park",73,1910,"Regular",3,"Home","Collingwood","St Kilda",73
970,1910-05-21,"R3","Sydney",10,7,67,"Essendon",11,7,73,"Lake Oval",-6,1910,"Regular",3,"Away","Essendon","Sydney",6
971,1910-05-21,"R3","Fitzroy",7,11,53,"Geelong",9,13,67,"Brunswick St",-14,1910,"Regular",3,"Away","Geelong","Fitzroy",14
972,1910-05-21,"R3","University",10,13,73,"Richmond",7,10,52,"East Melbourne",21,1910,"Regular",3,"Home","University","Richmond",21
973,1910-05-28,"R4","Carlton",6,13,49,"Sydney",4,8,32,"Princes Park",17,1910,"Regular",4,"Home","Carlton","Sydney",17
974,1910-05-28,"R4","Essendon",6,7,43,"Collingwood",4,17,41,"East Melbourne",2,1910,"Regular",4,"Home","Essendon","Collingwood",2
975,1910-05-28,"R4","Richmond",7,19,61,"Fitzroy",4,8,32,"Punt Rd",29,1910,"Regular",4,"Home","Richmond","Fitzroy",29
976,1910-05-28,"R4","Geelong",6,9,45,"University",9,4,58,"Corio Oval",-13,1910,"Regular",4,"Away","University","Geelong",13
977,1910-05-28,"R4","St Kilda",7,9,51,"Melbourne",8,6,54,"Junction Oval",-3,1910,"Regular",4,"Away","Melbourne","St Kilda",3
978,1910-06-04,"R5","Fitzroy",9,9,63,"Carlton",14,20,104,"Brunswick St",-41,1910,"Regular",5,"Away","Carlton","Fitzroy",41
979,1910-06-04,"R5","Collingwood",10,16,76,"Melbourne",4,4,28,"Victoria Park",48,1910,"Regular",5,"Home","Collingwood","Melbourne",48
980,1910-06-04,"R5","Essendon",8,15,63,"St Kilda",7,9,51,"East Melbourne",12,1910,"Regular",5,"Home","Essendon","St Kilda",12
981,1910-06-04,"R5","Geelong",5,16,46,"Richmond",4,5,29,"Corio Oval",17,1910,"Regular",5,"Home","Geelong","Richmond",17
982,1910-06-04,"R5","Sydney",6,14,50,"University",7,6,48,"Lake Oval",2,1910,"Regular",5,"Home","Sydney","University",2
983,1910-06-06,"R6","University",5,5,35,"Carlton",11,8,74,"East Melbourne",-39,1910,"Regular",6,"Away","Carlton","University",39
984,1910-06-06,"R6","Fitzroy",7,9,51,"Collingwood",11,14,80,"Brunswick St",-29,1910,"Regular",6,"Away","Collingwood","Fitzroy",29
985,1910-06-06,"R6","Melbourne",10,7,67,"Essendon",16,21,117,"M.C.G.",-50,1910,"Regular",6,"Away","Essendon","Melbourne",50
986,1910-06-06,"R6","Geelong",11,12,78,"Sydney",6,6,42,"Corio Oval",36,1910,"Regular",6,"Home","Geelong","Sydney",36
987,1910-06-06,"R6","St Kilda",7,7,49,"Richmond",8,14,62,"Junction Oval",-13,1910,"Regular",6,"Away","Richmond","St Kilda",13
988,1910-06-11,"R7","Carlton",6,15,51,"Essendon",7,10,52,"Princes Park",-1,1910,"Regular",7,"Away","Essendon","Carlton",1
989,1910-06-11,"R7","Richmond",5,7,37,"Collingwood",6,9,45,"Punt Rd",-8,1910,"Regular",7,"Away","Collingwood","Richmond",8
990,1910-06-11,"R7","University",13,14,92,"Fitzroy",8,8,56,"East Melbourne",36,1910,"Regular",7,"Home","University","Fitzroy",36
991,1910-06-11,"R7","St Kilda",9,6,60,"Geelong",10,14,74,"Junction Oval",-14,1910,"Regular",7,"Away","Geelong","St Kilda",14
992,1910-06-11,"R7","Sydney",11,15,81,"Melbourne",6,10,46,"Lake Oval",35,1910,"Regular",7,"Home","Sydney","Melbourne",35
993,1910-06-18,"R8","Richmond",7,6,48,"Carlton",7,15,57,"Punt Rd",-9,1910,"Regular",8,"Away","Carlton","Richmond",9
994,1910-06-18,"R8","Collingwood",6,10,46,"University",6,6,42,"Victoria Park",4,1910,"Regular",8,"Home","Collingwood","University",4
995,1910-06-18,"R8","Essendon",5,12,42,"Geelong",2,9,21,"East Melbourne",21,1910,"Regular",8,"Home","Essendon","Geelong",21
996,1910-06-18,"R8","Melbourne",6,14,50,"Fitzroy",8,18,66,"M.C.G.",-16,1910,"Regular",8,"Away","Fitzroy","Melbourne",16
997,1910-06-18,"R8","St Kilda",4,5,29,"Sydney",6,13,49,"Junction Oval",-20,1910,"Regular",8,"Away","Sydney","St Kilda",20
998,1910-06-25,"R9","Carlton",9,10,64,"St Kilda",4,7,31,"Princes Park",33,1910,"Regular",9,"Home","Carlton","St Kilda",33
999,1910-06-25,"R9","Richmond",6,10,46,"Essendon",9,14,68,"Punt Rd",-22,1910,"Regular",9,"Away","Essendon","Richmond",22
1000,1910-06-25,"R9","Fitzroy",7,13,55,"Sydney",11,6,72,"Brunswick St",-17,1910,"Regular",9,"Away","Sydney","Fitzroy",17
1001,1910-06-25,"R9","University",7,7,49,"Melbourne",4,11,35,"East Melbourne",14,1910,"Regular",9,"Home","University","Melbourne",14
1002,1910-06-25,"R9","Geelong",10,9,69,"Collingwood",6,11,47,"Corio Oval",22,1910,"Regular",9,"Home","Geelong","Collingwood",22
1003,1910-07-02,"R10","Collingwood",2,10,22,"Carlton",6,15,51,"Victoria Park",-29,1910,"Regular",10,"Away","Carlton","Collingwood",29
1004,1910-07-02,"R10","Fitzroy",11,5,71,"Essendon",12,17,89,"Brunswick St",-18,1910,"Regular",10,"Away","Essendon","Fitzroy",18
1005,1910-07-02,"R10","Richmond",10,7,67,"Sydney",10,11,71,"Punt Rd",-4,1910,"Regular",10,"Away","Sydney","Richmond",4
1006,1910-07-02,"R10","University",7,12,54,"St Kilda",6,9,45,"East Melbourne",9,1910,"Regular",10,"Home","University","St Kilda",9
1007,1910-07-02,"R10","Geelong",15,10,100,"Melbourne",8,3,51,"Corio Oval",49,1910,"Regular",10,"Home","Geelong","Melbourne",49
1008,1910-07-09,"R11","Carlton",16,11,107,"Geelong",3,15,33,"Princes Park",74,1910,"Regular",11,"Home","Carlton","Geelong",74
1009,1910-07-09,"R11","Sydney",13,17,95,"Collingwood",4,9,33,"Lake Oval",62,1910,"Regular",11,"Home","Sydney","Collingwood",62
1010,1910-07-09,"R11","Essendon",8,9,57,"University",11,9,75,"East Melbourne",-18,1910,"Regular",11,"Away","University","Essendon",18
1011,1910-07-09,"R11","St Kilda",4,10,34,"Fitzroy",8,14,62,"Junction Oval",-28,1910,"Regular",11,"Away","Fitzroy","St Kilda",28
1012,1910-07-09,"R11","Melbourne",4,10,34,"Richmond",12,15,87,"M.C.G.",-53,1910,"Regular",11,"Away","Richmond","Melbourne",53
1013,1910-07-16,"R12","Carlton",13,22,100,"Melbourne",4,11,35,"Princes Park",65,1910,"Regular",12,"Home","Carlton","Melbourne",65
1014,1910-07-16,"R12","St Kilda",6,8,44,"Collingwood",7,12,54,"Junction Oval",-10,1910,"Regular",12,"Away","Collingwood","St Kilda",10
1015,1910-07-16,"R12","Essendon",6,9,45,"Sydney",5,4,34,"East Melbourne",11,1910,"Regular",12,"Home","Essendon","Sydney",11
1016,1910-07-16,"R12","Geelong",11,6,72,"Fitzroy",4,9,33,"Corio Oval",39,1910,"Regular",12,"Home","Geelong","Fitzroy",39
1017,1910-07-16,"R12","Richmond",5,11,41,"University",10,7,67,"Punt Rd",-26,1910,"Regular",12,"Away","University","Richmond",26
1018,1910-07-23,"R13","Sydney",4,7,31,"Carlton",6,8,44,"Lake Oval",-13,1910,"Regular",13,"Away","Carlton","Sydney",13
1019,1910-07-23,"R13","Collingwood",5,13,43,"Essendon",2,9,21,"Victoria Park",22,1910,"Regular",13,"Home","Collingwood","Essendon",22
1020,1910-07-23,"R13","Fitzroy",3,7,25,"Richmond",5,5,35,"Brunswick St",-10,1910,"Regular",13,"Away","Richmond","Fitzroy",10
1021,1910-07-23,"R13","University",8,13,61,"Geelong",5,8,38,"East Melbourne",23,1910,"Regular",13,"Home","University","Geelong",23
1022,1910-07-23,"R13","Melbourne",6,12,48,"St Kilda",4,11,35,"M.C.G.",13,1910,"Regular",13,"Home","Melbourne","St Kilda",13
1023,1910-07-30,"R14","Carlton",5,13,43,"Fitzroy",4,16,40,"Princes Park",3,1910,"Regular",14,"Home","Carlton","Fitzroy",3
1024,1910-07-30,"R14","Melbourne",7,6,48,"Collingwood",9,12,66,"M.C.G.",-18,1910,"Regular",14,"Away","Collingwood","Melbourne",18
1025,1910-07-30,"R14","St Kilda",5,8,38,"Essendon",11,11,77,"Junction Oval",-39,1910,"Regular",14,"Away","Essendon","St Kilda",39
1026,1910-07-30,"R14","Richmond",5,12,42,"Geelong",6,6,42,"Punt Rd",0,1910,"Regular",14,"Home","Richmond","Geelong",0
1027,1910-07-30,"R14","University",3,6,24,"Sydney",10,7,67,"East Melbourne",-43,1910,"Regular",14,"Away","Sydney","University",43
1028,1910-08-06,"R15","Collingwood",7,12,54,"Fitzroy",6,6,42,"Victoria Park",12,1910,"Regular",15,"Home","Collingwood","Fitzroy",12
1029,1910-08-06,"R15","Sydney",11,12,78,"Geelong",3,8,26,"Lake Oval",52,1910,"Regular",15,"Home","Sydney","Geelong",52
1030,1910-08-06,"R15","Richmond",8,6,54,"St Kilda",1,10,16,"Punt Rd",38,1910,"Regular",15,"Home","Richmond","St Kilda",38
1031,1910-08-13,"R15","Carlton",11,12,78,"University",6,14,50,"Princes Park",28,1910,"Regular",15,"Home","Carlton","University",28
1032,1910-08-13,"R15","Essendon",4,18,42,"Melbourne",7,12,54,"East Melbourne",-12,1910,"Regular",15,"Away","Melbourne","Essendon",12
1033,1910-08-20,"R16","Essendon",8,12,60,"Carlton",7,10,52,"East Melbourne",8,1910,"Regular",16,"Home","Essendon","Carlton",8
1034,1910-08-20,"R16","Collingwood",8,13,61,"Richmond",5,4,34,"Victoria Park",27,1910,"Regular",16,"Home","Collingwood","Richmond",27
1035,1910-08-20,"R16","Fitzroy",3,5,23,"University",7,6,48,"Brunswick St",-25,1910,"Regular",16,"Away","University","Fitzroy",25
1036,1910-08-20,"R16","Geelong",7,11,53,"St Kilda",3,6,24,"Corio Oval",29,1910,"Regular",16,"Home","Geelong","St Kilda",29
1037,1910-08-20,"R16","Melbourne",8,6,54,"Sydney",8,10,58,"M.C.G.",-4,1910,"Regular",16,"Away","Sydney","Melbourne",4
1038,1910-08-27,"R17","Carlton",9,8,62,"Richmond",6,9,45,"Princes Park",17,1910,"Regular",17,"Home","Carlton","Richmond",17
1039,1910-08-27,"R17","University",9,5,59,"Collingwood",10,15,75,"East Melbourne",-16,1910,"Regular",17,"Away","Collingwood","University",16
1040,1910-08-27,"R17","Geelong",10,19,79,"Essendon",10,11,71,"Corio Oval",8,1910,"Regular",17,"Home","Geelong","Essendon",8
1041,1910-08-27,"R17","Fitzroy",12,16,88,"Melbourne",2,11,23,"Brunswick St",65,1910,"Regular",17,"Home","Fitzroy","Melbourne",65
1042,1910-08-27,"R17","Sydney",11,11,77,"St Kilda",10,5,65,"Lake Oval",12,1910,"Regular",17,"Home","Sydney","St Kilda",12
1043,1910-09-03,"R18","St Kilda",5,6,36,"Carlton",2,12,24,"Junction Oval",12,1910,"Regular",18,"Home","St Kilda","Carlton",12
1044,1910-09-03,"R18","Collingwood",4,13,37,"Geelong",2,9,21,"Victoria Park",16,1910,"Regular",18,"Home","Collingwood","Geelong",16
1045,1910-09-03,"R18","Essendon",6,14,50,"Richmond",7,9,51,"East Melbourne",-1,1910,"Regular",18,"Away","Richmond","Essendon",1
1046,1910-09-03,"R18","Sydney",7,10,52,"Fitzroy",4,5,29,"Lake Oval",23,1910,"Regular",18,"Home","Sydney","Fitzroy",23
1047,1910-09-03,"R18","Melbourne",9,6,60,"University",7,7,49,"M.C.G.",11,1910,"Regular",18,"Home","Melbourne","University",11
1048,1910-09-10,"SF","Collingwood",14,11,95,"Essendon",5,7,37,"M.C.G.",58,1910,"Finals",19,"Home","Collingwood","Essendon",58
1049,1910-09-17,"SF","Carlton",6,17,53,"Sydney",10,5,65,"M.C.G.",-12,1910,"Finals",19,"Away","Sydney","Carlton",12
1050,1910-09-24,"PF","Collingwood",8,7,55,"Sydney",6,8,44,"M.C.G.",11,1910,"Finals",20,"Home","Collingwood","Sydney",11
1051,1910-10-01,"GF","Carlton",6,11,47,"Collingwood",9,7,61,"M.C.G.",-14,1910,"Finals",21,"Away","Collingwood","Carlton",14
1052,1911-04-29,"R1","Essendon",5,15,45,"Carlton",6,9,45,"East Melbourne",0,1911,"Regular",1,"Home","Essendon","Carlton",0
1053,1911-04-29,"R1","Collingwood",14,10,94,"Richmond",9,11,65,"Victoria Park",29,1911,"Regular",1,"Home","Collingwood","Richmond",29
1054,1911-04-29,"R1","Melbourne",10,12,72,"Fitzroy",11,4,70,"M.C.G.",2,1911,"Regular",1,"Home","Melbourne","Fitzroy",2
1055,1911-04-29,"R1","St Kilda",10,6,66,"Geelong",7,15,57,"Junction Oval",9,1911,"Regular",1,"Home","St Kilda","Geelong",9
1056,1911-04-29,"R1","Sydney",14,18,102,"University",5,10,40,"Lake Oval",62,1911,"Regular",1,"Home","Sydney","University",62
1057,1911-05-06,"R2","Carlton",10,6,66,"Sydney",10,6,66,"Princes Park",0,1911,"Regular",2,"Home","Carlton","Sydney",0
1058,1911-05-06,"R2","Fitzroy",4,10,34,"Collingwood",7,7,49,"Brunswick St",-15,1911,"Regular",2,"Away","Collingwood","Fitzroy",15
1059,1911-05-06,"R2","Richmond",3,11,29,"Essendon",10,16,76,"Punt Rd",-47,1911,"Regular",2,"Away","Essendon","Richmond",47
1060,1911-05-06,"R2","Geelong",7,12,54,"Melbourne",7,12,54,"Corio Oval",0,1911,"Regular",2,"Home","Geelong","Melbourne",0
1061,1911-05-06,"R2","University",10,9,69,"St Kilda",6,7,43,"M.C.G.",26,1911,"Regular",2,"Home","University","St Kilda",26
1062,1911-05-13,"R3","Carlton",6,7,43,"Fitzroy",6,9,45,"Princes Park",-2,1911,"Regular",3,"Away","Fitzroy","Carlton",2
1063,1911-05-13,"R3","Collingwood",8,17,65,"Geelong",10,8,68,"Victoria Park",-3,1911,"Regular",3,"Away","Geelong","Collingwood",3
1064,1911-05-13,"R3","Melbourne",0,9,9,"Essendon",6,11,47,"M.C.G.",-38,1911,"Regular",3,"Away","Essendon","Melbourne",38
1065,1911-05-13,"R3","Richmond",6,17,53,"University",6,5,41,"Punt Rd",12,1911,"Regular",3,"Home","Richmond","University",12
1066,1911-05-13,"R3","St Kilda",2,5,17,"Sydney",10,13,73,"Junction Oval",-56,1911,"Regular",3,"Away","Sydney","St Kilda",56
1067,1911-05-20,"R4","University",6,8,44,"Carlton",9,11,65,"M.C.G.",-21,1911,"Regular",4,"Away","Carlton","University",21
1068,1911-05-20,"R4","Essendon",21,12,138,"Collingwood",7,11,53,"East Melbourne",85,1911,"Regular",4,"Home","Essendon","Collingwood",85
1069,1911-05-20,"R4","Fitzroy",10,24,84,"St Kilda",4,6,30,"Brunswick St",54,1911,"Regular",4,"Home","Fitzroy","St Kilda",54
1070,1911-05-20,"R4","Geelong",8,12,60,"Richmond",6,11,47,"Corio Oval",13,1911,"Regular",4,"Home","Geelong","Richmond",13
1071,1911-05-20,"R4","Sydney",12,13,85,"Melbourne",8,11,59,"Lake Oval",26,1911,"Regular",4,"Home","Sydney","Melbourne",26
1072,1911-05-27,"R5","Carlton",13,11,89,"Richmond",4,15,39,"Princes Park",50,1911,"Regular",5,"Home","Carlton","Richmond",50
1073,1911-05-27,"R5","Sydney",4,10,34,"Collingwood",5,10,40,"Lake Oval",-6,1911,"Regular",5,"Away","Collingwood","Sydney",6
1074,1911-05-27,"R5","Essendon",12,14,86,"University",6,6,42,"East Melbourne",44,1911,"Regular",5,"Home","Essendon","University",44
1075,1911-05-27,"R5","Fitzroy",8,17,65,"Geelong",4,8,32,"Brunswick St",33,1911,"Regular",5,"Home","Fitzroy","Geelong",33
1076,1911-05-27,"R5","Melbourne",9,15,69,"St Kilda",4,7,31,"M.C.G.",38,1911,"Regular",5,"Home","Melbourne","St Kilda",38
1077,1911-06-03,"R6","St Kilda",5,12,42,"Carlton",6,16,52,"Junction Oval",-10,1911,"Regular",6,"Away","Carlton","St Kilda",10
1078,1911-06-03,"R6","Collingwood",6,13,49,"Melbourne",5,13,43,"Victoria Park",6,1911,"Regular",6,"Home","Collingwood","Melbourne",6
1079,1911-06-03,"R6","Geelong",6,6,42,"Essendon",8,11,59,"Corio Oval",-17,1911,"Regular",6,"Away","Essendon","Geelong",17
1080,1911-06-03,"R6","University",5,12,42,"Fitzroy",10,16,76,"M.C.G.",-34,1911,"Regular",6,"Away","Fitzroy","University",34
1081,1911-06-03,"R6","Richmond",8,14,62,"Sydney",7,12,54,"Punt Rd",8,1911,"Regular",6,"Home","Richmond","Sydney",8
1082,1911-06-05,"R7","Geelong",7,7,49,"Carlton",5,8,38,"Corio Oval",11,1911,"Regular",7,"Home","Geelong","Carlton",11
1083,1911-06-05,"R7","Collingwood",10,17,77,"University",7,9,51,"Victoria Park",26,1911,"Regular",7,"Home","Collingwood","University",26
1084,1911-06-05,"R7","Essendon",9,10,64,"St Kilda",3,6,24,"East Melbourne",40,1911,"Regular",7,"Home","Essendon","St Kilda",40
1085,1911-06-05,"R7","Fitzroy",3,5,23,"Sydney",10,11,71,"Brunswick St",-48,1911,"Regular",7,"Away","Sydney","Fitzroy",48
1086,1911-06-05,"R7","Melbourne",6,12,48,"Richmond",9,15,69,"M.C.G.",-21,1911,"Regular",7,"Away","Richmond","Melbourne",21
1087,1911-06-10,"R8","Carlton",7,13,55,"Collingwood",2,10,22,"Princes Park",33,1911,"Regular",8,"Home","Carlton","Collingwood",33
1088,1911-06-10,"R8","Essendon",8,7,55,"Fitzroy",3,2,20,"East Melbourne",35,1911,"Regular",8,"Home","Essendon","Fitzroy",35
1089,1911-06-10,"R8","Sydney",7,10,52,"Geelong",5,9,39,"Lake Oval",13,1911,"Regular",8,"Home","Sydney","Geelong",13
1090,1911-06-10,"R8","University",5,9,39,"Melbourne",9,13,67,"M.C.G.",-28,1911,"Regular",8,"Away","Melbourne","University",28
1091,1911-06-10,"R8","St Kilda",3,8,26,"Richmond",6,6,42,"Junction Oval",-16,1911,"Regular",8,"Away","Richmond","St Kilda",16
1092,1911-06-17,"R9","Melbourne",9,2,56,"Carlton",13,11,89,"M.C.G.",-33,1911,"Regular",9,"Away","Carlton","Melbourne",33
1093,1911-06-17,"R9","Collingwood",12,13,85,"St Kilda",4,8,32,"Victoria Park",53,1911,"Regular",9,"Home","Collingwood","St Kilda",53
1094,1911-06-17,"R9","Sydney",6,8,44,"Essendon",5,11,41,"Lake Oval",3,1911,"Regular",9,"Home","Sydney","Essendon",3
1095,1911-06-17,"R9","Richmond",4,12,36,"Fitzroy",5,8,38,"Punt Rd",-2,1911,"Regular",9,"Away","Fitzroy","Richmond",2
1096,1911-06-17,"R9","Geelong",10,12,72,"University",9,6,60,"Corio Oval",12,1911,"Regular",9,"Home","Geelong","University",12
1097,1911-06-22,"R10","Richmond",4,6,30,"Collingwood",7,8,50,"Punt Rd",-20,1911,"Regular",10,"Away","Collingwood","Richmond",20
1098,1911-06-22,"R10","Fitzroy",8,15,63,"Melbourne",5,5,35,"Brunswick St",28,1911,"Regular",10,"Home","Fitzroy","Melbourne",28
1099,1911-06-24,"R10","Carlton",6,16,52,"Essendon",5,10,40,"Princes Park",12,1911,"Regular",10,"Home","Carlton","Essendon",12
1100,1911-06-24,"R10","Geelong",8,7,55,"St Kilda",6,4,40,"Corio Oval",15,1911,"Regular",10,"Home","Geelong","St Kilda",15
1101,1911-06-24,"R10","University",4,5,29,"Sydney",9,13,67,"M.C.G.",-38,1911,"Regular",10,"Away","Sydney","University",38
1102,1911-07-01,"R11","Sydney",12,8,80,"Carlton",9,11,65,"Lake Oval",15,1911,"Regular",11,"Home","Sydney","Carlton",15
1103,1911-07-01,"R11","Collingwood",9,7,61,"Fitzroy",10,12,72,"Victoria Park",-11,1911,"Regular",11,"Away","Fitzroy","Collingwood",11
1104,1911-07-01,"R11","Essendon",7,15,57,"Richmond",7,5,47,"East Melbourne",10,1911,"Regular",11,"Home","Essendon","Richmond",10
1105,1911-07-01,"R11","Melbourne",10,7,67,"Geelong",8,7,55,"M.C.G.",12,1911,"Regular",11,"Home","Melbourne","Geelong",12
1106,1911-07-01,"R11","St Kilda",15,11,101,"University",6,5,41,"Junction Oval",60,1911,"Regular",11,"Home","St Kilda","University",60
1107,1911-07-08,"R12","Fitzroy",5,13,43,"Carlton",6,10,46,"Brunswick St",-3,1911,"Regular",12,"Away","Carlton","Fitzroy",3
1108,1911-07-08,"R12","Geelong",6,7,43,"Collingwood",8,5,53,"Corio Oval",-10,1911,"Regular",12,"Away","Collingwood","Geelong",10
1109,1911-07-08,"R12","Essendon",7,15,57,"Melbourne",6,13,49,"East Melbourne",8,1911,"Regular",12,"Home","Essendon","Melbourne",8
1110,1911-07-08,"R12","University",3,8,26,"Richmond",6,10,46,"M.C.G.",-20,1911,"Regular",12,"Away","Richmond","University",20
1111,1911-07-08,"R12","Sydney",12,14,86,"St Kilda",6,13,49,"Lake Oval",37,1911,"Regular",12,"Home","Sydney","St Kilda",37
1112,1911-07-15,"R13","Carlton",9,12,66,"University",2,10,22,"Princes Park",44,1911,"Regular",13,"Home","Carlton","University",44
1113,1911-07-15,"R13","Collingwood",2,11,23,"Essendon",3,11,29,"Victoria Park",-6,1911,"Regular",13,"Away","Essendon","Collingwood",6
1114,1911-07-15,"R13","St Kilda",3,8,26,"Fitzroy",12,12,84,"Junction Oval",-58,1911,"Regular",13,"Away","Fitzroy","St Kilda",58
1115,1911-07-15,"R13","Richmond",11,14,80,"Geelong",8,12,60,"Punt Rd",20,1911,"Regular",13,"Home","Richmond","Geelong",20
1116,1911-07-15,"R13","Melbourne",7,7,49,"Sydney",9,8,62,"M.C.G.",-13,1911,"Regular",13,"Away","Sydney","Melbourne",13
1117,1911-07-22,"R14","Richmond",6,5,41,"Carlton",11,10,76,"Punt Rd",-35,1911,"Regular",14,"Away","Carlton","Richmond",35
1118,1911-07-22,"R14","Collingwood",5,6,36,"Sydney",5,7,37,"Victoria Park",-1,1911,"Regular",14,"Away","Sydney","Collingwood",1
1119,1911-07-22,"R14","University",6,6,42,"Essendon",12,8,80,"M.C.G.",-38,1911,"Regular",14,"Away","Essendon","University",38
1120,1911-07-22,"R14","St Kilda",5,9,39,"Melbourne",11,11,77,"Junction Oval",-38,1911,"Regular",14,"Away","Melbourne","St Kilda",38
1121,1911-07-22,"R14","Geelong",10,14,74,"Fitzroy",6,3,39,"Corio Oval",35,1911,"Regular",14,"Home","Geelong","Fitzroy",35
1122,1911-07-29,"R15","Carlton",18,21,129,"St Kilda",2,3,15,"Princes Park",114,1911,"Regular",15,"Home","Carlton","St Kilda",114
1123,1911-07-29,"R15","Melbourne",4,6,30,"Collingwood",6,16,52,"M.C.G.",-22,1911,"Regular",15,"Away","Collingwood","Melbourne",22
1124,1911-07-29,"R15","Essendon",9,7,61,"Geelong",4,11,35,"East Melbourne",26,1911,"Regular",15,"Home","Essendon","Geelong",26
1125,1911-07-29,"R15","Fitzroy",12,14,86,"University",7,7,49,"Brunswick St",37,1911,"Regular",15,"Home","Fitzroy","University",37
1126,1911-07-29,"R15","Sydney",8,25,73,"Richmond",5,7,37,"Lake Oval",36,1911,"Regular",15,"Home","Sydney","Richmond",36
1127,1911-08-19,"R16","Carlton",11,5,71,"Geelong",7,9,51,"Princes Park",20,1911,"Regular",16,"Home","Carlton","Geelong",20
1128,1911-08-19,"R16","University",0,9,9,"Collingwood",14,14,98,"M.C.G.",-89,1911,"Regular",16,"Away","Collingwood","University",89
1129,1911-08-19,"R16","St Kilda",5,8,38,"Essendon",24,19,163,"Junction Oval",-125,1911,"Regular",16,"Away","Essendon","St Kilda",125
1130,1911-08-19,"R16","Sydney",5,6,36,"Fitzroy",4,3,27,"Lake Oval",9,1911,"Regular",16,"Home","Sydney","Fitzroy",9
1131,1911-08-19,"R16","Richmond",7,9,51,"Melbourne",9,6,60,"Punt Rd",-9,1911,"Regular",16,"Away","Melbourne","Richmond",9
1132,1911-08-26,"R17","Collingwood",8,8,56,"Carlton",4,17,41,"Victoria Park",15,1911,"Regular",17,"Home","Collingwood","Carlton",15
1133,1911-08-26,"R17","Fitzroy",3,7,25,"Essendon",6,10,46,"Brunswick St",-21,1911,"Regular",17,"Away","Essendon","Fitzroy",21
1134,1911-08-26,"R17","Geelong",10,12,72,"Sydney",10,3,63,"Corio Oval",9,1911,"Regular",17,"Home","Geelong","Sydney",9
1135,1911-08-26,"R17","Melbourne",13,13,91,"University",4,5,29,"M.C.G.",62,1911,"Regular",17,"Home","Melbourne","University",62
1136,1911-08-26,"R17","Richmond",17,21,123,"St Kilda",5,6,36,"Punt Rd",87,1911,"Regular",17,"Home","Richmond","St Kilda",87
1137,1911-09-02,"R18","Carlton",9,8,62,"Melbourne",8,6,54,"Princes Park",8,1911,"Regular",18,"Home","Carlton","Melbourne",8
1138,1911-09-02,"R18","St Kilda",6,8,44,"Collingwood",15,11,101,"Junction Oval",-57,1911,"Regular",18,"Away","Collingwood","St Kilda",57
1139,1911-09-02,"R18","Essendon",9,9,63,"Sydney",8,10,58,"East Melbourne",5,1911,"Regular",18,"Home","Essendon","Sydney",5
1140,1911-09-02,"R18","Fitzroy",8,9,57,"Richmond",4,10,34,"Brunswick St",23,1911,"Regular",18,"Home","Fitzroy","Richmond",23
1141,1911-09-02,"R18","University",7,4,46,"Geelong",15,17,107,"M.C.G.",-61,1911,"Regular",18,"Away","Geelong","University",61
1142,1911-09-09,"SF","Sydney",6,11,47,"Collingwood",11,11,77,"M.C.G.",-30,1911,"Finals",19,"Away","Collingwood","Sydney",30
1143,1911-09-16,"SF","Essendon",9,15,69,"Carlton",6,12,48,"M.C.G.",21,1911,"Finals",19,"Home","Essendon","Carlton",21
1144,1911-09-23,"GF","Essendon",5,11,41,"Collingwood",4,11,35,"M.C.G.",6,1911,"Finals",20,"Home","Essendon","Collingwood",6
1145,1912-04-27,"R1","Carlton",9,16,70,"Geelong",4,7,31,"Princes Park",39,1912,"Regular",1,"Home","Carlton","Geelong",39
1146,1912-04-27,"R1","Melbourne",9,14,68,"Collingwood",5,9,39,"M.C.G.",29,1912,"Regular",1,"Home","Melbourne","Collingwood",29
1147,1912-04-27,"R1","Essendon",17,14,116,"University",6,6,42,"East Melbourne",74,1912,"Regular",1,"Home","Essendon","University",74
1148,1912-04-27,"R1","Sydney",7,5,47,"Fitzroy",4,10,34,"Lake Oval",13,1912,"Regular",1,"Home","Sydney","Fitzroy",13
1149,1912-04-27,"R1","St Kilda",6,10,46,"Richmond",7,11,53,"Junction Oval",-7,1912,"Regular",1,"Away","Richmond","St Kilda",7
1150,1912-05-04,"R2","Fitzroy",5,11,41,"Carlton",9,10,64,"Brunswick St",-23,1912,"Regular",2,"Away","Carlton","Fitzroy",23
1151,1912-05-04,"R2","Collingwood",6,17,53,"Essendon",10,10,70,"Victoria Park",-17,1912,"Regular",2,"Away","Essendon","Collingwood",17
1152,1912-05-04,"R2","University",8,12,60,"Melbourne",10,8,68,"M.C.G.",-8,1912,"Regular",2,"Away","Melbourne","University",8
1153,1912-05-04,"R2","Richmond",5,8,38,"Sydney",2,23,35,"Punt Rd",3,1912,"Regular",2,"Home","Richmond","Sydney",3
1154,1912-05-04,"R2","Geelong",13,15,93,"St Kilda",6,11,47,"Corio Oval",46,1912,"Regular",2,"Home","Geelong","St Kilda",46
1155,1912-05-11,"R3","Essendon",8,11,59,"Carlton",6,14,50,"East Melbourne",9,1912,"Regular",3,"Home","Essendon","Carlton",9
1156,1912-05-11,"R3","St Kilda",12,21,93,"Collingwood",4,12,36,"Junction Oval",57,1912,"Regular",3,"Home","St Kilda","Collingwood",57
1157,1912-05-11,"R3","Fitzroy",7,14,56,"Geelong",5,6,36,"Brunswick St",20,1912,"Regular",3,"Home","Fitzroy","Geelong",20
1158,1912-05-11,"R3","Sydney",6,18,54,"Melbourne",3,4,22,"Lake Oval",32,1912,"Regular",3,"Home","Sydney","Melbourne",32
1159,1912-05-11,"R3","University",9,9,63,"Richmond",6,12,48,"M.C.G.",15,1912,"Regular",3,"Home","University","Richmond",15
1160,1912-05-18,"R4","Carlton",6,9,45,"Collingwood",6,10,46,"Princes Park",-1,1912,"Regular",4,"Away","Collingwood","Carlton",1
1161,1912-05-18,"R4","Sydney",8,8,56,"Essendon",9,8,62,"Lake Oval",-6,1912,"Regular",4,"Away","Essendon","Sydney",6
1162,1912-05-18,"R4","Richmond",9,6,60,"Fitzroy",13,8,86,"Punt Rd",-26,1912,"Regular",4,"Away","Fitzroy","Richmond",26
1163,1912-05-18,"R4","Geelong",11,12,78,"Melbourne",5,5,35,"Corio Oval",43,1912,"Regular",4,"Home","Geelong","Melbourne",43
1164,1912-05-18,"R4","University",3,13,31,"St Kilda",7,14,56,"M.C.G.",-25,1912,"Regular",4,"Away","St Kilda","University",25
1165,1912-05-25,"R5","Melbourne",8,2,50,"Carlton",5,14,44,"M.C.G.",6,1912,"Regular",5,"Home","Melbourne","Carlton",6
1166,1912-05-25,"R5","Collingwood",10,12,72,"Richmond",6,4,40,"Victoria Park",32,1912,"Regular",5,"Home","Collingwood","Richmond",32
1167,1912-05-25,"R5","Essendon",7,7,49,"Geelong",7,10,52,"East Melbourne",-3,1912,"Regular",5,"Away","Geelong","Essendon",3
1168,1912-05-25,"R5","Fitzroy",8,11,59,"University",4,8,32,"Brunswick St",27,1912,"Regular",5,"Home","Fitzroy","University",27
1169,1912-05-25,"R5","St Kilda",5,5,35,"Sydney",7,8,50,"Junction Oval",-15,1912,"Regular",5,"Away","Sydney","St Kilda",15
1170,1912-06-01,"R6","Carlton",12,15,87,"St Kilda",6,11,47,"Princes Park",40,1912,"Regular",6,"Home","Carlton","St Kilda",40
1171,1912-06-01,"R6","Geelong",13,13,91,"Collingwood",2,15,27,"Corio Oval",64,1912,"Regular",6,"Home","Geelong","Collingwood",64
1172,1912-06-01,"R6","Richmond",10,10,70,"Essendon",13,14,92,"Punt Rd",-22,1912,"Regular",6,"Away","Essendon","Richmond",22
1173,1912-06-01,"R6","Fitzroy",11,12,78,"Melbourne",10,6,66,"Brunswick St",12,1912,"Regular",6,"Home","Fitzroy","Melbourne",12
1174,1912-06-01,"R6","University",5,8,38,"Sydney",9,16,70,"M.C.G.",-32,1912,"Regular",6,"Away","Sydney","University",32
1175,1912-06-03,"R7","Richmond",7,8,50,"Carlton",17,17,119,"Punt Rd",-69,1912,"Regular",7,"Away","Carlton","Richmond",69
1176,1912-06-03,"R7","Collingwood",10,13,73,"University",4,12,36,"Victoria Park",37,1912,"Regular",7,"Home","Collingwood","University",37
1177,1912-06-03,"R7","Melbourne",8,6,54,"Essendon",16,12,108,"M.C.G.",-54,1912,"Regular",7,"Away","Essendon","Melbourne",54
1178,1912-06-03,"R7","St Kilda",6,10,46,"Fitzroy",8,7,55,"Junction Oval",-9,1912,"Regular",7,"Away","Fitzroy","St Kilda",9
1179,1912-06-03,"R7","Sydney",13,15,93,"Geelong",8,13,61,"Lake Oval",32,1912,"Regular",7,"Home","Sydney","Geelong",32
1180,1912-06-08,"R8","Carlton",8,16,64,"Sydney",6,10,46,"Princes Park",18,1912,"Regular",8,"Home","Carlton","Sydney",18
1181,1912-06-08,"R8","Collingwood",13,10,88,"Fitzroy",11,7,73,"Victoria Park",15,1912,"Regular",8,"Home","Collingwood","Fitzroy",15
1182,1912-06-08,"R8","Essendon",6,19,55,"St Kilda",10,6,66,"East Melbourne",-11,1912,"Regular",8,"Away","St Kilda","Essendon",11
1183,1912-06-08,"R8","Geelong",8,15,63,"University",3,8,26,"Corio Oval",37,1912,"Regular",8,"Home","Geelong","University",37
1184,1912-06-08,"R8","Melbourne",14,14,98,"Richmond",4,9,33,"M.C.G.",65,1912,"Regular",8,"Home","Melbourne","Richmond",65
1185,1912-06-15,"R9","University",8,10,58,"Carlton",10,17,77,"M.C.G.",-19,1912,"Regular",9,"Away","Carlton","University",19
1186,1912-06-15,"R9","Sydney",4,16,40,"Collingwood",4,8,32,"Lake Oval",8,1912,"Regular",9,"Home","Sydney","Collingwood",8
1187,1912-06-15,"R9","Fitzroy",3,7,25,"Essendon",8,8,56,"Brunswick St",-31,1912,"Regular",9,"Away","Essendon","Fitzroy",31
1188,1912-06-15,"R9","Richmond",4,16,40,"Geelong",7,12,54,"Punt Rd",-14,1912,"Regular",9,"Away","Geelong","Richmond",14
1189,1912-06-15,"R9","St Kilda",2,12,24,"Melbourne",7,13,55,"Junction Oval",-31,1912,"Regular",9,"Away","Melbourne","St Kilda",31
1190,1912-06-22,"R10","Geelong",12,7,79,"Carlton",8,12,60,"Corio Oval",19,1912,"Regular",10,"Home","Geelong","Carlton",19
1191,1912-06-22,"R10","Collingwood",6,17,53,"Melbourne",6,9,45,"Victoria Park",8,1912,"Regular",10,"Home","Collingwood","Melbourne",8
1192,1912-06-22,"R10","University",7,10,52,"Essendon",16,24,120,"M.C.G.",-68,1912,"Regular",10,"Away","Essendon","University",68
1193,1912-06-22,"R10","Fitzroy",3,10,28,"Sydney",9,12,66,"Brunswick St",-38,1912,"Regular",10,"Away","Sydney","Fitzroy",38
1194,1912-06-22,"R10","Richmond",6,6,42,"St Kilda",12,14,86,"Punt Rd",-44,1912,"Regular",10,"Away","St Kilda","Richmond",44
1195,1912-06-29,"R11","Carlton",6,8,44,"Fitzroy",4,15,39,"Princes Park",5,1912,"Regular",11,"Home","Carlton","Fitzroy",5
1196,1912-06-29,"R11","Essendon",6,18,54,"Collingwood",6,10,46,"East Melbourne",8,1912,"Regular",11,"Home","Essendon","Collingwood",8
1197,1912-06-29,"R11","St Kilda",12,11,83,"Geelong",9,14,68,"Junction Oval",15,1912,"Regular",11,"Home","St Kilda","Geelong",15
1198,1912-06-29,"R11","Melbourne",13,14,92,"University",5,7,37,"M.C.G.",55,1912,"Regular",11,"Home","Melbourne","University",55
1199,1912-06-29,"R11","Sydney",19,12,126,"Richmond",5,7,37,"Lake Oval",89,1912,"Regular",11,"Home","Sydney","Richmond",89
1200,1912-07-13,"R12","Carlton",10,16,76,"Essendon",4,9,33,"Princes Park",43,1912,"Regular",12,"Home","Carlton","Essendon",43
1201,1912-07-13,"R12","Collingwood",8,15,63,"St Kilda",6,4,40,"Victoria Park",23,1912,"Regular",12,"Home","Collingwood","St Kilda",23
1202,1912-07-13,"R12","Geelong",10,13,73,"Fitzroy",5,10,40,"Corio Oval",33,1912,"Regular",12,"Home","Geelong","Fitzroy",33
1203,1912-07-13,"R12","Melbourne",0,8,8,"Sydney",13,8,86,"M.C.G.",-78,1912,"Regular",12,"Away","Sydney","Melbourne",78
1204,1912-07-13,"R12","Richmond",11,19,85,"University",4,4,28,"Punt Rd",57,1912,"Regular",12,"Home","Richmond","University",57
1205,1912-07-20,"R13","Collingwood",3,14,32,"Carlton",8,7,55,"Victoria Park",-23,1912,"Regular",13,"Away","Carlton","Collingwood",23
1206,1912-07-20,"R13","Essendon",7,10,52,"Sydney",9,11,65,"East Melbourne",-13,1912,"Regular",13,"Away","Sydney","Essendon",13
1207,1912-07-20,"R13","Fitzroy",10,10,70,"Richmond",3,11,29,"Brunswick St",41,1912,"Regular",13,"Home","Fitzroy","Richmond",41
1208,1912-07-20,"R13","Melbourne",7,12,54,"Geelong",5,13,43,"M.C.G.",11,1912,"Regular",13,"Home","Melbourne","Geelong",11
1209,1912-07-20,"R13","St Kilda",15,12,102,"University",6,14,50,"Junction Oval",52,1912,"Regular",13,"Home","St Kilda","University",52
1210,1912-07-27,"R14","Carlton",4,18,42,"Melbourne",5,7,37,"Princes Park",5,1912,"Regular",14,"Home","Carlton","Melbourne",5
1211,1912-07-27,"R14","Richmond",6,4,40,"Collingwood",10,15,75,"Punt Rd",-35,1912,"Regular",14,"Away","Collingwood","Richmond",35
1212,1912-07-27,"R14","Geelong",13,14,92,"Essendon",5,10,40,"Corio Oval",52,1912,"Regular",14,"Home","Geelong","Essendon",52
1213,1912-07-27,"R14","University",7,8,50,"Fitzroy",12,14,86,"M.C.G.",-36,1912,"Regular",14,"Away","Fitzroy","University",36
1214,1912-07-27,"R14","Sydney",14,7,91,"St Kilda",7,18,60,"Lake Oval",31,1912,"Regular",14,"Home","Sydney","St Kilda",31
1215,1912-08-03,"R15","St Kilda",6,15,51,"Carlton",7,12,54,"Junction Oval",-3,1912,"Regular",15,"Away","Carlton","St Kilda",3
1216,1912-08-03,"R15","Collingwood",7,15,57,"Geelong",6,8,44,"Victoria Park",13,1912,"Regular",15,"Home","Collingwood","Geelong",13
1217,1912-08-03,"R15","Essendon",10,12,72,"Richmond",5,13,43,"East Melbourne",29,1912,"Regular",15,"Home","Essendon","Richmond",29
1218,1912-08-03,"R15","Melbourne",6,6,42,"Fitzroy",6,7,43,"M.C.G.",-1,1912,"Regular",15,"Away","Fitzroy","Melbourne",1
1219,1912-08-03,"R15","Sydney",12,13,85,"University",7,5,47,"Lake Oval",38,1912,"Regular",15,"Home","Sydney","University",38
1220,1912-08-17,"R16","Carlton",8,20,68,"Richmond",8,11,59,"Princes Park",9,1912,"Regular",16,"Home","Carlton","Richmond",9
1221,1912-08-17,"R16","University",6,7,43,"Collingwood",6,20,56,"M.C.G.",-13,1912,"Regular",16,"Away","Collingwood","University",13
1222,1912-08-17,"R16","Essendon",9,8,62,"Melbourne",7,8,50,"East Melbourne",12,1912,"Regular",16,"Home","Essendon","Melbourne",12
1223,1912-08-17,"R16","Fitzroy",12,17,89,"St Kilda",8,7,55,"Brunswick St",34,1912,"Regular",16,"Home","Fitzroy","St Kilda",34
1224,1912-08-17,"R16","Geelong",4,8,32,"Sydney",6,15,51,"Corio Oval",-19,1912,"Regular",16,"Away","Sydney","Geelong",19
1225,1912-08-24,"R17","Sydney",6,10,46,"Carlton",7,10,52,"Lake Oval",-6,1912,"Regular",17,"Away","Carlton","Sydney",6
1226,1912-08-24,"R17","Fitzroy",9,11,65,"Collingwood",4,3,27,"Brunswick St",38,1912,"Regular",17,"Home","Fitzroy","Collingwood",38
1227,1912-08-24,"R17","St Kilda",15,18,108,"Essendon",7,8,50,"Junction Oval",58,1912,"Regular",17,"Home","St Kilda","Essendon",58
1228,1912-08-24,"R17","University",7,8,50,"Geelong",12,22,94,"M.C.G.",-44,1912,"Regular",17,"Away","Geelong","University",44
1229,1912-08-24,"R17","Richmond",9,9,63,"Melbourne",11,7,73,"Punt Rd",-10,1912,"Regular",17,"Away","Melbourne","Richmond",10
1230,1912-08-31,"R18","Carlton",10,14,74,"University",10,9,69,"Princes Park",5,1912,"Regular",18,"Home","Carlton","University",5
1231,1912-08-31,"R18","Collingwood",5,7,37,"Sydney",7,11,53,"Victoria Park",-16,1912,"Regular",18,"Away","Sydney","Collingwood",16
1232,1912-08-31,"R18","Essendon",7,13,55,"Fitzroy",6,13,49,"East Melbourne",6,1912,"Regular",18,"Home","Essendon","Fitzroy",6
1233,1912-08-31,"R18","Geelong",9,16,70,"Richmond",4,9,33,"Corio Oval",37,1912,"Regular",18,"Home","Geelong","Richmond",37
1234,1912-08-31,"R18","Melbourne",9,14,68,"St Kilda",7,7,49,"M.C.G.",19,1912,"Regular",18,"Home","Melbourne","St Kilda",19
1235,1912-09-07,"SF","Carlton",10,11,71,"Geelong",4,19,43,"M.C.G.",28,1912,"Finals",19,"Home","Carlton","Geelong",28
1236,1912-09-14,"SF","Sydney",6,6,42,"Essendon",7,12,54,"M.C.G.",-12,1912,"Finals",19,"Away","Essendon","Sydney",12
1237,1912-09-21,"PF","Carlton",6,12,48,"Essendon",7,10,52,"M.C.G.",-4,1912,"Finals",20,"Away","Essendon","Carlton",4
1238,1912-09-28,"GF","Sydney",4,9,33,"Essendon",5,17,47,"M.C.G.",-14,1912,"Finals",21,"Away","Essendon","Sydney",14
1239,1913-04-26,"R1","Essendon",9,13,67,"Carlton",11,17,83,"East Melbourne",-16,1913,"Regular",1,"Away","Carlton","Essendon",16
1240,1913-04-26,"R1","Melbourne",5,7,37,"Collingwood",8,12,60,"M.C.G.",-23,1913,"Regular",1,"Away","Collingwood","Melbourne",23
1241,1913-04-26,"R1","Fitzroy",10,19,79,"University",5,7,37,"Brunswick St",42,1913,"Regular",1,"Home","Fitzroy","University",42
1242,1913-04-26,"R1","Geelong",7,13,55,"Richmond",5,7,37,"Corio Oval",18,1913,"Regular",1,"Home","Geelong","Richmond",18
1243,1913-04-26,"R1","Sydney",8,15,63,"St Kilda",8,6,54,"Lake Oval",9,1913,"Regular",1,"Home","Sydney","St Kilda",9
1244,1913-05-03,"R2","Carlton",8,13,61,"Sydney",9,7,61,"Princes Park",0,1913,"Regular",2,"Home","Carlton","Sydney",0
1245,1913-05-03,"R2","Collingwood",10,17,77,"Geelong",11,2,68,"Victoria Park",9,1913,"Regular",2,"Home","Collingwood","Geelong",9
1246,1913-05-03,"R2","Richmond",11,12,78,"Essendon",13,11,89,"Punt Rd",-11,1913,"Regular",2,"Away","Essendon","Richmond",11
1247,1913-05-03,"R2","St Kilda",10,7,67,"Fitzroy",3,16,34,"Junction Oval",33,1913,"Regular",2,"Home","St Kilda","Fitzroy",33
1248,1913-05-03,"R2","University",10,12,72,"Melbourne",14,15,99,"M.C.G.",-27,1913,"Regular",2,"Away","Melbourne","University",27
1249,1913-05-10,"R3","Carlton",11,13,79,"Melbourne",7,11,53,"Princes Park",26,1913,"Regular",3,"Home","Carlton","Melbourne",26
1250,1913-05-10,"R3","Essendon",10,5,65,"Collingwood",10,10,70,"East Melbourne",-5,1913,"Regular",3,"Away","Collingwood","Essendon",5
1251,1913-05-10,"R3","Fitzroy",8,14,62,"Geelong",6,7,43,"Brunswick St",19,1913,"Regular",3,"Home","Fitzroy","Geelong",19
1252,1913-05-10,"R3","Sydney",8,9,57,"Richmond",9,2,56,"Lake Oval",1,1913,"Regular",3,"Home","Sydney","Richmond",1
1253,1913-05-10,"R3","University",9,11,65,"St Kilda",10,13,73,"M.C.G.",-8,1913,"Regular",3,"Away","St Kilda","University",8
1254,1913-05-17,"R4","Collingwood",6,8,44,"Carlton",5,8,38,"Victoria Park",6,1913,"Regular",4,"Home","Collingwood","Carlton",6
1255,1913-05-17,"R4","Essendon",7,14,56,"Sydney",15,13,103,"East Melbourne",-47,1913,"Regular",4,"Away","Sydney","Essendon",47
1256,1913-05-17,"R4","Melbourne",4,7,31,"Fitzroy",7,11,53,"M.C.G.",-22,1913,"Regular",4,"Away","Fitzroy","Melbourne",22
1257,1913-05-17,"R4","Geelong",14,14,98,"University",7,9,51,"Corio Oval",47,1913,"Regular",4,"Home","Geelong","University",47
1258,1913-05-17,"R4","Richmond",9,14,68,"St Kilda",7,12,54,"Punt Rd",14,1913,"Regular",4,"Home","Richmond","St Kilda",14
1259,1913-05-24,"R5","University",8,8,56,"Carlton",10,12,72,"M.C.G.",-16,1913,"Regular",5,"Away","Carlton","University",16
1260,1913-05-24,"R5","Collingwood",9,16,70,"Richmond",6,12,48,"Victoria Park",22,1913,"Regular",5,"Home","Collingwood","Richmond",22
1261,1913-05-24,"R5","Fitzroy",7,9,51,"Essendon",5,6,36,"Brunswick St",15,1913,"Regular",5,"Home","Fitzroy","Essendon",15
1262,1913-05-24,"R5","Geelong",7,15,57,"Sydney",9,17,71,"Corio Oval",-14,1913,"Regular",5,"Away","Sydney","Geelong",14
1263,1913-05-24,"R5","St Kilda",8,13,61,"Melbourne",7,14,56,"Junction Oval",5,1913,"Regular",5,"Home","St Kilda","Melbourne",5
1264,1913-05-31,"R6","Carlton",4,13,37,"St Kilda",3,6,24,"Princes Park",13,1913,"Regular",6,"Home","Carlton","St Kilda",13
1265,1913-05-31,"R6","University",2,8,20,"Collingwood",7,12,54,"M.C.G.",-34,1913,"Regular",6,"Away","Collingwood","University",34
1266,1913-05-31,"R6","Essendon",3,5,23,"Geelong",6,11,47,"East Melbourne",-24,1913,"Regular",6,"Away","Geelong","Essendon",24
1267,1913-05-31,"R6","Fitzroy",6,7,43,"Richmond",5,6,36,"Brunswick St",7,1913,"Regular",6,"Home","Fitzroy","Richmond",7
1268,1913-05-31,"R6","Sydney",6,16,52,"Melbourne",4,4,28,"Lake Oval",24,1913,"Regular",6,"Home","Sydney","Melbourne",24
1269,1913-06-07,"R7","Richmond",8,13,61,"Carlton",10,7,67,"Punt Rd",-6,1913,"Regular",7,"Away","Carlton","Richmond",6
1270,1913-06-07,"R7","Collingwood",13,11,89,"St Kilda",7,12,54,"Victoria Park",35,1913,"Regular",7,"Home","Collingwood","St Kilda",35
1271,1913-06-07,"R7","Essendon",14,22,106,"University",6,5,41,"East Melbourne",65,1913,"Regular",7,"Home","Essendon","University",65
1272,1913-06-07,"R7","Sydney",7,8,50,"Fitzroy",11,17,83,"Lake Oval",-33,1913,"Regular",7,"Away","Fitzroy","Sydney",33
1273,1913-06-07,"R7","Melbourne",7,10,52,"Geelong",12,12,84,"M.C.G.",-32,1913,"Regular",7,"Away","Geelong","Melbourne",32
1274,1913-06-09,"R8","Geelong",7,12,54,"Carlton",9,15,69,"Corio Oval",-15,1913,"Regular",8,"Away","Carlton","Geelong",15
1275,1913-06-09,"R8","Collingwood",5,7,37,"Fitzroy",6,11,47,"Victoria Park",-10,1913,"Regular",8,"Away","Fitzroy","Collingwood",10
1276,1913-06-09,"R8","St Kilda",9,11,65,"Essendon",7,13,55,"Junction Oval",10,1913,"Regular",8,"Home","St Kilda","Essendon",10
1277,1913-06-09,"R8","Richmond",7,10,52,"Melbourne",5,10,40,"Punt Rd",12,1913,"Regular",8,"Home","Richmond","Melbourne",12
1278,1913-06-09,"R8","University",10,9,69,"Sydney",13,12,90,"M.C.G.",-21,1913,"Regular",8,"Away","Sydney","University",21
1279,1913-06-14,"R9","Fitzroy",14,15,99,"Carlton",9,10,64,"Brunswick St",35,1913,"Regular",9,"Home","Fitzroy","Carlton",35
1280,1913-06-14,"R9","Sydney",10,15,75,"Collingwood",7,9,51,"Lake Oval",24,1913,"Regular",9,"Home","Sydney","Collingwood",24
1281,1913-06-14,"R9","Essendon",9,17,71,"Melbourne",3,12,30,"East Melbourne",41,1913,"Regular",9,"Home","Essendon","Melbourne",41
1282,1913-06-14,"R9","St Kilda",11,12,78,"Geelong",10,11,71,"Junction Oval",7,1913,"Regular",9,"Home","St Kilda","Geelong",7
1283,1913-06-14,"R9","University",5,10,40,"Richmond",12,11,83,"M.C.G.",-43,1913,"Regular",9,"Away","Richmond","University",43
1284,1913-06-21,"R10","Carlton",15,15,105,"Essendon",11,12,78,"Princes Park",27,1913,"Regular",10,"Home","Carlton","Essendon",27
1285,1913-06-21,"R10","Collingwood",14,11,95,"Melbourne",6,11,47,"Victoria Park",48,1913,"Regular",10,"Home","Collingwood","Melbourne",48
1286,1913-06-21,"R10","University",5,5,35,"Fitzroy",10,15,75,"M.C.G.",-40,1913,"Regular",10,"Away","Fitzroy","University",40
1287,1913-06-21,"R10","Richmond",12,9,81,"Geelong",8,15,63,"Punt Rd",18,1913,"Regular",10,"Home","Richmond","Geelong",18
1288,1913-06-21,"R10","St Kilda",9,11,65,"Sydney",13,14,92,"Junction Oval",-27,1913,"Regular",10,"Away","Sydney","St Kilda",27
1289,1913-06-28,"R11","Sydney",12,16,88,"Carlton",5,11,41,"Lake Oval",47,1913,"Regular",11,"Home","Sydney","Carlton",47
1290,1913-06-28,"R11","Geelong",8,12,60,"Collingwood",11,5,71,"Corio Oval",-11,1913,"Regular",11,"Away","Collingwood","Geelong",11
1291,1913-06-28,"R11","Essendon",8,9,57,"Richmond",10,7,67,"East Melbourne",-10,1913,"Regular",11,"Away","Richmond","Essendon",10
1292,1913-06-28,"R11","Fitzroy",7,11,53,"St Kilda",5,9,39,"Brunswick St",14,1913,"Regular",11,"Home","Fitzroy","St Kilda",14
1293,1913-06-28,"R11","Melbourne",7,20,62,"University",7,11,53,"M.C.G.",9,1913,"Regular",11,"Home","Melbourne","University",9
1294,1913-07-05,"R12","Melbourne",10,7,67,"Carlton",7,12,54,"M.C.G.",13,1913,"Regular",12,"Home","Melbourne","Carlton",13
1295,1913-07-05,"R12","Collingwood",10,12,72,"Essendon",7,12,54,"Victoria Park",18,1913,"Regular",12,"Home","Collingwood","Essendon",18
1296,1913-07-05,"R12","Geelong",11,12,78,"Fitzroy",8,13,61,"Corio Oval",17,1913,"Regular",12,"Home","Geelong","Fitzroy",17
1297,1913-07-05,"R12","Richmond",3,17,35,"Sydney",8,11,59,"Punt Rd",-24,1913,"Regular",12,"Away","Sydney","Richmond",24
1298,1913-07-05,"R12","St Kilda",18,20,128,"University",7,14,56,"Junction Oval",72,1913,"Regular",12,"Home","St Kilda","University",72
1299,1913-07-19,"R13","Carlton",6,18,54,"Collingwood",11,11,77,"Princes Park",-23,1913,"Regular",13,"Away","Collingwood","Carlton",23
1300,1913-07-19,"R13","Sydney",5,12,42,"Essendon",7,20,62,"Lake Oval",-20,1913,"Regular",13,"Away","Essendon","Sydney",20
1301,1913-07-19,"R13","Fitzroy",12,14,86,"Melbourne",3,10,28,"Brunswick St",58,1913,"Regular",13,"Home","Fitzroy","Melbourne",58
1302,1913-07-19,"R13","University",5,6,36,"Geelong",17,18,120,"M.C.G.",-84,1913,"Regular",13,"Away","Geelong","University",84
1303,1913-07-19,"R13","St Kilda",9,8,62,"Richmond",5,6,36,"Junction Oval",26,1913,"Regular",13,"Home","St Kilda","Richmond",26
1304,1913-07-26,"R14","Carlton",9,22,76,"University",3,8,26,"Princes Park",50,1913,"Regular",14,"Home","Carlton","University",50
1305,1913-07-26,"R14","Richmond",5,15,45,"Collingwood",10,9,69,"Punt Rd",-24,1913,"Regular",14,"Away","Collingwood","Richmond",24
1306,1913-07-26,"R14","Essendon",4,12,36,"Fitzroy",7,12,54,"East Melbourne",-18,1913,"Regular",14,"Away","Fitzroy","Essendon",18
1307,1913-07-26,"R14","Sydney",12,10,82,"Geelong",9,12,66,"Lake Oval",16,1913,"Regular",14,"Home","Sydney","Geelong",16
1308,1913-07-26,"R14","Melbourne",5,5,35,"St Kilda",9,17,71,"M.C.G.",-36,1913,"Regular",14,"Away","St Kilda","Melbourne",36
1309,1913-08-02,"R15","St Kilda",10,10,70,"Carlton",11,3,69,"Junction Oval",1,1913,"Regular",15,"Home","St Kilda","Carlton",1
1310,1913-08-02,"R15","Collingwood",12,15,87,"University",10,10,70,"Victoria Park",17,1913,"Regular",15,"Home","Collingwood","University",17
1311,1913-08-02,"R15","Geelong",11,10,76,"Essendon",8,5,53,"Corio Oval",23,1913,"Regular",15,"Home","Geelong","Essendon",23
1312,1913-08-02,"R15","Richmond",6,10,46,"Fitzroy",11,13,79,"Punt Rd",-33,1913,"Regular",15,"Away","Fitzroy","Richmond",33
1313,1913-08-02,"R15","Melbourne",2,7,19,"Sydney",5,18,48,"M.C.G.",-29,1913,"Regular",15,"Away","Sydney","Melbourne",29
1314,1913-08-09,"R16","Carlton",9,9,63,"Richmond",7,9,51,"Princes Park",12,1913,"Regular",16,"Home","Carlton","Richmond",12
1315,1913-08-09,"R16","St Kilda",12,10,82,"Collingwood",6,8,44,"Junction Oval",38,1913,"Regular",16,"Home","St Kilda","Collingwood",38
1316,1913-08-09,"R16","University",8,12,60,"Essendon",9,8,62,"M.C.G.",-2,1913,"Regular",16,"Away","Essendon","University",2
1317,1913-08-09,"R16","Fitzroy",8,11,59,"Sydney",7,14,56,"Brunswick St",3,1913,"Regular",16,"Home","Fitzroy","Sydney",3
1318,1913-08-09,"R16","Geelong",4,23,47,"Melbourne",4,2,26,"Corio Oval",21,1913,"Regular",16,"Home","Geelong","Melbourne",21
1319,1913-08-23,"R17","Carlton",6,10,46,"Geelong",9,15,69,"Princes Park",-23,1913,"Regular",17,"Away","Geelong","Carlton",23
1320,1913-08-23,"R17","Fitzroy",9,10,64,"Collingwood",4,13,37,"Brunswick St",27,1913,"Regular",17,"Home","Fitzroy","Collingwood",27
1321,1913-08-23,"R17","Essendon",7,8,50,"St Kilda",9,8,62,"East Melbourne",-12,1913,"Regular",17,"Away","St Kilda","Essendon",12
1322,1913-08-23,"R17","Melbourne",9,10,64,"Richmond",8,5,53,"Punt Rd",11,1913,"Regular",17,"Home","Melbourne","Richmond",11
1323,1913-08-23,"R17","Sydney",17,9,111,"University",8,13,61,"Lake Oval",50,1913,"Regular",17,"Home","Sydney","University",50
1324,1913-08-30,"R18","Carlton",4,8,32,"Fitzroy",7,13,55,"Princes Park",-23,1913,"Regular",18,"Away","Fitzroy","Carlton",23
1325,1913-08-30,"R18","Collingwood",7,12,54,"Sydney",8,8,56,"Victoria Park",-2,1913,"Regular",18,"Away","Sydney","Collingwood",2
1326,1913-08-30,"R18","Melbourne",6,6,42,"Essendon",6,16,52,"M.C.G.",-10,1913,"Regular",18,"Away","Essendon","Melbourne",10
1327,1913-08-30,"R18","Geelong",15,18,108,"St Kilda",5,10,40,"Corio Oval",68,1913,"Regular",18,"Home","Geelong","St Kilda",68
1328,1913-08-30,"R18","Richmond",15,11,101,"University",8,11,59,"Punt Rd",42,1913,"Regular",18,"Home","Richmond","University",42
1329,1913-09-06,"SF","Sydney",6,15,51,"St Kilda",12,12,84,"M.C.G.",-33,1913,"Finals",19,"Away","St Kilda","Sydney",33
1330,1913-09-13,"SF","Fitzroy",11,14,80,"Collingwood",6,7,43,"M.C.G.",37,1913,"Finals",19,"Home","Fitzroy","Collingwood",37
1331,1913-09-20,"PF","Fitzroy",6,9,45,"St Kilda",10,10,70,"M.C.G.",-25,1913,"Finals",20,"Away","St Kilda","Fitzroy",25
1332,1913-09-27,"GF","Fitzroy",7,14,56,"St Kilda",5,13,43,"M.C.G.",13,1913,"Finals",21,"Home","Fitzroy","St Kilda",13
1333,1914-04-25,"R1","Collingwood",8,8,56,"Carlton",6,20,56,"Victoria Park",0,1914,"Regular",1,"Home","Collingwood","Carlton",0
1334,1914-04-25,"R1","Geelong",8,13,61,"Essendon",8,13,61,"Corio Oval",0,1914,"Regular",1,"Home","Geelong","Essendon",0
1335,1914-04-25,"R1","Fitzroy",13,15,93,"Melbourne",5,7,37,"Brunswick St",56,1914,"Regular",1,"Home","Fitzroy","Melbourne",56
1336,1914-04-25,"R1","St Kilda",8,16,64,"Richmond",5,12,42,"Junction Oval",22,1914,"Regular",1,"Home","St Kilda","Richmond",22
1337,1914-04-25,"R1","University",6,8,44,"Sydney",14,14,98,"M.C.G.",-54,1914,"Regular",1,"Away","Sydney","University",54
1338,1914-05-02,"R2","Carlton",4,11,35,"St Kilda",6,12,48,"Princes Park",-13,1914,"Regular",2,"Away","St Kilda","Carlton",13
1339,1914-05-02,"R2","Melbourne",6,7,43,"Collingwood",9,13,67,"M.C.G.",-24,1914,"Regular",2,"Away","Collingwood","Melbourne",24
1340,1914-05-02,"R2","Essendon",12,14,86,"University",7,8,50,"East Melbourne",36,1914,"Regular",2,"Home","Essendon","University",36
1341,1914-05-02,"R2","Richmond",3,10,28,"Fitzroy",9,15,69,"Punt Rd",-41,1914,"Regular",2,"Away","Fitzroy","Richmond",41
1342,1914-05-02,"R2","Sydney",8,14,62,"Geelong",7,9,51,"Lake Oval",11,1914,"Regular",2,"Home","Sydney","Geelong",11
1343,1914-05-09,"R3","University",4,8,32,"Carlton",13,24,102,"M.C.G.",-70,1914,"Regular",3,"Away","Carlton","University",70
1344,1914-05-09,"R3","Collingwood",12,18,90,"Richmond",4,12,36,"Victoria Park",54,1914,"Regular",3,"Home","Collingwood","Richmond",54
1345,1914-05-09,"R3","St Kilda",7,10,52,"Essendon",9,15,69,"Junction Oval",-17,1914,"Regular",3,"Away","Essendon","St Kilda",17
1346,1914-05-09,"R3","Fitzroy",9,12,66,"Sydney",11,8,74,"Brunswick St",-8,1914,"Regular",3,"Away","Sydney","Fitzroy",8
1347,1914-05-09,"R3","Geelong",10,14,74,"Melbourne",9,4,58,"Corio Oval",16,1914,"Regular",3,"Home","Geelong","Melbourne",16
1348,1914-05-16,"R4","Sydney",8,4,52,"Carlton",7,10,52,"Lake Oval",0,1914,"Regular",4,"Home","Sydney","Carlton",0
1349,1914-05-16,"R4","Fitzroy",7,12,54,"Collingwood",7,10,52,"Brunswick St",2,1914,"Regular",4,"Home","Fitzroy","Collingwood",2
1350,1914-05-16,"R4","Essendon",7,11,53,"Richmond",7,7,49,"East Melbourne",4,1914,"Regular",4,"Home","Essendon","Richmond",4
1351,1914-05-16,"R4","University",11,5,71,"Geelong",13,9,87,"M.C.G.",-16,1914,"Regular",4,"Away","Geelong","University",16
1352,1914-05-16,"R4","St Kilda",17,13,115,"Melbourne",8,7,55,"Junction Oval",60,1914,"Regular",4,"Home","St Kilda","Melbourne",60
1353,1914-05-23,"R5","Carlton",4,4,28,"Fitzroy",6,10,46,"Princes Park",-18,1914,"Regular",5,"Away","Fitzroy","Carlton",18
1354,1914-05-23,"R5","Collingwood",18,17,125,"University",7,11,53,"Victoria Park",72,1914,"Regular",5,"Home","Collingwood","University",72
1355,1914-05-23,"R5","Melbourne",5,7,37,"Essendon",5,24,54,"M.C.G.",-17,1914,"Regular",5,"Away","Essendon","Melbourne",17
1356,1914-05-23,"R5","Richmond",10,17,77,"Geelong",6,17,53,"Punt Rd",24,1914,"Regular",5,"Home","Richmond","Geelong",24
1357,1914-05-23,"R5","Sydney",11,11,77,"St Kilda",9,12,66,"Lake Oval",11,1914,"Regular",5,"Home","Sydney","St Kilda",11
1358,1914-05-30,"R6","Carlton",13,19,97,"Melbourne",5,9,39,"Princes Park",58,1914,"Regular",6,"Home","Carlton","Melbourne",58
1359,1914-05-30,"R6","St Kilda",12,10,82,"Collingwood",5,14,44,"Junction Oval",38,1914,"Regular",6,"Home","St Kilda","Collingwood",38
1360,1914-05-30,"R6","Essendon",5,11,41,"Sydney",5,13,43,"East Melbourne",-2,1914,"Regular",6,"Away","Sydney","Essendon",2
1361,1914-05-30,"R6","Geelong",4,8,32,"Fitzroy",6,4,40,"Corio Oval",-8,1914,"Regular",6,"Away","Fitzroy","Geelong",8
1362,1914-05-30,"R6","University",5,6,36,"Richmond",16,14,110,"M.C.G.",-74,1914,"Regular",6,"Away","Richmond","University",74
1363,1914-06-06,"R7","Geelong",9,11,65,"Carlton",3,16,34,"Corio Oval",31,1914,"Regular",7,"Home","Geelong","Carlton",31
1364,1914-06-06,"R7","Collingwood",11,12,78,"Essendon",9,9,63,"Victoria Park",15,1914,"Regular",7,"Home","Collingwood","Essendon",15
1365,1914-06-06,"R7","Fitzroy",10,13,73,"St Kilda",7,6,48,"Brunswick St",25,1914,"Regular",7,"Home","Fitzroy","St Kilda",25
1366,1914-06-06,"R7","Melbourne",14,9,93,"University",5,16,46,"M.C.G.",47,1914,"Regular",7,"Home","Melbourne","University",47
1367,1914-06-06,"R7","Richmond",4,12,36,"Sydney",7,12,54,"Punt Rd",-18,1914,"Regular",7,"Away","Sydney","Richmond",18
1368,1914-06-08,"R8","Essendon",6,3,39,"Carlton",11,10,76,"East Melbourne",-37,1914,"Regular",8,"Away","Carlton","Essendon",37
1369,1914-06-08,"R8","Sydney",5,13,43,"Collingwood",6,10,46,"Lake Oval",-3,1914,"Regular",8,"Away","Collingwood","Sydney",3
1370,1914-06-08,"R8","University",3,6,24,"Fitzroy",15,18,108,"M.C.G.",-84,1914,"Regular",8,"Away","Fitzroy","University",84
1371,1914-06-08,"R8","St Kilda",12,10,82,"Geelong",8,10,58,"Junction Oval",24,1914,"Regular",8,"Home","St Kilda","Geelong",24
1372,1914-06-08,"R8","Richmond",14,11,95,"Melbourne",6,17,53,"Punt Rd",42,1914,"Regular",8,"Home","Richmond","Melbourne",42
1373,1914-06-13,"R9","Carlton",5,13,43,"Richmond",5,11,41,"Princes Park",2,1914,"Regular",9,"Home","Carlton","Richmond",2
1374,1914-06-13,"R9","Geelong",9,17,71,"Collingwood",5,6,36,"Corio Oval",35,1914,"Regular",9,"Home","Geelong","Collingwood",35
1375,1914-06-13,"R9","Fitzroy",10,6,66,"Essendon",7,8,50,"Brunswick St",16,1914,"Regular",9,"Home","Fitzroy","Essendon",16
1376,1914-06-13,"R9","Melbourne",8,7,55,"Sydney",13,12,90,"M.C.G.",-35,1914,"Regular",9,"Away","Sydney","Melbourne",35
1377,1914-06-13,"R9","St Kilda",15,11,101,"University",10,7,67,"Junction Oval",34,1914,"Regular",9,"Home","St Kilda","University",34
1378,1914-06-20,"R10","Carlton",6,16,52,"Collingwood",5,15,45,"Princes Park",7,1914,"Regular",10,"Home","Carlton","Collingwood",7
1379,1914-06-20,"R10","Essendon",9,13,67,"Geelong",5,11,41,"East Melbourne",26,1914,"Regular",10,"Home","Essendon","Geelong",26
1380,1914-06-20,"R10","Melbourne",8,15,63,"Fitzroy",12,11,83,"M.C.G.",-20,1914,"Regular",10,"Away","Fitzroy","Melbourne",20
1381,1914-06-20,"R10","Richmond",9,14,68,"St Kilda",9,12,66,"Punt Rd",2,1914,"Regular",10,"Home","Richmond","St Kilda",2
1382,1914-06-20,"R10","Sydney",9,16,70,"University",8,7,55,"Lake Oval",15,1914,"Regular",10,"Home","Sydney","University",15
1383,1914-06-27,"R11","St Kilda",7,8,50,"Carlton",7,11,53,"Junction Oval",-3,1914,"Regular",11,"Away","Carlton","St Kilda",3
1384,1914-06-27,"R11","Collingwood",11,16,82,"Melbourne",7,10,52,"Victoria Park",30,1914,"Regular",11,"Home","Collingwood","Melbourne",30
1385,1914-06-27,"R11","University",3,8,26,"Essendon",14,21,105,"M.C.G.",-79,1914,"Regular",11,"Away","Essendon","University",79
1386,1914-06-27,"R11","Fitzroy",10,11,71,"Richmond",4,15,39,"Brunswick St",32,1914,"Regular",11,"Home","Fitzroy","Richmond",32
1387,1914-06-27,"R11","Geelong",9,20,74,"Sydney",6,9,45,"Corio Oval",29,1914,"Regular",11,"Home","Geelong","Sydney",29
1388,1914-07-04,"R12","Carlton",11,21,87,"University",8,8,56,"Princes Park",31,1914,"Regular",12,"Home","Carlton","University",31
1389,1914-07-04,"R12","Richmond",9,11,65,"Collingwood",6,13,49,"Punt Rd",16,1914,"Regular",12,"Home","Richmond","Collingwood",16
1390,1914-07-04,"R12","Essendon",6,18,54,"St Kilda",8,6,54,"East Melbourne",0,1914,"Regular",12,"Home","Essendon","St Kilda",0
1391,1914-07-04,"R12","Sydney",10,4,64,"Fitzroy",7,12,54,"Lake Oval",10,1914,"Regular",12,"Home","Sydney","Fitzroy",10
1392,1914-07-04,"R12","Melbourne",3,4,22,"Geelong",9,14,68,"M.C.G.",-46,1914,"Regular",12,"Away","Geelong","Melbourne",46
1393,1914-07-11,"R13","Carlton",11,14,80,"Sydney",9,6,60,"Princes Park",20,1914,"Regular",13,"Home","Carlton","Sydney",20
1394,1914-07-11,"R13","Collingwood",5,7,37,"Fitzroy",3,16,34,"Victoria Park",3,1914,"Regular",13,"Home","Collingwood","Fitzroy",3
1395,1914-07-11,"R13","Richmond",8,21,69,"Essendon",5,7,37,"Punt Rd",32,1914,"Regular",13,"Home","Richmond","Essendon",32
1396,1914-07-11,"R13","Melbourne",7,6,48,"St Kilda",14,16,100,"M.C.G.",-52,1914,"Regular",13,"Away","St Kilda","Melbourne",52
1397,1914-07-11,"R13","Geelong",8,17,65,"University",3,3,21,"Corio Oval",44,1914,"Regular",13,"Home","Geelong","University",44
1398,1914-07-18,"R14","Fitzroy",4,13,37,"Carlton",7,4,46,"Brunswick St",-9,1914,"Regular",14,"Away","Carlton","Fitzroy",9
1399,1914-07-18,"R14","University",3,5,23,"Collingwood",15,13,103,"M.C.G.",-80,1914,"Regular",14,"Away","Collingwood","University",80
1400,1914-07-18,"R14","Essendon",14,15,99,"Melbourne",6,5,41,"East Melbourne",58,1914,"Regular",14,"Home","Essendon","Melbourne",58
1401,1914-07-18,"R14","Geelong",13,12,90,"Richmond",3,12,30,"Corio Oval",60,1914,"Regular",14,"Home","Geelong","Richmond",60
1402,1914-07-18,"R14","St Kilda",12,7,79,"Sydney",7,15,57,"Junction Oval",22,1914,"Regular",14,"Home","St Kilda","Sydney",22
1403,1914-07-25,"R15","Melbourne",8,10,58,"Carlton",16,15,111,"M.C.G.",-53,1914,"Regular",15,"Away","Carlton","Melbourne",53
1404,1914-07-25,"R15","Collingwood",12,14,86,"St Kilda",7,5,47,"Victoria Park",39,1914,"Regular",15,"Home","Collingwood","St Kilda",39
1405,1914-07-25,"R15","Sydney",4,8,32,"Essendon",15,14,104,"Lake Oval",-72,1914,"Regular",15,"Away","Essendon","Sydney",72
1406,1914-07-25,"R15","Fitzroy",8,5,53,"Geelong",11,13,79,"Brunswick St",-26,1914,"Regular",15,"Away","Geelong","Fitzroy",26
1407,1914-07-25,"R15","Richmond",14,10,94,"University",10,11,71,"Punt Rd",23,1914,"Regular",15,"Home","Richmond","University",23
1408,1914-08-01,"R16","Carlton",4,12,36,"Geelong",5,4,34,"Princes Park",2,1914,"Regular",16,"Home","Carlton","Geelong",2
1409,1914-08-01,"R16","Essendon",5,9,39,"Collingwood",6,12,48,"East Melbourne",-9,1914,"Regular",16,"Away","Collingwood","Essendon",9
1410,1914-08-01,"R16","St Kilda",6,15,51,"Fitzroy",7,11,53,"Junction Oval",-2,1914,"Regular",16,"Away","Fitzroy","St Kilda",2
1411,1914-08-01,"R16","University",6,12,48,"Melbourne",11,9,75,"M.C.G.",-27,1914,"Regular",16,"Away","Melbourne","University",27
1412,1914-08-01,"R16","Sydney",8,9,57,"Richmond",5,13,43,"Lake Oval",14,1914,"Regular",16,"Home","Sydney","Richmond",14
1413,1914-08-22,"R17","Carlton",10,11,71,"Essendon",7,8,50,"Princes Park",21,1914,"Regular",17,"Home","Carlton","Essendon",21
1414,1914-08-22,"R17","Collingwood",4,12,36,"Sydney",8,9,57,"Victoria Park",-21,1914,"Regular",17,"Away","Sydney","Collingwood",21
1415,1914-08-22,"R17","Fitzroy",18,19,127,"University",6,2,38,"Brunswick St",89,1914,"Regular",17,"Home","Fitzroy","University",89
1416,1914-08-22,"R17","Geelong",9,7,61,"St Kilda",5,15,45,"Corio Oval",16,1914,"Regular",17,"Home","Geelong","St Kilda",16
1417,1914-08-22,"R17","Melbourne",8,10,58,"Richmond",15,15,105,"M.C.G.",-47,1914,"Regular",17,"Away","Richmond","Melbourne",47
1418,1914-08-29,"R18","Richmond",8,9,57,"Carlton",9,9,63,"Punt Rd",-6,1914,"Regular",18,"Away","Carlton","Richmond",6
1419,1914-08-29,"R18","Collingwood",4,10,34,"Geelong",8,10,58,"Victoria Park",-24,1914,"Regular",18,"Away","Geelong","Collingwood",24
1420,1914-08-29,"R18","Essendon",9,14,68,"Fitzroy",7,8,50,"East Melbourne",18,1914,"Regular",18,"Home","Essendon","Fitzroy",18
1421,1914-08-29,"R18","Sydney",10,18,78,"Melbourne",5,5,35,"Lake Oval",43,1914,"Regular",18,"Home","Sydney","Melbourne",43
1422,1914-08-29,"R18","University",7,10,52,"St Kilda",13,15,93,"M.C.G.",-41,1914,"Regular",18,"Away","St Kilda","University",41
1423,1914-09-05,"SF","Sydney",5,14,44,"Geelong",5,7,37,"M.C.G.",7,1914,"Finals",19,"Home","Sydney","Geelong",7
1424,1914-09-12,"SF","Carlton",9,8,62,"Fitzroy",5,12,42,"M.C.G.",20,1914,"Finals",19,"Home","Carlton","Fitzroy",20
1425,1914-09-19,"PF","Carlton",3,6,24,"Sydney",5,13,43,"M.C.G.",-19,1914,"Finals",20,"Away","Sydney","Carlton",19
1426,1914-09-26,"GF","Carlton",6,9,45,"Sydney",4,15,39,"M.C.G.",6,1914,"Finals",21,"Home","Carlton","Sydney",6
1427,1915-04-24,"R1","Collingwood",7,10,52,"Essendon",3,8,26,"Victoria Park",26,1915,"Regular",1,"Home","Collingwood","Essendon",26
1428,1915-04-24,"R1","Melbourne",12,10,82,"Richmond",11,7,73,"M.C.G.",9,1915,"Regular",1,"Home","Melbourne","Richmond",9
1429,1915-04-24,"R1","St Kilda",8,16,64,"Sydney",4,13,37,"Junction Oval",27,1915,"Regular",1,"Home","St Kilda","Sydney",27
1430,1915-04-24,"R1","Carlton",5,11,41,"Fitzroy",6,5,41,"Princes Park",0,1915,"Regular",1,"Home","Carlton","Fitzroy",0
1431,1915-05-01,"R2","Sydney",6,11,47,"Carlton",8,12,60,"Lake Oval",-13,1915,"Regular",2,"Away","Carlton","Sydney",13
1432,1915-05-01,"R2","Richmond",4,6,30,"Collingwood",12,11,83,"Punt Rd",-53,1915,"Regular",2,"Away","Collingwood","Richmond",53
1433,1915-05-01,"R2","Fitzroy",14,17,101,"Melbourne",9,2,56,"Brunswick St",45,1915,"Regular",2,"Home","Fitzroy","Melbourne",45
1434,1915-05-01,"R2","Geelong",7,14,56,"St Kilda",6,18,54,"Corio Oval",2,1915,"Regular",2,"Home","Geelong","St Kilda",2
1435,1915-05-08,"R3","St Kilda",7,14,56,"Collingwood",10,16,76,"Junction Oval",-20,1915,"Regular",3,"Away","Collingwood","St Kilda",20
1436,1915-05-08,"R3","Essendon",4,10,34,"Fitzroy",16,6,102,"East Melbourne",-68,1915,"Regular",3,"Away","Fitzroy","Essendon",68
1437,1915-05-08,"R3","Melbourne",15,12,102,"Geelong",12,11,83,"M.C.G.",19,1915,"Regular",3,"Home","Melbourne","Geelong",19
1438,1915-05-08,"R3","Richmond",9,15,69,"Sydney",8,19,67,"Punt Rd",2,1915,"Regular",3,"Home","Richmond","Sydney",2
1439,1915-05-15,"R4","Carlton",3,13,31,"Essendon",8,8,56,"Princes Park",-25,1915,"Regular",4,"Away","Essendon","Carlton",25
1440,1915-05-15,"R4","Collingwood",9,13,67,"Melbourne",5,9,39,"Victoria Park",28,1915,"Regular",4,"Home","Collingwood","Melbourne",28
1441,1915-05-15,"R4","Fitzroy",5,19,49,"St Kilda",2,6,18,"Brunswick St",31,1915,"Regular",4,"Home","Fitzroy","St Kilda",31
1442,1915-05-15,"R4","Geelong",4,10,34,"Richmond",10,11,71,"Corio Oval",-37,1915,"Regular",4,"Away","Richmond","Geelong",37
1443,1915-05-22,"R5","Melbourne",8,3,51,"Carlton",10,12,72,"M.C.G.",-21,1915,"Regular",5,"Away","Carlton","Melbourne",21
1444,1915-05-22,"R5","Collingwood",8,14,62,"Geelong",3,12,30,"Victoria Park",32,1915,"Regular",5,"Home","Collingwood","Geelong",32
1445,1915-05-22,"R5","Essendon",7,10,52,"St Kilda",6,4,40,"East Melbourne",12,1915,"Regular",5,"Home","Essendon","St Kilda",12
1446,1915-05-22,"R5","Sydney",8,8,56,"Fitzroy",6,4,40,"Lake Oval",16,1915,"Regular",5,"Home","Sydney","Fitzroy",16
1447,1915-05-29,"R6","Geelong",5,10,40,"Carlton",9,13,67,"Corio Oval",-27,1915,"Regular",6,"Away","Carlton","Geelong",27
1448,1915-05-29,"R6","Essendon",8,7,55,"Sydney",8,16,64,"East Melbourne",-9,1915,"Regular",6,"Away","Sydney","Essendon",9
1449,1915-05-29,"R6","Richmond",7,12,54,"Fitzroy",8,12,60,"Punt Rd",-6,1915,"Regular",6,"Away","Fitzroy","Richmond",6
1450,1915-05-29,"R6","St Kilda",9,11,65,"Melbourne",13,11,89,"Junction Oval",-24,1915,"Regular",6,"Away","Melbourne","St Kilda",24
1451,1915-06-05,"R7","Sydney",7,5,47,"Melbourne",10,8,68,"Lake Oval",-21,1915,"Regular",7,"Away","Melbourne","Sydney",21
1452,1915-06-05,"R7","Richmond",7,6,48,"St Kilda",5,20,50,"Punt Rd",-2,1915,"Regular",7,"Away","St Kilda","Richmond",2
1453,1915-06-07,"R7","Carlton",11,9,75,"Collingwood",10,13,73,"Princes Park",2,1915,"Regular",7,"Home","Carlton","Collingwood",2
1454,1915-06-07,"R7","Essendon",12,6,78,"Geelong",12,8,80,"East Melbourne",-2,1915,"Regular",7,"Away","Geelong","Essendon",2
1455,1915-06-12,"R8","Carlton",15,17,107,"Richmond",8,5,53,"Princes Park",54,1915,"Regular",8,"Home","Carlton","Richmond",54
1456,1915-06-12,"R8","Fitzroy",6,14,50,"Collingwood",11,8,74,"Brunswick St",-24,1915,"Regular",8,"Away","Collingwood","Fitzroy",24
1457,1915-06-12,"R8","Melbourne",10,12,72,"Essendon",6,17,53,"M.C.G.",19,1915,"Regular",8,"Home","Melbourne","Essendon",19
1458,1915-06-12,"R8","Sydney",14,17,101,"Geelong",13,5,83,"Lake Oval",18,1915,"Regular",8,"Home","Sydney","Geelong",18
1459,1915-06-19,"R9","St Kilda",1,1,7,"Carlton",5,15,45,"Junction Oval",-38,1915,"Regular",9,"Away","Carlton","St Kilda",38
1460,1915-06-19,"R9","Collingwood",5,13,43,"Sydney",3,10,28,"Victoria Park",15,1915,"Regular",9,"Home","Collingwood","Sydney",15
1461,1915-06-19,"R9","Essendon",5,6,36,"Richmond",5,8,38,"East Melbourne",-2,1915,"Regular",9,"Away","Richmond","Essendon",2
1462,1915-06-19,"R9","Geelong",4,12,36,"Fitzroy",10,12,72,"Corio Oval",-36,1915,"Regular",9,"Away","Fitzroy","Geelong",36
1463,1915-06-26,"R10","Fitzroy",7,8,50,"Carlton",5,8,38,"Brunswick St",12,1915,"Regular",10,"Home","Fitzroy","Carlton",12
1464,1915-06-26,"R10","Essendon",5,12,42,"Collingwood",11,12,78,"East Melbourne",-36,1915,"Regular",10,"Away","Collingwood","Essendon",36
1465,1915-06-26,"R10","Richmond",8,12,60,"Melbourne",10,11,71,"Punt Rd",-11,1915,"Regular",10,"Away","Melbourne","Richmond",11
1466,1915-06-26,"R10","Sydney",9,11,65,"St Kilda",7,5,47,"Lake Oval",18,1915,"Regular",10,"Home","Sydney","St Kilda",18
1467,1915-07-03,"R11","Carlton",7,15,57,"Sydney",7,5,47,"Princes Park",10,1915,"Regular",11,"Home","Carlton","Sydney",10
1468,1915-07-03,"R11","Collingwood",10,20,80,"Richmond",6,7,43,"Victoria Park",37,1915,"Regular",11,"Home","Collingwood","Richmond",37
1469,1915-07-03,"R11","Melbourne",12,13,85,"Fitzroy",10,13,73,"M.C.G.",12,1915,"Regular",11,"Home","Melbourne","Fitzroy",12
1470,1915-07-03,"R11","St Kilda",12,17,89,"Geelong",8,7,55,"Junction Oval",34,1915,"Regular",11,"Home","St Kilda","Geelong",34
1471,1915-07-10,"R12","Collingwood",17,20,122,"St Kilda",3,6,24,"Victoria Park",98,1915,"Regular",12,"Home","Collingwood","St Kilda",98
1472,1915-07-10,"R12","Fitzroy",6,12,48,"Essendon",5,5,35,"Brunswick St",13,1915,"Regular",12,"Home","Fitzroy","Essendon",13
1473,1915-07-10,"R12","Geelong",5,9,39,"Melbourne",11,13,79,"Corio Oval",-40,1915,"Regular",12,"Away","Melbourne","Geelong",40
1474,1915-07-10,"R12","Sydney",10,12,72,"Richmond",7,11,53,"Lake Oval",19,1915,"Regular",12,"Home","Sydney","Richmond",19
1475,1915-07-17,"R13","Essendon",5,15,45,"Carlton",12,15,87,"East Melbourne",-42,1915,"Regular",13,"Away","Carlton","Essendon",42
1476,1915-07-17,"R13","Melbourne",8,6,54,"Collingwood",12,21,93,"M.C.G.",-39,1915,"Regular",13,"Away","Collingwood","Melbourne",39
1477,1915-07-17,"R13","St Kilda",7,7,49,"Fitzroy",14,14,98,"Junction Oval",-49,1915,"Regular",13,"Away","Fitzroy","St Kilda",49
1478,1915-07-17,"R13","Richmond",12,15,87,"Geelong",12,7,79,"Punt Rd",8,1915,"Regular",13,"Home","Richmond","Geelong",8
1479,1915-07-24,"R14","Carlton",11,8,74,"Melbourne",5,15,45,"Princes Park",29,1915,"Regular",14,"Home","Carlton","Melbourne",29
1480,1915-07-24,"R14","Geelong",7,9,51,"Collingwood",13,13,91,"Corio Oval",-40,1915,"Regular",14,"Away","Collingwood","Geelong",40
1481,1915-07-24,"R14","St Kilda",10,10,70,"Essendon",3,13,31,"Junction Oval",39,1915,"Regular",14,"Home","St Kilda","Essendon",39
1482,1915-07-24,"R14","Fitzroy",8,6,54,"Sydney",7,6,48,"Brunswick St",6,1915,"Regular",14,"Home","Fitzroy","Sydney",6
1483,1915-07-31,"R15","Carlton",9,20,74,"Geelong",8,12,60,"Princes Park",14,1915,"Regular",15,"Home","Carlton","Geelong",14
1484,1915-07-31,"R15","Sydney",13,19,97,"Essendon",6,4,40,"Lake Oval",57,1915,"Regular",15,"Home","Sydney","Essendon",57
1485,1915-07-31,"R15","Fitzroy",18,17,125,"Richmond",7,7,49,"Brunswick St",76,1915,"Regular",15,"Home","Fitzroy","Richmond",76
1486,1915-07-31,"R15","Melbourne",9,19,73,"St Kilda",7,6,48,"M.C.G.",25,1915,"Regular",15,"Home","Melbourne","St Kilda",25
1487,1915-08-07,"R16","Collingwood",9,8,62,"Carlton",9,9,63,"Victoria Park",-1,1915,"Regular",16,"Away","Carlton","Collingwood",1
1488,1915-08-07,"R16","Geelong",7,11,53,"Essendon",6,9,45,"Corio Oval",8,1915,"Regular",16,"Home","Geelong","Essendon",8
1489,1915-08-07,"R16","Melbourne",4,12,36,"Sydney",5,13,43,"M.C.G.",-7,1915,"Regular",16,"Away","Sydney","Melbourne",7
1490,1915-08-07,"R16","St Kilda",6,18,54,"Richmond",4,6,30,"Junction Oval",24,1915,"Regular",16,"Home","St Kilda","Richmond",24
1491,1915-08-14,"R17","Richmond",7,7,49,"Carlton",17,15,117,"Punt Rd",-68,1915,"Regular",17,"Away","Carlton","Richmond",68
1492,1915-08-14,"R17","Collingwood",8,13,61,"Fitzroy",8,11,59,"Victoria Park",2,1915,"Regular",17,"Home","Collingwood","Fitzroy",2
1493,1915-08-14,"R17","Essendon",10,15,75,"Melbourne",7,14,56,"East Melbourne",19,1915,"Regular",17,"Home","Essendon","Melbourne",19
1494,1915-08-14,"R17","Geelong",7,10,52,"Sydney",10,14,74,"Corio Oval",-22,1915,"Regular",17,"Away","Sydney","Geelong",22
1495,1915-08-21,"R18","Carlton",14,16,100,"St Kilda",6,8,44,"Princes Park",56,1915,"Regular",18,"Home","Carlton","St Kilda",56
1496,1915-08-21,"R18","Sydney",4,9,33,"Collingwood",7,9,51,"Lake Oval",-18,1915,"Regular",18,"Away","Collingwood","Sydney",18
1497,1915-08-21,"R18","Richmond",14,15,99,"Essendon",6,11,47,"Punt Rd",52,1915,"Regular",18,"Home","Richmond","Essendon",52
1498,1915-08-21,"R18","Fitzroy",18,13,121,"Geelong",4,7,31,"Brunswick St",90,1915,"Regular",18,"Home","Fitzroy","Geelong",90
1499,1915-08-28,"SF","Carlton",11,12,78,"Melbourne",10,7,67,"M.C.G.",11,1915,"Finals",19,"Home","Carlton","Melbourne",11
1500,1915-09-04,"SF","Collingwood",4,12,36,"Fitzroy",9,16,70,"M.C.G.",-34,1915,"Finals",19,"Away","Fitzroy","Collingwood",34
1501,1915-09-11,"PF","Carlton",6,18,54,"Fitzroy",5,8,38,"M.C.G.",16,1915,"Finals",20,"Home","Carlton","Fitzroy",16
1502,1915-09-18,"GF","Collingwood",6,9,45,"Carlton",11,12,78,"M.C.G.",-33,1915,"Finals",21,"Away","Carlton","Collingwood",33
1503,1916-05-06,"R1","Carlton",7,18,60,"Fitzroy",9,10,64,"Princes Park",-4,1916,"Regular",1,"Away","Fitzroy","Carlton",4
1504,1916-05-06,"R1","Richmond",10,9,69,"Collingwood",11,11,77,"Punt Rd",-8,1916,"Regular",1,"Away","Collingwood","Richmond",8
1505,1916-05-13,"R2","Collingwood",7,3,45,"Carlton",10,11,71,"Victoria Park",-26,1916,"Regular",2,"Away","Carlton","Collingwood",26
1506,1916-05-13,"R2","Fitzroy",9,12,66,"Richmond",5,7,37,"Brunswick St",29,1916,"Regular",2,"Home","Fitzroy","Richmond",29
1507,1916-05-20,"R3","Richmond",7,19,61,"Carlton",9,12,66,"Punt Rd",-5,1916,"Regular",3,"Away","Carlton","Richmond",5
1508,1916-05-20,"R3","Fitzroy",7,8,50,"Collingwood",6,14,50,"Brunswick St",0,1916,"Regular",3,"Home","Fitzroy","Collingwood",0
1509,1916-05-27,"R4","Fitzroy",7,9,51,"Carlton",13,6,84,"Brunswick St",-33,1916,"Regular",4,"Away","Carlton","Fitzroy",33
1510,1916-05-27,"R4","Collingwood",10,18,78,"Richmond",7,11,53,"Victoria Park",25,1916,"Regular",4,"Home","Collingwood","Richmond",25
1511,1916-06-03,"R5","Carlton",10,15,75,"Collingwood",11,10,76,"Princes Park",-1,1916,"Regular",5,"Away","Collingwood","Carlton",1
1512,1916-06-05,"R5","Richmond",19,13,127,"Fitzroy",9,14,68,"Punt Rd",59,1916,"Regular",5,"Home","Richmond","Fitzroy",59
1513,1916-06-10,"R6","Carlton",14,8,92,"Richmond",3,13,31,"Princes Park",61,1916,"Regular",6,"Home","Carlton","Richmond",61
1514,1916-06-10,"R6","Collingwood",11,13,79,"Fitzroy",8,17,65,"Victoria Park",14,1916,"Regular",6,"Home","Collingwood","Fitzroy",14
1515,1916-06-17,"R7","Fitzroy",7,8,50,"Carlton",10,19,79,"Brunswick St",-29,1916,"Regular",7,"Away","Carlton","Fitzroy",29
1516,1916-06-17,"R7","Collingwood",10,14,74,"Richmond",11,9,75,"Victoria Park",-1,1916,"Regular",7,"Away","Richmond","Collingwood",1
1517,1916-06-24,"R8","Carlton",9,11,65,"Collingwood",7,11,53,"Princes Park",12,1916,"Regular",8,"Home","Carlton","Collingwood",12
1518,1916-06-24,"R8","Richmond",9,11,65,"Fitzroy",7,13,55,"Punt Rd",10,1916,"Regular",8,"Home","Richmond","Fitzroy",10
1519,1916-07-08,"R9","Carlton",12,19,91,"Richmond",6,5,41,"Princes Park",50,1916,"Regular",9,"Home","Carlton","Richmond",50
1520,1916-07-08,"R9","Collingwood",8,11,59,"Fitzroy",8,10,58,"Victoria Park",1,1916,"Regular",9,"Home","Collingwood","Fitzroy",1
1521,1916-07-15,"R10","Carlton",11,15,81,"Fitzroy",8,14,62,"Princes Park",19,1916,"Regular",10,"Home","Carlton","Fitzroy",19
1522,1916-07-15,"R10","Richmond",14,9,93,"Collingwood",9,13,67,"Punt Rd",26,1916,"Regular",10,"Home","Richmond","Collingwood",26
1523,1916-07-22,"R11","Collingwood",10,10,70,"Carlton",9,18,72,"Victoria Park",-2,1916,"Regular",11,"Away","Carlton","Collingwood",2
1524,1916-07-22,"R11","Fitzroy",9,11,65,"Richmond",10,15,75,"Brunswick St",-10,1916,"Regular",11,"Away","Richmond","Fitzroy",10
1525,1916-07-29,"R12","Richmond",9,11,65,"Carlton",12,10,82,"Punt Rd",-17,1916,"Regular",12,"Away","Carlton","Richmond",17
1526,1916-07-29,"R12","Fitzroy",8,9,57,"Collingwood",11,9,75,"Brunswick St",-18,1916,"Regular",12,"Away","Collingwood","Fitzroy",18
1527,1916-08-12,"SF","Collingwood",8,9,57,"Fitzroy",9,9,63,"M.C.G.",-6,1916,"Finals",13,"Away","Fitzroy","Collingwood",6
1528,1916-08-19,"SF","Carlton",10,15,75,"Richmond",10,12,72,"M.C.G.",3,1916,"Finals",13,"Home","Carlton","Richmond",3
1529,1916-08-26,"PF","Carlton",5,12,42,"Fitzroy",9,11,65,"M.C.G.",-23,1916,"Finals",14,"Away","Fitzroy","Carlton",23
1530,1916-09-02,"GF","Carlton",8,8,56,"Fitzroy",12,13,85,"M.C.G.",-29,1916,"Finals",15,"Away","Fitzroy","Carlton",29
1531,1917-05-12,"R1","Fitzroy",6,9,45,"Carlton",6,9,45,"Brunswick St",0,1917,"Regular",1,"Home","Fitzroy","Carlton",0
1532,1917-05-12,"R1","Collingwood",11,11,77,"Richmond",4,4,28,"Victoria Park",49,1917,"Regular",1,"Home","Collingwood","Richmond",49
1533,1917-05-12,"R1","Sydney",9,18,72,"Geelong",4,14,38,"Lake Oval",34,1917,"Regular",1,"Home","Sydney","Geelong",34
1534,1917-05-19,"R2","Carlton",13,7,85,"Collingwood",8,6,54,"Princes Park",31,1917,"Regular",2,"Home","Carlton","Collingwood",31
1535,1917-05-19,"R2","Geelong",6,10,46,"Fitzroy",8,16,64,"Corio Oval",-18,1917,"Regular",2,"Away","Fitzroy","Geelong",18
1536,1917-05-19,"R2","Richmond",6,16,52,"Sydney",8,16,64,"Punt Rd",-12,1917,"Regular",2,"Away","Sydney","Richmond",12
1537,1917-05-26,"R3","Sydney",5,16,46,"Carlton",3,13,31,"Lake Oval",15,1917,"Regular",3,"Home","Sydney","Carlton",15
1538,1917-05-26,"R3","Fitzroy",8,14,62,"Collingwood",11,12,78,"Brunswick St",-16,1917,"Regular",3,"Away","Collingwood","Fitzroy",16
1539,1917-05-26,"R3","Richmond",14,6,90,"Geelong",6,16,52,"Punt Rd",38,1917,"Regular",3,"Home","Richmond","Geelong",38
1540,1917-06-02,"R4","Collingwood",8,18,66,"Sydney",6,9,45,"Victoria Park",21,1917,"Regular",4,"Home","Collingwood","Sydney",21
1541,1917-06-04,"R4","Carlton",5,12,42,"Geelong",6,7,43,"Princes Park",-1,1917,"Regular",4,"Away","Geelong","Carlton",1
1542,1917-06-04,"R4","Fitzroy",6,13,49,"Richmond",5,8,38,"Brunswick St",11,1917,"Regular",4,"Home","Fitzroy","Richmond",11
1543,1917-06-09,"R5","Carlton",14,13,97,"Richmond",7,11,53,"Princes Park",44,1917,"Regular",5,"Home","Carlton","Richmond",44
1544,1917-06-09,"R5","Geelong",6,7,43,"Collingwood",8,9,57,"Corio Oval",-14,1917,"Regular",5,"Away","Collingwood","Geelong",14
1545,1917-06-09,"R5","Sydney",5,20,50,"Fitzroy",8,7,55,"Lake Oval",-5,1917,"Regular",5,"Away","Fitzroy","Sydney",5
1546,1917-06-16,"R6","Carlton",4,17,41,"Fitzroy",8,9,57,"Princes Park",-16,1917,"Regular",6,"Away","Fitzroy","Carlton",16
1547,1917-06-16,"R6","Richmond",7,8,50,"Collingwood",6,14,50,"Punt Rd",0,1917,"Regular",6,"Home","Richmond","Collingwood",0
1548,1917-06-16,"R6","Geelong",6,14,50,"Sydney",6,11,47,"Corio Oval",3,1917,"Regular",6,"Home","Geelong","Sydney",3
1549,1917-06-23,"R7","Collingwood",13,14,92,"Carlton",8,7,55,"Victoria Park",37,1917,"Regular",7,"Home","Collingwood","Carlton",37
1550,1917-06-23,"R7","Fitzroy",8,4,52,"Geelong",9,11,65,"Brunswick St",-13,1917,"Regular",7,"Away","Geelong","Fitzroy",13
1551,1917-06-23,"R7","Sydney",9,17,71,"Richmond",6,3,39,"Lake Oval",32,1917,"Regular",7,"Home","Sydney","Richmond",32
1552,1917-06-30,"R8","Carlton",9,11,65,"Sydney",7,12,54,"Princes Park",11,1917,"Regular",8,"Home","Carlton","Sydney",11
1553,1917-06-30,"R8","Collingwood",11,11,77,"Fitzroy",10,14,74,"Victoria Park",3,1917,"Regular",8,"Home","Collingwood","Fitzroy",3
1554,1917-06-30,"R8","Geelong",11,15,81,"Richmond",5,4,34,"Corio Oval",47,1917,"Regular",8,"Home","Geelong","Richmond",47
1555,1917-07-07,"R9","Geelong",3,11,29,"Carlton",4,10,34,"Corio Oval",-5,1917,"Regular",9,"Away","Carlton","Geelong",5
1556,1917-07-07,"R9","Sydney",13,12,90,"Collingwood",10,13,73,"Lake Oval",17,1917,"Regular",9,"Home","Sydney","Collingwood",17
1557,1917-07-07,"R9","Richmond",13,9,87,"Fitzroy",5,8,38,"Punt Rd",49,1917,"Regular",9,"Home","Richmond","Fitzroy",49
1558,1917-07-14,"R10","Richmond",6,10,46,"Carlton",7,9,51,"Punt Rd",-5,1917,"Regular",10,"Away","Carlton","Richmond",5
1559,1917-07-14,"R10","Collingwood",10,19,79,"Geelong",2,11,23,"Victoria Park",56,1917,"Regular",10,"Home","Collingwood","Geelong",56
1560,1917-07-14,"R10","Fitzroy",9,10,64,"Sydney",8,9,57,"Brunswick St",7,1917,"Regular",10,"Home","Fitzroy","Sydney",7
1561,1917-07-21,"R11","Fitzroy",5,15,45,"Carlton",8,11,59,"Brunswick St",-14,1917,"Regular",11,"Away","Carlton","Fitzroy",14
1562,1917-07-21,"R11","Collingwood",11,19,85,"Richmond",7,7,49,"Victoria Park",36,1917,"Regular",11,"Home","Collingwood","Richmond",36
1563,1917-07-21,"R11","Sydney",14,14,98,"Geelong",6,13,49,"Lake Oval",49,1917,"Regular",11,"Home","Sydney","Geelong",49
1564,1917-07-28,"R12","Carlton",4,13,37,"Collingwood",3,8,26,"Princes Park",11,1917,"Regular",12,"Home","Carlton","Collingwood",11
1565,1917-07-28,"R12","Geelong",10,3,63,"Fitzroy",12,10,82,"Corio Oval",-19,1917,"Regular",12,"Away","Fitzroy","Geelong",19
1566,1917-07-28,"R12","Richmond",5,11,41,"Sydney",7,14,56,"Punt Rd",-15,1917,"Regular",12,"Away","Sydney","Richmond",15
1567,1917-08-11,"R13","Sydney",8,7,55,"Carlton",6,14,50,"Lake Oval",5,1917,"Regular",13,"Home","Sydney","Carlton",5
1568,1917-08-11,"R13","Fitzroy",7,3,45,"Collingwood",14,17,101,"Brunswick St",-56,1917,"Regular",13,"Away","Collingwood","Fitzroy",56
1569,1917-08-11,"R13","Richmond",5,12,42,"Geelong",7,8,50,"Punt Rd",-8,1917,"Regular",13,"Away","Geelong","Richmond",8
1570,1917-08-18,"R14","Geelong",5,8,38,"Carlton",10,11,71,"Corio Oval",-33,1917,"Regular",14,"Away","Carlton","Geelong",33
1571,1917-08-18,"R14","Collingwood",6,16,52,"Sydney",2,9,21,"Victoria Park",31,1917,"Regular",14,"Home","Collingwood","Sydney",31
1572,1917-08-18,"R14","Richmond",10,11,71,"Fitzroy",7,11,53,"Punt Rd",18,1917,"Regular",14,"Home","Richmond","Fitzroy",18
1573,1917-08-25,"R15","Carlton",12,8,80,"Richmond",4,17,41,"Princes Park",39,1917,"Regular",15,"Home","Carlton","Richmond",39
1574,1917-08-25,"R15","Geelong",8,17,65,"Collingwood",9,9,63,"Corio Oval",2,1917,"Regular",15,"Home","Geelong","Collingwood",2
1575,1917-08-25,"R15","Sydney",12,13,85,"Fitzroy",7,5,47,"Lake Oval",38,1917,"Regular",15,"Home","Sydney","Fitzroy",38
1576,1917-09-01,"SF","Carlton",6,8,44,"Fitzroy",6,17,53,"M.C.G.",-9,1917,"Finals",16,"Away","Fitzroy","Carlton",9
1577,1917-09-08,"SF","Collingwood",13,17,95,"Sydney",3,17,35,"M.C.G.",60,1917,"Finals",16,"Home","Collingwood","Sydney",60
1578,1917-09-15,"PF","Collingwood",7,10,52,"Fitzroy",8,10,58,"M.C.G.",-6,1917,"Finals",17,"Away","Fitzroy","Collingwood",6
1579,1917-09-22,"GF","Collingwood",9,20,74,"Fitzroy",5,9,39,"M.C.G.",35,1917,"Finals",18,"Home","Collingwood","Fitzroy",35
1580,1918-05-11,"R1","Collingwood",8,17,65,"Carlton",4,6,30,"Victoria Park",35,1918,"Regular",1,"Home","Collingwood","Carlton",35
1581,1918-05-11,"R1","Richmond",5,16,46,"Essendon",4,10,34,"Punt Rd",12,1918,"Regular",1,"Home","Richmond","Essendon",12
1582,1918-05-11,"R1","St Kilda",4,16,40,"Fitzroy",4,10,34,"Junction Oval",6,1918,"Regular",1,"Home","St Kilda","Fitzroy",6
1583,1918-05-11,"R1","Sydney",7,15,57,"Geelong",4,7,31,"Lake Oval",26,1918,"Regular",1,"Home","Sydney","Geelong",26
1584,1918-05-18,"R2","Carlton",8,5,53,"Richmond",7,16,58,"Princes Park",-5,1918,"Regular",2,"Away","Richmond","Carlton",5
1585,1918-05-18,"R2","Geelong",5,6,36,"Collingwood",7,6,48,"Corio Oval",-12,1918,"Regular",2,"Away","Collingwood","Geelong",12
1586,1918-05-18,"R2","Fitzroy",5,8,38,"Sydney",12,6,78,"Brunswick St",-40,1918,"Regular",2,"Away","Sydney","Fitzroy",40
1587,1918-05-18,"R2","Essendon",8,13,61,"St Kilda",6,18,54,"East Melbourne",7,1918,"Regular",2,"Home","Essendon","St Kilda",7
1588,1918-05-25,"R3","Carlton",11,11,77,"St Kilda",7,9,51,"Princes Park",26,1918,"Regular",3,"Home","Carlton","St Kilda",26
1589,1918-05-25,"R3","Sydney",12,13,85,"Collingwood",9,13,67,"Lake Oval",18,1918,"Regular",3,"Home","Sydney","Collingwood",18
1590,1918-05-25,"R3","Geelong",6,16,52,"Essendon",4,12,36,"Corio Oval",16,1918,"Regular",3,"Home","Geelong","Essendon",16
1591,1918-05-25,"R3","Richmond",6,8,44,"Fitzroy",10,12,72,"Punt Rd",-28,1918,"Regular",3,"Away","Fitzroy","Richmond",28
1592,1918-06-01,"R4","Essendon",4,13,37,"Carlton",8,27,75,"East Melbourne",-38,1918,"Regular",4,"Away","Carlton","Essendon",38
1593,1918-06-01,"R4","Collingwood",11,10,76,"Richmond",8,8,56,"Victoria Park",20,1918,"Regular",4,"Home","Collingwood","Richmond",20
1594,1918-06-03,"R4","Fitzroy",10,14,74,"Geelong",8,14,62,"Brunswick St",12,1918,"Regular",4,"Home","Fitzroy","Geelong",12
1595,1918-06-03,"R4","St Kilda",6,13,49,"Sydney",6,8,44,"Junction Oval",5,1918,"Regular",4,"Home","St Kilda","Sydney",5
1596,1918-06-08,"R5","Sydney",11,10,76,"Carlton",10,12,72,"Lake Oval",4,1918,"Regular",5,"Home","Sydney","Carlton",4
1597,1918-06-08,"R5","Collingwood",14,21,105,"St Kilda",6,9,45,"Victoria Park",60,1918,"Regular",5,"Home","Collingwood","St Kilda",60
1598,1918-06-08,"R5","Fitzroy",9,12,66,"Essendon",2,13,25,"Brunswick St",41,1918,"Regular",5,"Home","Fitzroy","Essendon",41
1599,1918-06-08,"R5","Geelong",6,13,49,"Richmond",7,18,60,"Corio Oval",-11,1918,"Regular",5,"Away","Richmond","Geelong",11
1600,1918-06-15,"R6","Carlton",16,15,111,"Geelong",7,3,45,"Princes Park",66,1918,"Regular",6,"Home","Carlton","Geelong",66
1601,1918-06-15,"R6","Collingwood",7,11,53,"Fitzroy",3,6,24,"Victoria Park",29,1918,"Regular",6,"Home","Collingwood","Fitzroy",29
1602,1918-06-15,"R6","Essendon",4,8,32,"Sydney",7,10,52,"East Melbourne",-20,1918,"Regular",6,"Away","Sydney","Essendon",20
1603,1918-06-15,"R6","Richmond",5,13,43,"St Kilda",7,18,60,"Punt Rd",-17,1918,"Regular",6,"Away","St Kilda","Richmond",17
1604,1918-06-22,"R7","Fitzroy",6,15,51,"Carlton",12,11,83,"Brunswick St",-32,1918,"Regular",7,"Away","Carlton","Fitzroy",32
1605,1918-06-22,"R7","Essendon",4,9,33,"Collingwood",14,14,98,"East Melbourne",-65,1918,"Regular",7,"Away","Collingwood","Essendon",65
1606,1918-06-22,"R7","St Kilda",15,13,103,"Geelong",5,9,39,"Junction Oval",64,1918,"Regular",7,"Home","St Kilda","Geelong",64
1607,1918-06-22,"R7","Sydney",12,14,86,"Richmond",4,10,34,"Lake Oval",52,1918,"Regular",7,"Home","Sydney","Richmond",52
1608,1918-06-29,"R8","Carlton",6,13,49,"Collingwood",6,5,41,"Princes Park",8,1918,"Regular",8,"Home","Carlton","Collingwood",8
1609,1918-06-29,"R8","Essendon",3,4,22,"Richmond",5,15,45,"East Melbourne",-23,1918,"Regular",8,"Away","Richmond","Essendon",23
1610,1918-06-29,"R8","Fitzroy",7,6,48,"St Kilda",3,5,23,"Brunswick St",25,1918,"Regular",8,"Home","Fitzroy","St Kilda",25
1611,1918-06-29,"R8","Geelong",7,8,50,"Sydney",7,13,55,"Corio Oval",-5,1918,"Regular",8,"Away","Sydney","Geelong",5
1612,1918-07-06,"R9","Richmond",7,16,58,"Carlton",8,13,61,"Punt Rd",-3,1918,"Regular",9,"Away","Carlton","Richmond",3
1613,1918-07-06,"R9","Collingwood",12,14,86,"Geelong",7,10,52,"Victoria Park",34,1918,"Regular",9,"Home","Collingwood","Geelong",34
1614,1918-07-06,"R9","St Kilda",6,14,50,"Essendon",6,6,42,"Junction Oval",8,1918,"Regular",9,"Home","St Kilda","Essendon",8
1615,1918-07-06,"R9","Sydney",12,14,86,"Fitzroy",8,13,61,"Lake Oval",25,1918,"Regular",9,"Home","Sydney","Fitzroy",25
1616,1918-07-13,"R10","St Kilda",4,20,44,"Carlton",2,5,17,"Junction Oval",27,1918,"Regular",10,"Home","St Kilda","Carlton",27
1617,1918-07-13,"R10","Collingwood",6,8,44,"Sydney",7,9,51,"Victoria Park",-7,1918,"Regular",10,"Away","Sydney","Collingwood",7
1618,1918-07-13,"R10","Essendon",8,10,58,"Geelong",5,9,39,"East Melbourne",19,1918,"Regular",10,"Home","Essendon","Geelong",19
1619,1918-07-13,"R10","Fitzroy",10,11,71,"Richmond",6,7,43,"Brunswick St",28,1918,"Regular",10,"Home","Fitzroy","Richmond",28
1620,1918-07-20,"R11","Carlton",10,20,80,"Essendon",4,7,31,"Princes Park",49,1918,"Regular",11,"Home","Carlton","Essendon",49
1621,1918-07-20,"R11","Richmond",6,13,49,"Collingwood",11,10,76,"Punt Rd",-27,1918,"Regular",11,"Away","Collingwood","Richmond",27
1622,1918-07-20,"R11","Geelong",5,6,36,"Fitzroy",11,6,72,"Corio Oval",-36,1918,"Regular",11,"Away","Fitzroy","Geelong",36
1623,1918-07-20,"R11","Sydney",14,17,101,"St Kilda",7,9,51,"Lake Oval",50,1918,"Regular",11,"Home","Sydney","St Kilda",50
1624,1918-07-27,"R12","Carlton",5,13,43,"Sydney",8,7,55,"Princes Park",-12,1918,"Regular",12,"Away","Sydney","Carlton",12
1625,1918-07-27,"R12","St Kilda",9,9,63,"Collingwood",6,14,50,"Junction Oval",13,1918,"Regular",12,"Home","St Kilda","Collingwood",13
1626,1918-07-27,"R12","Essendon",8,10,58,"Fitzroy",6,6,42,"East Melbourne",16,1918,"Regular",12,"Home","Essendon","Fitzroy",16
1627,1918-07-27,"R12","Richmond",15,15,105,"Geelong",10,11,71,"Punt Rd",34,1918,"Regular",12,"Home","Richmond","Geelong",34
1628,1918-08-03,"R13","Fitzroy",8,12,60,"Collingwood",10,19,79,"Brunswick St",-19,1918,"Regular",13,"Away","Collingwood","Fitzroy",19
1629,1918-08-03,"R13","Sydney",12,13,85,"Essendon",7,10,52,"Lake Oval",33,1918,"Regular",13,"Home","Sydney","Essendon",33
1630,1918-08-03,"R13","St Kilda",10,7,67,"Richmond",8,9,57,"Junction Oval",10,1918,"Regular",13,"Home","St Kilda","Richmond",10
1631,1918-08-03,"R13","Geelong",10,7,67,"Carlton",4,13,37,"Corio Oval",30,1918,"Regular",13,"Home","Geelong","Carlton",30
1632,1918-08-10,"R14","Carlton",10,14,74,"Fitzroy",9,7,61,"Princes Park",13,1918,"Regular",14,"Home","Carlton","Fitzroy",13
1633,1918-08-10,"R14","Collingwood",9,14,68,"Essendon",3,8,26,"Victoria Park",42,1918,"Regular",14,"Home","Collingwood","Essendon",42
1634,1918-08-10,"R14","Geelong",10,27,87,"St Kilda",6,6,42,"Corio Oval",45,1918,"Regular",14,"Home","Geelong","St Kilda",45
1635,1918-08-10,"R14","Richmond",7,12,54,"Sydney",7,17,59,"Punt Rd",-5,1918,"Regular",14,"Away","Sydney","Richmond",5
1636,1918-08-17,"SF","Collingwood",7,16,58,"St Kilda",7,7,49,"M.C.G.",9,1918,"Finals",15,"Home","Collingwood","St Kilda",9
1637,1918-08-31,"SF","Sydney",8,10,58,"Carlton",7,11,53,"M.C.G.",5,1918,"Finals",15,"Home","Sydney","Carlton",5
1638,1918-09-07,"GF","Sydney",9,8,62,"Collingwood",7,15,57,"M.C.G.",5,1918,"Finals",16,"Home","Sydney","Collingwood",5
1639,1919-05-03,"R1","Carlton",14,14,98,"Fitzroy",8,7,55,"Princes Park",43,1919,"Regular",1,"Home","Carlton","Fitzroy",43
1640,1919-05-03,"R1","Sydney",6,13,49,"Collingwood",9,8,62,"Lake Oval",-13,1919,"Regular",1,"Away","Collingwood","Sydney",13
1641,1919-05-03,"R1","Richmond",12,19,91,"Essendon",10,11,71,"Punt Rd",20,1919,"Regular",1,"Home","Richmond","Essendon",20
1642,1919-05-03,"R1","St Kilda",12,14,86,"Melbourne",9,4,58,"Junction Oval",28,1919,"Regular",1,"Home","St Kilda","Melbourne",28
1643,1919-05-10,"R2","Essendon",9,11,65,"Carlton",7,11,53,"East Melbourne",12,1919,"Regular",2,"Home","Essendon","Carlton",12
1644,1919-05-10,"R2","Collingwood",5,15,45,"St Kilda",5,18,48,"Victoria Park",-3,1919,"Regular",2,"Away","St Kilda","Collingwood",3
1645,1919-05-10,"R2","Geelong",7,9,51,"Richmond",10,6,66,"Corio Oval",-15,1919,"Regular",2,"Away","Richmond","Geelong",15
1646,1919-05-10,"R2","Melbourne",3,10,28,"Sydney",10,19,79,"M.C.G.",-51,1919,"Regular",2,"Away","Sydney","Melbourne",51
1647,1919-05-17,"R3","Geelong",5,2,32,"Collingwood",5,19,49,"Corio Oval",-17,1919,"Regular",3,"Away","Collingwood","Geelong",17
1648,1919-05-17,"R3","Fitzroy",18,10,118,"Essendon",5,12,42,"Brunswick St",76,1919,"Regular",3,"Home","Fitzroy","Essendon",76
1649,1919-05-17,"R3","Melbourne",7,7,49,"Richmond",11,14,80,"M.C.G.",-31,1919,"Regular",3,"Away","Richmond","Melbourne",31
1650,1919-05-17,"R3","St Kilda",4,7,31,"Sydney",9,13,67,"Junction Oval",-36,1919,"Regular",3,"Away","Sydney","St Kilda",36
1651,1919-05-24,"R4","Carlton",13,21,99,"Geelong",3,4,22,"Princes Park",77,1919,"Regular",4,"Home","Carlton","Geelong",77
1652,1919-05-24,"R4","Richmond",8,6,54,"Collingwood",11,8,74,"Punt Rd",-20,1919,"Regular",4,"Away","Collingwood","Richmond",20
1653,1919-05-24,"R4","Essendon",4,9,33,"St Kilda",7,6,48,"East Melbourne",-15,1919,"Regular",4,"Away","St Kilda","Essendon",15
1654,1919-05-24,"R4","Sydney",4,15,39,"Fitzroy",4,12,36,"Lake Oval",3,1919,"Regular",4,"Home","Sydney","Fitzroy",3
1655,1919-05-31,"R5","Carlton",18,15,123,"Melbourne",5,4,34,"Princes Park",89,1919,"Regular",5,"Home","Carlton","Melbourne",89
1656,1919-05-31,"R5","Essendon",7,8,50,"Sydney",9,16,70,"East Melbourne",-20,1919,"Regular",5,"Away","Sydney","Essendon",20
1657,1919-05-31,"R5","Fitzroy",10,14,74,"Richmond",7,6,48,"Brunswick St",26,1919,"Regular",5,"Home","Fitzroy","Richmond",26
1658,1919-05-31,"R5","Geelong",0,18,18,"St Kilda",6,10,46,"Corio Oval",-28,1919,"Regular",5,"Away","St Kilda","Geelong",28
1659,1919-06-07,"R6","Collingwood",16,20,116,"Melbourne",8,7,55,"Victoria Park",61,1919,"Regular",6,"Home","Collingwood","Melbourne",61
1660,1919-06-07,"R6","Richmond",7,20,62,"Sydney",11,16,82,"Punt Rd",-20,1919,"Regular",6,"Away","Sydney","Richmond",20
1661,1919-06-09,"R6","St Kilda",7,11,53,"Carlton",11,9,75,"Junction Oval",-22,1919,"Regular",6,"Away","Carlton","St Kilda",22
1662,1919-06-09,"R6","Fitzroy",7,18,60,"Geelong",4,4,28,"Brunswick St",32,1919,"Regular",6,"Home","Fitzroy","Geelong",32
1663,1919-06-14,"R7","Carlton",9,16,70,"Collingwood",8,11,59,"Princes Park",11,1919,"Regular",7,"Home","Carlton","Collingwood",11
1664,1919-06-14,"R7","Geelong",6,8,44,"Essendon",8,8,56,"Corio Oval",-12,1919,"Regular",7,"Away","Essendon","Geelong",12
1665,1919-06-14,"R7","Melbourne",6,6,42,"Fitzroy",11,12,78,"M.C.G.",-36,1919,"Regular",7,"Away","Fitzroy","Melbourne",36
1666,1919-06-14,"R7","St Kilda",5,12,42,"Richmond",7,9,51,"Junction Oval",-9,1919,"Regular",7,"Away","Richmond","St Kilda",9
1667,1919-06-21,"R8","Sydney",6,13,49,"Carlton",6,8,44,"Lake Oval",5,1919,"Regular",8,"Home","Sydney","Carlton",5
1668,1919-06-21,"R8","Essendon",6,8,44,"Collingwood",10,10,70,"East Melbourne",-26,1919,"Regular",8,"Away","Collingwood","Essendon",26
1669,1919-06-21,"R8","Fitzroy",13,14,92,"St Kilda",7,5,47,"Brunswick St",45,1919,"Regular",8,"Home","Fitzroy","St Kilda",45
1670,1919-06-21,"R8","Melbourne",7,10,52,"Geelong",10,12,72,"M.C.G.",-20,1919,"Regular",8,"Away","Geelong","Melbourne",20
1671,1919-06-28,"R9","Carlton",9,15,69,"Richmond",14,11,95,"Princes Park",-26,1919,"Regular",9,"Away","Richmond","Carlton",26
1672,1919-06-28,"R9","Collingwood",9,14,68,"Fitzroy",10,11,71,"Victoria Park",-3,1919,"Regular",9,"Away","Fitzroy","Collingwood",3
1673,1919-06-28,"R9","Essendon",16,17,113,"Melbourne",6,8,44,"East Melbourne",69,1919,"Regular",9,"Home","Essendon","Melbourne",69
1674,1919-06-28,"R9","Sydney",5,22,52,"Geelong",5,4,34,"Lake Oval",18,1919,"Regular",9,"Home","Sydney","Geelong",18
1675,1919-07-12,"R10","Fitzroy",5,11,41,"Carlton",5,9,39,"Brunswick St",2,1919,"Regular",10,"Home","Fitzroy","Carlton",2
1676,1919-07-12,"R10","Collingwood",8,11,59,"Sydney",3,18,36,"Victoria Park",23,1919,"Regular",10,"Home","Collingwood","Sydney",23
1677,1919-07-12,"R10","Essendon",6,10,46,"Richmond",6,15,51,"East Melbourne",-5,1919,"Regular",10,"Away","Richmond","Essendon",5
1678,1919-07-12,"R10","Melbourne",5,7,37,"St Kilda",6,11,47,"M.C.G.",-10,1919,"Regular",10,"Away","St Kilda","Melbourne",10
1679,1919-07-19,"R11","Carlton",7,8,50,"Essendon",9,11,65,"Princes Park",-15,1919,"Regular",11,"Away","Essendon","Carlton",15
1680,1919-07-19,"R11","St Kilda",5,9,39,"Collingwood",13,13,91,"Junction Oval",-52,1919,"Regular",11,"Away","Collingwood","St Kilda",52
1681,1919-07-19,"R11","Richmond",16,15,111,"Geelong",7,14,56,"Punt Rd",55,1919,"Regular",11,"Home","Richmond","Geelong",55
1682,1919-07-19,"R11","Sydney",13,16,94,"Melbourne",2,15,27,"Lake Oval",67,1919,"Regular",11,"Home","Sydney","Melbourne",67
1683,1919-07-26,"R12","Collingwood",12,11,83,"Geelong",4,7,31,"Victoria Park",52,1919,"Regular",12,"Home","Collingwood","Geelong",52
1684,1919-07-26,"R12","Essendon",9,13,67,"Fitzroy",8,8,56,"East Melbourne",11,1919,"Regular",12,"Home","Essendon","Fitzroy",11
1685,1919-07-26,"R12","Richmond",9,18,72,"Melbourne",7,6,48,"Punt Rd",24,1919,"Regular",12,"Home","Richmond","Melbourne",24
1686,1919-07-26,"R12","Sydney",29,15,189,"St Kilda",2,6,18,"Lake Oval",171,1919,"Regular",12,"Home","Sydney","St Kilda",171
1687,1919-08-09,"R13","Geelong",8,11,59,"Carlton",12,22,94,"Corio Oval",-35,1919,"Regular",13,"Away","Carlton","Geelong",35
1688,1919-08-09,"R13","Collingwood",11,12,78,"Richmond",9,11,65,"Victoria Park",13,1919,"Regular",13,"Home","Collingwood","Richmond",13
1689,1919-08-09,"R13","St Kilda",6,10,46,"Essendon",4,10,34,"Junction Oval",12,1919,"Regular",13,"Home","St Kilda","Essendon",12
1690,1919-08-09,"R13","Fitzroy",7,5,47,"Sydney",14,10,94,"Brunswick St",-47,1919,"Regular",13,"Away","Sydney","Fitzroy",47
1691,1919-08-16,"R14","Melbourne",5,6,36,"Carlton",13,18,96,"M.C.G.",-60,1919,"Regular",14,"Away","Carlton","Melbourne",60
1692,1919-08-16,"R14","Sydney",12,15,87,"Essendon",8,7,55,"Lake Oval",32,1919,"Regular",14,"Home","Sydney","Essendon",32
1693,1919-08-16,"R14","Richmond",6,21,57,"Fitzroy",3,13,31,"Punt Rd",26,1919,"Regular",14,"Home","Richmond","Fitzroy",26
1694,1919-08-16,"R14","St Kilda",12,18,90,"Geelong",10,17,77,"Junction Oval",13,1919,"Regular",14,"Home","St Kilda","Geelong",13
1695,1919-08-23,"R15","Carlton",10,14,74,"St Kilda",9,4,58,"Princes Park",16,1919,"Regular",15,"Home","Carlton","St Kilda",16
1696,1919-08-23,"R15","Melbourne",5,6,36,"Collingwood",20,25,145,"M.C.G.",-109,1919,"Regular",15,"Away","Collingwood","Melbourne",109
1697,1919-08-23,"R15","Geelong",11,9,75,"Fitzroy",11,9,75,"Corio Oval",0,1919,"Regular",15,"Home","Geelong","Fitzroy",0
1698,1919-08-23,"R15","Sydney",6,7,43,"Richmond",4,14,38,"Lake Oval",5,1919,"Regular",15,"Home","Sydney","Richmond",5
1699,1919-08-30,"R16","Collingwood",17,11,113,"Carlton",5,16,46,"Victoria Park",67,1919,"Regular",16,"Home","Collingwood","Carlton",67
1700,1919-08-30,"R16","Essendon",9,18,72,"Geelong",6,13,49,"East Melbourne",23,1919,"Regular",16,"Home","Essendon","Geelong",23
1701,1919-08-30,"R16","Fitzroy",21,16,142,"Melbourne",2,5,17,"Brunswick St",125,1919,"Regular",16,"Home","Fitzroy","Melbourne",125
1702,1919-08-30,"R16","Richmond",14,16,100,"St Kilda",5,11,41,"Punt Rd",59,1919,"Regular",16,"Home","Richmond","St Kilda",59
1703,1919-09-06,"R17","Carlton",8,11,59,"Sydney",8,7,55,"Princes Park",4,1919,"Regular",17,"Home","Carlton","Sydney",4
1704,1919-09-06,"R17","Collingwood",9,13,67,"Essendon",5,14,44,"Victoria Park",23,1919,"Regular",17,"Home","Collingwood","Essendon",23
1705,1919-09-06,"R17","St Kilda",3,14,32,"Fitzroy",7,10,52,"Junction Oval",-20,1919,"Regular",17,"Away","Fitzroy","St Kilda",20
1706,1919-09-06,"R17","Geelong",14,12,96,"Melbourne",6,15,51,"Corio Oval",45,1919,"Regular",17,"Home","Geelong","Melbourne",45
1707,1919-09-13,"R18","Richmond",5,12,42,"Carlton",7,19,61,"Punt Rd",-19,1919,"Regular",18,"Away","Carlton","Richmond",19
1708,1919-09-13,"R18","Fitzroy",6,10,46,"Collingwood",9,10,64,"Brunswick St",-18,1919,"Regular",18,"Away","Collingwood","Fitzroy",18
1709,1919-09-13,"R18","Melbourne",4,9,33,"Essendon",10,7,67,"M.C.G.",-34,1919,"Regular",18,"Away","Essendon","Melbourne",34
1710,1919-09-13,"R18","Geelong",6,14,50,"Sydney",3,8,26,"Corio Oval",24,1919,"Regular",18,"Home","Geelong","Sydney",24
1711,1919-09-20,"SF","Sydney",9,5,59,"Richmond",10,13,73,"M.C.G.",-14,1919,"Finals",19,"Away","Richmond","Sydney",14
1712,1919-09-27,"SF","Collingwood",9,10,64,"Carlton",6,10,46,"M.C.G.",18,1919,"Finals",19,"Home","Collingwood","Carlton",18
1713,1919-10-04,"PF","Collingwood",6,9,45,"Richmond",10,14,74,"M.C.G.",-29,1919,"Finals",20,"Away","Richmond","Collingwood",29
1714,1919-10-11,"GF","Collingwood",11,12,78,"Richmond",7,11,53,"M.C.G.",25,1919,"Finals",21,"Home","Collingwood","Richmond",25
1715,1920-05-01,"R1","Carlton",10,10,70,"St Kilda",5,11,41,"Princes Park",29,1920,"Regular",1,"Home","Carlton","St Kilda",29
1716,1920-05-01,"R1","Collingwood",5,6,36,"Essendon",7,12,54,"Victoria Park",-18,1920,"Regular",1,"Away","Essendon","Collingwood",18
1717,1920-05-01,"R1","Fitzroy",8,11,59,"Richmond",11,13,79,"Brunswick St",-20,1920,"Regular",1,"Away","Richmond","Fitzroy",20
1718,1920-05-01,"R1","Melbourne",9,13,67,"Sydney",8,7,55,"M.C.G.",12,1920,"Regular",1,"Home","Melbourne","Sydney",12
1719,1920-05-08,"R2","Richmond",14,13,97,"Carlton",9,14,68,"Punt Rd",29,1920,"Regular",2,"Home","Richmond","Carlton",29
1720,1920-05-08,"R2","Geelong",7,8,50,"Collingwood",7,13,55,"Corio Oval",-5,1920,"Regular",2,"Away","Collingwood","Geelong",5
1721,1920-05-08,"R2","Essendon",9,11,65,"Melbourne",12,8,80,"East Melbourne",-15,1920,"Regular",2,"Away","Melbourne","Essendon",15
1722,1920-05-08,"R2","Sydney",6,13,49,"Fitzroy",12,7,79,"Lake Oval",-30,1920,"Regular",2,"Away","Fitzroy","Sydney",30
1723,1920-05-15,"R3","Carlton",3,11,29,"Fitzroy",5,8,38,"Princes Park",-9,1920,"Regular",3,"Away","Fitzroy","Carlton",9
1724,1920-05-15,"R3","Collingwood",4,20,44,"Melbourne",3,5,23,"Victoria Park",21,1920,"Regular",3,"Home","Collingwood","Melbourne",21
1725,1920-05-15,"R3","Essendon",7,13,55,"Sydney",9,9,63,"East Melbourne",-8,1920,"Regular",3,"Away","Sydney","Essendon",8
1726,1920-05-15,"R3","St Kilda",11,12,78,"Geelong",8,8,56,"Junction Oval",22,1920,"Regular",3,"Home","St Kilda","Geelong",22
1727,1920-05-22,"R4","Essendon",7,13,55,"Carlton",14,17,101,"East Melbourne",-46,1920,"Regular",4,"Away","Carlton","Essendon",46
1728,1920-05-22,"R4","Fitzroy",9,7,61,"Collingwood",7,11,53,"Brunswick St",8,1920,"Regular",4,"Home","Fitzroy","Collingwood",8
1729,1920-05-22,"R4","Geelong",10,4,64,"Richmond",9,19,73,"Corio Oval",-9,1920,"Regular",4,"Away","Richmond","Geelong",9
1730,1920-05-22,"R4","Melbourne",11,15,81,"St Kilda",5,11,41,"M.C.G.",40,1920,"Regular",4,"Home","Melbourne","St Kilda",40
1731,1920-05-26,"R5","Richmond",11,12,78,"Collingwood",10,11,71,"Punt Rd",7,1920,"Regular",5,"Home","Richmond","Collingwood",7
1732,1920-05-26,"R5","Fitzroy",13,18,96,"Geelong",8,8,56,"Brunswick St",40,1920,"Regular",5,"Home","Fitzroy","Geelong",40
1733,1920-05-26,"R5","Sydney",8,10,58,"Carlton",4,15,39,"Lake Oval",19,1920,"Regular",5,"Home","Sydney","Carlton",19
1734,1920-05-26,"R5","St Kilda",8,6,54,"Essendon",8,15,63,"Junction Oval",-9,1920,"Regular",5,"Away","Essendon","St Kilda",9
1735,1920-06-05,"R6","Carlton",7,24,66,"Melbourne",13,6,84,"Princes Park",-18,1920,"Regular",6,"Away","Melbourne","Carlton",18
1736,1920-06-05,"R6","Richmond",9,7,61,"Sydney",5,4,34,"Punt Rd",27,1920,"Regular",6,"Home","Richmond","Sydney",27
1737,1920-06-07,"R6","Collingwood",12,11,83,"St Kilda",7,10,52,"Victoria Park",31,1920,"Regular",6,"Home","Collingwood","St Kilda",31
1738,1920-06-07,"R6","Essendon",13,26,104,"Geelong",12,13,85,"East Melbourne",19,1920,"Regular",6,"Home","Essendon","Geelong",19
1739,1920-06-12,"R7","Geelong",9,16,70,"Carlton",11,13,79,"Corio Oval",-9,1920,"Regular",7,"Away","Carlton","Geelong",9
1740,1920-06-12,"R7","Fitzroy",6,7,43,"Essendon",14,9,93,"Brunswick St",-50,1920,"Regular",7,"Away","Essendon","Fitzroy",50
1741,1920-06-12,"R7","Melbourne",10,8,68,"Richmond",12,16,88,"M.C.G.",-20,1920,"Regular",7,"Away","Richmond","Melbourne",20
1742,1920-06-12,"R7","St Kilda",7,11,53,"Sydney",13,10,88,"Junction Oval",-35,1920,"Regular",7,"Away","Sydney","St Kilda",35
1743,1920-06-19,"R8","Collingwood",12,13,85,"Carlton",10,6,66,"Victoria Park",19,1920,"Regular",8,"Home","Collingwood","Carlton",19
1744,1920-06-19,"R8","Melbourne",6,10,46,"Fitzroy",16,12,108,"M.C.G.",-62,1920,"Regular",8,"Away","Fitzroy","Melbourne",62
1745,1920-06-19,"R8","Sydney",16,23,119,"Geelong",5,16,46,"Lake Oval",73,1920,"Regular",8,"Home","Sydney","Geelong",73
1746,1920-06-19,"R8","Richmond",19,15,129,"St Kilda",8,6,54,"Punt Rd",75,1920,"Regular",8,"Home","Richmond","St Kilda",75
1747,1920-06-26,"R9","Sydney",9,9,63,"Collingwood",10,7,67,"Lake Oval",-4,1920,"Regular",9,"Away","Collingwood","Sydney",4
1748,1920-06-26,"R9","Richmond",13,17,95,"Essendon",11,9,75,"Punt Rd",20,1920,"Regular",9,"Home","Richmond","Essendon",20
1749,1920-06-26,"R9","St Kilda",4,4,28,"Fitzroy",14,18,102,"Junction Oval",-74,1920,"Regular",9,"Away","Fitzroy","St Kilda",74
1750,1920-06-26,"R9","Geelong",16,17,113,"Melbourne",6,12,48,"Corio Oval",65,1920,"Regular",9,"Home","Geelong","Melbourne",65
1751,1920-07-03,"R10","St Kilda",8,9,57,"Carlton",11,15,81,"Junction Oval",-24,1920,"Regular",10,"Away","Carlton","St Kilda",24
1752,1920-07-03,"R10","Essendon",8,7,55,"Collingwood",9,8,62,"East Melbourne",-7,1920,"Regular",10,"Away","Collingwood","Essendon",7
1753,1920-07-03,"R10","Richmond",8,12,60,"Fitzroy",12,6,78,"Punt Rd",-18,1920,"Regular",10,"Away","Fitzroy","Richmond",18
1754,1920-07-03,"R10","Sydney",12,13,85,"Melbourne",5,11,41,"Lake Oval",44,1920,"Regular",10,"Home","Sydney","Melbourne",44
1755,1920-07-10,"R11","Carlton",8,11,59,"Richmond",3,8,26,"Princes Park",33,1920,"Regular",11,"Home","Carlton","Richmond",33
1756,1920-07-10,"R11","Collingwood",11,17,83,"Geelong",5,11,41,"Victoria Park",42,1920,"Regular",11,"Home","Collingwood","Geelong",42
1757,1920-07-10,"R11","Melbourne",5,13,43,"Essendon",7,18,60,"M.C.G.",-17,1920,"Regular",11,"Away","Essendon","Melbourne",17
1758,1920-07-10,"R11","Fitzroy",9,13,67,"Sydney",8,14,62,"Brunswick St",5,1920,"Regular",11,"Home","Fitzroy","Sydney",5
1759,1920-07-17,"R12","Fitzroy",11,9,75,"Carlton",8,14,62,"Brunswick St",13,1920,"Regular",12,"Home","Fitzroy","Carlton",13
1760,1920-07-17,"R12","Melbourne",8,11,59,"Collingwood",10,15,75,"M.C.G.",-16,1920,"Regular",12,"Away","Collingwood","Melbourne",16
1761,1920-07-17,"R12","Sydney",8,14,62,"Essendon",7,7,49,"Lake Oval",13,1920,"Regular",12,"Home","Sydney","Essendon",13
1762,1920-07-17,"R12","Geelong",16,17,113,"St Kilda",9,8,62,"Corio Oval",51,1920,"Regular",12,"Home","Geelong","St Kilda",51
1763,1920-07-31,"R13","Carlton",11,14,80,"Sydney",7,11,53,"Princes Park",27,1920,"Regular",13,"Home","Carlton","Sydney",27
1764,1920-07-31,"R13","Collingwood",5,6,36,"Richmond",5,8,38,"Victoria Park",-2,1920,"Regular",13,"Away","Richmond","Collingwood",2
1765,1920-07-31,"R13","Essendon",7,9,51,"St Kilda",10,10,70,"East Melbourne",-19,1920,"Regular",13,"Away","St Kilda","Essendon",19
1766,1920-07-31,"R13","Geelong",4,9,33,"Fitzroy",7,13,55,"Corio Oval",-22,1920,"Regular",13,"Away","Fitzroy","Geelong",22
1767,1920-08-07,"R14","Carlton",13,11,89,"Essendon",8,14,62,"Princes Park",27,1920,"Regular",14,"Home","Carlton","Essendon",27
1768,1920-08-07,"R14","Collingwood",7,15,57,"Fitzroy",10,11,71,"Victoria Park",-14,1920,"Regular",14,"Away","Fitzroy","Collingwood",14
1769,1920-08-07,"R14","Richmond",16,16,112,"Geelong",5,14,44,"Punt Rd",68,1920,"Regular",14,"Home","Richmond","Geelong",68
1770,1920-08-07,"R14","St Kilda",3,3,21,"Melbourne",11,17,83,"Junction Oval",-62,1920,"Regular",14,"Away","Melbourne","St Kilda",62
1771,1920-08-14,"R15","Melbourne",3,7,25,"Carlton",12,15,87,"M.C.G.",-62,1920,"Regular",15,"Away","Carlton","Melbourne",62
1772,1920-08-14,"R15","St Kilda",8,7,55,"Collingwood",17,11,113,"Junction Oval",-58,1920,"Regular",15,"Away","Collingwood","St Kilda",58
1773,1920-08-14,"R15","Geelong",14,10,94,"Essendon",10,13,73,"Corio Oval",21,1920,"Regular",15,"Home","Geelong","Essendon",21
1774,1920-08-14,"R15","Sydney",9,7,61,"Richmond",14,8,92,"Lake Oval",-31,1920,"Regular",15,"Away","Richmond","Sydney",31
1775,1920-08-21,"R16","Carlton",15,14,104,"Geelong",6,5,41,"Princes Park",63,1920,"Regular",16,"Home","Carlton","Geelong",63
1776,1920-08-21,"R16","Essendon",10,7,67,"Fitzroy",12,11,83,"East Melbourne",-16,1920,"Regular",16,"Away","Fitzroy","Essendon",16
1777,1920-08-21,"R16","Richmond",20,14,134,"Melbourne",8,12,60,"Punt Rd",74,1920,"Regular",16,"Home","Richmond","Melbourne",74
1778,1920-08-21,"R16","Sydney",11,17,83,"St Kilda",3,14,32,"Lake Oval",51,1920,"Regular",16,"Home","Sydney","St Kilda",51
1779,1920-08-28,"R17","Carlton",16,13,109,"Collingwood",7,15,57,"Princes Park",52,1920,"Regular",17,"Home","Carlton","Collingwood",52
1780,1920-08-28,"R17","Fitzroy",16,12,108,"Melbourne",6,9,45,"Brunswick St",63,1920,"Regular",17,"Home","Fitzroy","Melbourne",63
1781,1920-08-28,"R17","Geelong",11,10,76,"Sydney",8,25,73,"Corio Oval",3,1920,"Regular",17,"Home","Geelong","Sydney",3
1782,1920-08-28,"R17","St Kilda",7,10,52,"Richmond",12,15,87,"Junction Oval",-35,1920,"Regular",17,"Away","Richmond","St Kilda",35
1783,1920-09-04,"R18","Collingwood",16,12,108,"Sydney",13,13,91,"Victoria Park",17,1920,"Regular",18,"Home","Collingwood","Sydney",17
1784,1920-09-04,"R18","Essendon",6,5,41,"Richmond",15,14,104,"East Melbourne",-63,1920,"Regular",18,"Away","Richmond","Essendon",63
1785,1920-09-04,"R18","Fitzroy",22,17,149,"St Kilda",11,3,69,"Brunswick St",80,1920,"Regular",18,"Home","Fitzroy","St Kilda",80
1786,1920-09-04,"R18","Melbourne",12,15,87,"Geelong",17,14,116,"M.C.G.",-29,1920,"Regular",18,"Away","Geelong","Melbourne",29
1787,1920-09-11,"SF","Fitzroy",3,5,23,"Collingwood",4,17,41,"M.C.G.",-18,1920,"Finals",19,"Away","Collingwood","Fitzroy",18
1788,1920-09-18,"SF","Richmond",4,6,30,"Carlton",7,11,53,"M.C.G.",-23,1920,"Finals",19,"Away","Carlton","Richmond",23
1789,1920-09-25,"PF","Carlton",8,11,59,"Collingwood",12,11,83,"M.C.G.",-24,1920,"Finals",20,"Away","Collingwood","Carlton",24
1790,1920-10-02,"GF","Richmond",7,10,52,"Collingwood",5,5,35,"M.C.G.",17,1920,"Finals",21,"Home","Richmond","Collingwood",17
1791,1921-05-07,"R1","Richmond",7,11,53,"Carlton",8,14,62,"Punt Rd",-9,1921,"Regular",1,"Away","Carlton","Richmond",9
1792,1921-05-07,"R1","Collingwood",10,13,73,"Fitzroy",9,3,57,"Victoria Park",16,1921,"Regular",1,"Home","Collingwood","Fitzroy",16
1793,1921-05-07,"R1","Essendon",11,12,78,"Melbourne",12,6,78,"East Melbourne",0,1921,"Regular",1,"Home","Essendon","Melbourne",0
1794,1921-05-07,"R1","St Kilda",10,6,66,"Sydney",9,13,67,"Junction Oval",-1,1921,"Regular",1,"Away","Sydney","St Kilda",1
1795,1921-05-14,"R2","Melbourne",7,11,53,"Collingwood",14,13,97,"M.C.G.",-44,1921,"Regular",2,"Away","Collingwood","Melbourne",44
1796,1921-05-14,"R2","Fitzroy",7,11,53,"St Kilda",8,15,63,"Brunswick St",-10,1921,"Regular",2,"Away","St Kilda","Fitzroy",10
1797,1921-05-14,"R2","Sydney",7,9,51,"Richmond",11,16,82,"Lake Oval",-31,1921,"Regular",2,"Away","Richmond","Sydney",31
1798,1921-05-14,"R2","Geelong",11,19,85,"Essendon",10,16,76,"Corio Oval",9,1921,"Regular",2,"Home","Geelong","Essendon",9
1799,1921-05-21,"R3","Carlton",15,11,101,"St Kilda",11,12,78,"Princes Park",23,1921,"Regular",3,"Home","Carlton","St Kilda",23
1800,1921-05-21,"R3","Collingwood",16,9,105,"Geelong",13,9,87,"Victoria Park",18,1921,"Regular",3,"Home","Collingwood","Geelong",18
1801,1921-05-21,"R3","Sydney",4,14,38,"Essendon",11,15,81,"Lake Oval",-43,1921,"Regular",3,"Away","Essendon","Sydney",43
1802,1921-05-21,"R3","Fitzroy",5,6,36,"Richmond",5,14,44,"Brunswick St",-8,1921,"Regular",3,"Away","Richmond","Fitzroy",8
1803,1921-05-28,"R4","Carlton",5,20,50,"Fitzroy",6,14,50,"Princes Park",0,1921,"Regular",4,"Home","Carlton","Fitzroy",0
1804,1921-05-28,"R4","Essendon",7,12,54,"Collingwood",9,17,71,"East Melbourne",-17,1921,"Regular",4,"Away","Collingwood","Essendon",17
1805,1921-05-28,"R4","Geelong",11,13,79,"Richmond",9,8,62,"Corio Oval",17,1921,"Regular",4,"Home","Geelong","Richmond",17
1806,1921-05-28,"R4","Melbourne",10,10,70,"Sydney",9,15,69,"M.C.G.",1,1921,"Regular",4,"Home","Melbourne","Sydney",1
1807,1921-06-04,"R5","Sydney",10,10,70,"Carlton",10,10,70,"Lake Oval",0,1921,"Regular",5,"Home","Sydney","Carlton",0
1808,1921-06-04,"R5","Richmond",7,11,53,"Collingwood",6,16,52,"Punt Rd",1,1921,"Regular",5,"Home","Richmond","Collingwood",1
1809,1921-06-06,"R5","Fitzroy",8,14,62,"Geelong",12,12,84,"Brunswick St",-22,1921,"Regular",5,"Away","Geelong","Fitzroy",22
1810,1921-06-06,"R5","St Kilda",12,18,90,"Melbourne",13,12,90,"Junction Oval",0,1921,"Regular",5,"Home","St Kilda","Melbourne",0
1811,1921-06-11,"R6","Essendon",7,18,60,"Carlton",18,9,117,"East Melbourne",-57,1921,"Regular",6,"Away","Carlton","Essendon",57
1812,1921-06-11,"R6","Collingwood",9,13,67,"Sydney",6,8,44,"Victoria Park",23,1921,"Regular",6,"Home","Collingwood","Sydney",23
1813,1921-06-11,"R6","Geelong",11,13,79,"St Kilda",5,5,35,"Corio Oval",44,1921,"Regular",6,"Home","Geelong","St Kilda",44
1814,1921-06-11,"R6","Richmond",14,11,95,"Melbourne",13,14,92,"Punt Rd",3,1921,"Regular",6,"Home","Richmond","Melbourne",3
1815,1921-06-18,"R7","Carlton",11,15,81,"Geelong",8,13,61,"Princes Park",20,1921,"Regular",7,"Home","Carlton","Geelong",20
1816,1921-06-18,"R7","Collingwood",17,12,114,"St Kilda",9,10,64,"Victoria Park",50,1921,"Regular",7,"Home","Collingwood","St Kilda",50
1817,1921-06-18,"R7","Richmond",12,14,86,"Essendon",10,11,71,"Punt Rd",15,1921,"Regular",7,"Home","Richmond","Essendon",15
1818,1921-06-18,"R7","Melbourne",9,15,69,"Fitzroy",4,17,41,"M.C.G.",28,1921,"Regular",7,"Home","Melbourne","Fitzroy",28
1819,1921-06-25,"R8","Melbourne",7,13,55,"Carlton",8,14,62,"M.C.G.",-7,1921,"Regular",8,"Away","Carlton","Melbourne",7
1820,1921-06-25,"R8","Fitzroy",12,13,85,"Essendon",6,10,46,"Brunswick St",39,1921,"Regular",8,"Home","Fitzroy","Essendon",39
1821,1921-06-25,"R8","Sydney",10,14,74,"Geelong",8,5,53,"Lake Oval",21,1921,"Regular",8,"Home","Sydney","Geelong",21
1822,1921-06-25,"R8","St Kilda",5,12,42,"Richmond",13,11,89,"Junction Oval",-47,1921,"Regular",8,"Away","Richmond","St Kilda",47
1823,1921-07-02,"R9","Carlton",12,16,88,"Collingwood",10,4,64,"Princes Park",24,1921,"Regular",9,"Home","Carlton","Collingwood",24
1824,1921-07-02,"R9","Essendon",5,12,42,"St Kilda",11,17,83,"East Melbourne",-41,1921,"Regular",9,"Away","St Kilda","Essendon",41
1825,1921-07-02,"R9","Sydney",8,18,66,"Fitzroy",6,12,48,"Lake Oval",18,1921,"Regular",9,"Home","Sydney","Fitzroy",18
1826,1921-07-02,"R9","Geelong",11,10,76,"Melbourne",8,16,64,"Corio Oval",12,1921,"Regular",9,"Home","Geelong","Melbourne",12
1827,1921-07-09,"R10","Carlton",14,15,99,"Richmond",6,12,48,"Princes Park",51,1921,"Regular",10,"Home","Carlton","Richmond",51
1828,1921-07-09,"R10","Fitzroy",8,18,66,"Collingwood",8,8,56,"Brunswick St",10,1921,"Regular",10,"Home","Fitzroy","Collingwood",10
1829,1921-07-09,"R10","Melbourne",7,12,54,"Essendon",11,14,80,"M.C.G.",-26,1921,"Regular",10,"Away","Essendon","Melbourne",26
1830,1921-07-09,"R10","Sydney",13,9,87,"St Kilda",11,8,74,"Lake Oval",13,1921,"Regular",10,"Home","Sydney","St Kilda",13
1831,1921-07-16,"R11","Collingwood",3,14,32,"Melbourne",7,7,49,"Victoria Park",-17,1921,"Regular",11,"Away","Melbourne","Collingwood",17
1832,1921-07-16,"R11","Essendon",2,15,27,"Geelong",9,18,72,"East Melbourne",-45,1921,"Regular",11,"Away","Geelong","Essendon",45
1833,1921-07-16,"R11","St Kilda",0,18,18,"Fitzroy",6,8,44,"Junction Oval",-26,1921,"Regular",11,"Away","Fitzroy","St Kilda",26
1834,1921-07-16,"R11","Richmond",9,12,66,"Sydney",8,13,61,"Punt Rd",5,1921,"Regular",11,"Home","Richmond","Sydney",5
1835,1921-07-23,"R12","St Kilda",5,14,44,"Carlton",22,10,142,"Junction Oval",-98,1921,"Regular",12,"Away","Carlton","St Kilda",98
1836,1921-07-23,"R12","Geelong",10,12,72,"Collingwood",6,11,47,"Corio Oval",25,1921,"Regular",12,"Home","Geelong","Collingwood",25
1837,1921-07-23,"R12","Essendon",8,13,61,"Sydney",5,13,43,"East Melbourne",18,1921,"Regular",12,"Home","Essendon","Sydney",18
1838,1921-07-23,"R12","Richmond",8,12,60,"Fitzroy",14,13,97,"Punt Rd",-37,1921,"Regular",12,"Away","Fitzroy","Richmond",37
1839,1921-07-30,"R13","Fitzroy",4,15,39,"Carlton",3,6,24,"Brunswick St",15,1921,"Regular",13,"Home","Fitzroy","Carlton",15
1840,1921-07-30,"R13","Collingwood",10,11,71,"Essendon",2,11,23,"Victoria Park",48,1921,"Regular",13,"Home","Collingwood","Essendon",48
1841,1921-07-30,"R13","Richmond",9,15,69,"Geelong",5,6,36,"Punt Rd",33,1921,"Regular",13,"Home","Richmond","Geelong",33
1842,1921-07-30,"R13","Sydney",8,21,69,"Melbourne",7,11,53,"Lake Oval",16,1921,"Regular",13,"Home","Sydney","Melbourne",16
1843,1921-08-20,"R14","Carlton",11,15,81,"Sydney",7,14,56,"Princes Park",25,1921,"Regular",14,"Home","Carlton","Sydney",25
1844,1921-08-20,"R14","Collingwood",6,10,46,"Richmond",10,12,72,"Victoria Park",-26,1921,"Regular",14,"Away","Richmond","Collingwood",26
1845,1921-08-20,"R14","Geelong",13,8,86,"Fitzroy",9,10,64,"Corio Oval",22,1921,"Regular",14,"Home","Geelong","Fitzroy",22
1846,1921-08-20,"R14","Melbourne",6,20,56,"St Kilda",5,19,49,"M.C.G.",7,1921,"Regular",14,"Home","Melbourne","St Kilda",7
1847,1921-08-27,"R15","Carlton",7,19,61,"Essendon",7,11,53,"Princes Park",8,1921,"Regular",15,"Home","Carlton","Essendon",8
1848,1921-08-27,"R15","Sydney",5,10,40,"Collingwood",8,7,55,"Lake Oval",-15,1921,"Regular",15,"Away","Collingwood","Sydney",15
1849,1921-08-27,"R15","St Kilda",11,16,82,"Geelong",9,9,63,"Junction Oval",19,1921,"Regular",15,"Home","St Kilda","Geelong",19
1850,1921-08-27,"R15","Melbourne",8,11,59,"Richmond",12,6,78,"M.C.G.",-19,1921,"Regular",15,"Away","Richmond","Melbourne",19
1851,1921-09-03,"R16","Geelong",6,11,47,"Carlton",8,15,63,"Corio Oval",-16,1921,"Regular",16,"Away","Carlton","Geelong",16
1852,1921-09-03,"R16","St Kilda",10,7,67,"Collingwood",12,7,79,"Junction Oval",-12,1921,"Regular",16,"Away","Collingwood","St Kilda",12
1853,1921-09-03,"R16","Essendon",5,15,45,"Richmond",11,14,80,"East Melbourne",-35,1921,"Regular",16,"Away","Richmond","Essendon",35
1854,1921-09-03,"R16","Fitzroy",9,8,62,"Melbourne",9,9,63,"Brunswick St",-1,1921,"Regular",16,"Away","Melbourne","Fitzroy",1
1855,1921-09-10,"R17","Carlton",14,16,100,"Melbourne",10,16,76,"Princes Park",24,1921,"Regular",17,"Home","Carlton","Melbourne",24
1856,1921-09-10,"R17","Essendon",10,14,74,"Fitzroy",11,8,74,"East Melbourne",0,1921,"Regular",17,"Home","Essendon","Fitzroy",0
1857,1921-09-10,"R17","Geelong",10,7,67,"Sydney",3,10,28,"Corio Oval",39,1921,"Regular",17,"Home","Geelong","Sydney",39
1858,1921-09-10,"R17","Richmond",14,11,95,"St Kilda",7,5,47,"Punt Rd",48,1921,"Regular",17,"Home","Richmond","St Kilda",48
1859,1921-09-17,"R18","Collingwood",5,7,37,"Carlton",9,10,64,"Victoria Park",-27,1921,"Regular",18,"Away","Carlton","Collingwood",27
1860,1921-09-17,"R18","St Kilda",14,12,96,"Essendon",13,16,94,"Junction Oval",2,1921,"Regular",18,"Home","St Kilda","Essendon",2
1861,1921-09-17,"R18","Fitzroy",10,19,79,"Sydney",6,9,45,"Brunswick St",34,1921,"Regular",18,"Home","Fitzroy","Sydney",34
1862,1921-09-17,"R18","Melbourne",16,19,115,"Geelong",10,11,71,"M.C.G.",44,1921,"Regular",18,"Home","Melbourne","Geelong",44
1863,1921-09-24,"SF","Richmond",16,19,115,"Geelong",6,18,54,"M.C.G.",61,1921,"Finals",19,"Home","Richmond","Geelong",61
1864,1921-10-01,"SF","Carlton",9,11,65,"Collingwood",7,10,52,"M.C.G.",13,1921,"Finals",19,"Home","Carlton","Collingwood",13
1865,1921-10-08,"PF","Carlton",7,17,59,"Richmond",10,7,67,"M.C.G.",-8,1921,"Finals",20,"Away","Richmond","Carlton",8
1866,1921-10-15,"GF","Carlton",4,8,32,"Richmond",5,6,36,"M.C.G.",-4,1921,"Finals",21,"Away","Richmond","Carlton",4
1867,1922-05-06,"R1","Essendon",11,14,80,"Carlton",9,8,62,"Windy Hill",18,1922,"Regular",1,"Home","Essendon","Carlton",18
1868,1922-05-06,"R1","Richmond",10,13,73,"Collingwood",8,8,56,"Punt Rd",17,1922,"Regular",1,"Home","Richmond","Collingwood",17
1869,1922-05-06,"R1","St Kilda",8,8,56,"Fitzroy",10,9,69,"Junction Oval",-13,1922,"Regular",1,"Away","Fitzroy","St Kilda",13
1870,1922-05-06,"R1","Sydney",7,13,55,"Melbourne",8,12,60,"Lake Oval",-5,1922,"Regular",1,"Away","Melbourne","Sydney",5
1871,1922-05-13,"R2","Carlton",10,13,73,"Fitzroy",9,9,63,"Princes Park",10,1922,"Regular",2,"Home","Carlton","Fitzroy",10
1872,1922-05-13,"R2","Collingwood",9,12,66,"Sydney",10,12,72,"Victoria Park",-6,1922,"Regular",2,"Away","Sydney","Collingwood",6
1873,1922-05-13,"R2","Geelong",6,6,42,"Essendon",8,16,64,"Corio Oval",-22,1922,"Regular",2,"Away","Essendon","Geelong",22
1874,1922-05-13,"R2","Melbourne",13,10,88,"Richmond",12,13,85,"M.C.G.",3,1922,"Regular",2,"Home","Melbourne","Richmond",3
1875,1922-05-20,"R3","Collingwood",10,18,78,"Carlton",10,11,71,"Victoria Park",7,1922,"Regular",3,"Home","Collingwood","Carlton",7
1876,1922-05-20,"R3","Essendon",12,12,84,"Sydney",8,13,61,"Windy Hill",23,1922,"Regular",3,"Home","Essendon","Sydney",23
1877,1922-05-20,"R3","Fitzroy",14,13,97,"Geelong",10,12,72,"Brunswick St",25,1922,"Regular",3,"Home","Fitzroy","Geelong",25
1878,1922-05-20,"R3","St Kilda",12,12,84,"Melbourne",11,8,74,"Junction Oval",10,1922,"Regular",3,"Home","St Kilda","Melbourne",10
1879,1922-05-27,"R4","Carlton",14,12,96,"Melbourne",8,16,64,"Princes Park",32,1922,"Regular",4,"Home","Carlton","Melbourne",32
1880,1922-05-27,"R4","Fitzroy",6,15,51,"Essendon",7,9,51,"Brunswick St",0,1922,"Regular",4,"Home","Fitzroy","Essendon",0
1881,1922-05-27,"R4","Geelong",11,9,75,"Richmond",11,7,73,"Corio Oval",2,1922,"Regular",4,"Home","Geelong","Richmond",2
1882,1922-05-27,"R4","Sydney",8,13,61,"St Kilda",12,5,77,"Lake Oval",-16,1922,"Regular",4,"Away","St Kilda","Sydney",16
1883,1922-06-03,"R5","Sydney",8,15,63,"Carlton",4,11,35,"Lake Oval",28,1922,"Regular",5,"Home","Sydney","Carlton",28
1884,1922-06-03,"R5","Collingwood",15,14,104,"St Kilda",4,11,35,"Victoria Park",69,1922,"Regular",5,"Home","Collingwood","St Kilda",69
1885,1922-06-05,"R5","Richmond",7,12,54,"Essendon",9,10,64,"Punt Rd",-10,1922,"Regular",5,"Away","Essendon","Richmond",10
1886,1922-06-05,"R5","Melbourne",9,12,66,"Geelong",9,6,60,"M.C.G.",6,1922,"Regular",5,"Home","Melbourne","Geelong",6
1887,1922-06-10,"R6","Carlton",13,19,97,"St Kilda",12,14,86,"Princes Park",11,1922,"Regular",6,"Home","Carlton","St Kilda",11
1888,1922-06-10,"R6","Geelong",8,9,57,"Collingwood",19,6,120,"Corio Oval",-63,1922,"Regular",6,"Away","Collingwood","Geelong",63
1889,1922-06-10,"R6","Essendon",12,21,93,"Melbourne",5,12,42,"Windy Hill",51,1922,"Regular",6,"Home","Essendon","Melbourne",51
1890,1922-06-10,"R6","Fitzroy",9,18,72,"Richmond",7,9,51,"Brunswick St",21,1922,"Regular",6,"Home","Fitzroy","Richmond",21
1891,1922-06-17,"R7","Carlton",8,15,63,"Geelong",9,19,73,"Princes Park",-10,1922,"Regular",7,"Away","Geelong","Carlton",10
1892,1922-06-17,"R7","Collingwood",15,10,100,"Fitzroy",10,8,68,"Victoria Park",32,1922,"Regular",7,"Home","Collingwood","Fitzroy",32
1893,1922-06-17,"R7","St Kilda",13,11,89,"Essendon",15,7,97,"Junction Oval",-8,1922,"Regular",7,"Away","Essendon","St Kilda",8
1894,1922-06-17,"R7","Sydney",10,14,74,"Richmond",12,7,79,"Lake Oval",-5,1922,"Regular",7,"Away","Richmond","Sydney",5
1895,1922-06-24,"R8","Richmond",10,6,66,"Carlton",12,11,83,"Punt Rd",-17,1922,"Regular",8,"Away","Carlton","Richmond",17
1896,1922-06-24,"R8","Melbourne",9,13,67,"Collingwood",7,17,59,"M.C.G.",8,1922,"Regular",8,"Home","Melbourne","Collingwood",8
1897,1922-06-24,"R8","Fitzroy",9,13,67,"Sydney",8,8,56,"Brunswick St",11,1922,"Regular",8,"Home","Fitzroy","Sydney",11
1898,1922-06-24,"R8","Geelong",7,12,54,"St Kilda",10,5,65,"Corio Oval",-11,1922,"Regular",8,"Away","St Kilda","Geelong",11
1899,1922-07-01,"R9","Essendon",7,14,56,"Collingwood",10,5,65,"Windy Hill",-9,1922,"Regular",9,"Away","Collingwood","Essendon",9
1900,1922-07-01,"R9","Fitzroy",5,19,49,"Melbourne",4,9,33,"Brunswick St",16,1922,"Regular",9,"Home","Fitzroy","Melbourne",16
1901,1922-07-01,"R9","Geelong",16,18,114,"Sydney",4,6,30,"Corio Oval",84,1922,"Regular",9,"Home","Geelong","Sydney",84
1902,1922-07-01,"R9","Richmond",11,13,79,"St Kilda",7,12,54,"Punt Rd",25,1922,"Regular",9,"Home","Richmond","St Kilda",25
1903,1922-07-15,"R10","Carlton",11,19,85,"Essendon",7,10,52,"Princes Park",33,1922,"Regular",10,"Home","Carlton","Essendon",33
1904,1922-07-15,"R10","Collingwood",6,14,50,"Richmond",3,13,31,"Victoria Park",19,1922,"Regular",10,"Home","Collingwood","Richmond",19
1905,1922-07-15,"R10","Fitzroy",13,11,89,"St Kilda",8,14,62,"Brunswick St",27,1922,"Regular",10,"Home","Fitzroy","St Kilda",27
1906,1922-07-15,"R10","Melbourne",15,10,100,"Sydney",9,18,72,"M.C.G.",28,1922,"Regular",10,"Home","Melbourne","Sydney",28
1907,1922-07-22,"R11","Fitzroy",11,13,79,"Carlton",9,7,61,"Brunswick St",18,1922,"Regular",11,"Home","Fitzroy","Carlton",18
1908,1922-07-22,"R11","Sydney",7,14,56,"Collingwood",8,16,64,"Lake Oval",-8,1922,"Regular",11,"Away","Collingwood","Sydney",8
1909,1922-07-22,"R11","Essendon",12,10,82,"Geelong",13,16,94,"Windy Hill",-12,1922,"Regular",11,"Away","Geelong","Essendon",12
1910,1922-07-22,"R11","Richmond",11,14,80,"Melbourne",10,17,77,"Punt Rd",3,1922,"Regular",11,"Home","Richmond","Melbourne",3
1911,1922-07-29,"R12","Carlton",12,16,88,"Collingwood",11,17,83,"Princes Park",5,1922,"Regular",12,"Home","Carlton","Collingwood",5
1912,1922-07-29,"R12","Sydney",14,15,99,"Essendon",11,8,74,"Lake Oval",25,1922,"Regular",12,"Home","Sydney","Essendon",25
1913,1922-07-29,"R12","Geelong",5,9,39,"Fitzroy",5,19,49,"Corio Oval",-10,1922,"Regular",12,"Away","Fitzroy","Geelong",10
1914,1922-07-29,"R12","Melbourne",13,10,88,"St Kilda",11,10,76,"M.C.G.",12,1922,"Regular",12,"Home","Melbourne","St Kilda",12
1915,1922-08-05,"R13","Melbourne",10,4,64,"Carlton",8,13,61,"M.C.G.",3,1922,"Regular",13,"Home","Melbourne","Carlton",3
1916,1922-08-05,"R13","Essendon",15,7,97,"Fitzroy",12,16,88,"Windy Hill",9,1922,"Regular",13,"Home","Essendon","Fitzroy",9
1917,1922-08-05,"R13","Richmond",12,17,89,"Geelong",11,13,79,"Punt Rd",10,1922,"Regular",13,"Home","Richmond","Geelong",10
1918,1922-08-05,"R13","St Kilda",10,15,75,"Sydney",11,9,75,"Junction Oval",0,1922,"Regular",13,"Home","St Kilda","Sydney",0
1919,1922-08-19,"R14","Carlton",14,19,103,"Sydney",10,15,75,"Princes Park",28,1922,"Regular",14,"Home","Carlton","Sydney",28
1920,1922-08-19,"R14","St Kilda",6,10,46,"Collingwood",8,9,57,"Junction Oval",-11,1922,"Regular",14,"Away","Collingwood","St Kilda",11
1921,1922-08-19,"R14","Essendon",15,13,103,"Richmond",10,6,66,"Windy Hill",37,1922,"Regular",14,"Home","Essendon","Richmond",37
1922,1922-08-19,"R14","Geelong",11,6,72,"Melbourne",5,16,46,"Corio Oval",26,1922,"Regular",14,"Home","Geelong","Melbourne",26
1923,1922-08-26,"R15","St Kilda",4,16,40,"Carlton",5,19,49,"Junction Oval",-9,1922,"Regular",15,"Away","Carlton","St Kilda",9
1924,1922-08-26,"R15","Collingwood",8,20,68,"Geelong",6,8,44,"Victoria Park",24,1922,"Regular",15,"Home","Collingwood","Geelong",24
1925,1922-08-26,"R15","Melbourne",3,10,28,"Essendon",6,8,44,"M.C.G.",-16,1922,"Regular",15,"Away","Essendon","Melbourne",16
1926,1922-08-26,"R15","Richmond",5,10,40,"Fitzroy",3,14,32,"Punt Rd",8,1922,"Regular",15,"Home","Richmond","Fitzroy",8
1927,1922-09-02,"R16","Geelong",11,10,76,"Carlton",16,15,111,"Corio Oval",-35,1922,"Regular",16,"Away","Carlton","Geelong",35
1928,1922-09-02,"R16","Fitzroy",8,14,62,"Collingwood",11,13,79,"Brunswick St",-17,1922,"Regular",16,"Away","Collingwood","Fitzroy",17
1929,1922-09-02,"R16","Essendon",8,15,63,"St Kilda",8,7,55,"Windy Hill",8,1922,"Regular",16,"Home","Essendon","St Kilda",8
1930,1922-09-02,"R16","Richmond",13,8,86,"Sydney",9,10,64,"Punt Rd",22,1922,"Regular",16,"Home","Richmond","Sydney",22
1931,1922-09-09,"R17","Carlton",14,10,94,"Richmond",7,8,50,"Princes Park",44,1922,"Regular",17,"Home","Carlton","Richmond",44
1932,1922-09-09,"R17","Collingwood",11,16,82,"Melbourne",7,11,53,"Victoria Park",29,1922,"Regular",17,"Home","Collingwood","Melbourne",29
1933,1922-09-09,"R17","Sydney",11,12,78,"Fitzroy",14,9,93,"Lake Oval",-15,1922,"Regular",17,"Away","Fitzroy","Sydney",15
1934,1922-09-09,"R17","St Kilda",18,18,126,"Geelong",10,11,71,"Junction Oval",55,1922,"Regular",17,"Home","St Kilda","Geelong",55
1935,1922-09-16,"R18","Collingwood",6,11,47,"Essendon",6,7,43,"Victoria Park",4,1922,"Regular",18,"Home","Collingwood","Essendon",4
1936,1922-09-16,"R18","Melbourne",7,13,55,"Fitzroy",8,15,63,"Princes Park",-8,1922,"Regular",18,"Away","Fitzroy","Melbourne",8
1937,1922-09-16,"R18","Sydney",21,10,136,"Geelong",8,10,58,"Lake Oval",78,1922,"Regular",18,"Home","Sydney","Geelong",78
1938,1922-09-16,"R18","St Kilda",7,22,64,"Richmond",5,7,37,"Junction Oval",27,1922,"Regular",18,"Home","St Kilda","Richmond",27
1939,1922-09-23,"SF","Essendon",5,9,39,"Carlton",4,10,34,"M.C.G.",5,1922,"Finals",19,"Home","Essendon","Carlton",5
1940,1922-09-30,"SF","Collingwood",5,12,42,"Fitzroy",6,10,46,"M.C.G.",-4,1922,"Finals",19,"Away","Fitzroy","Collingwood",4
1941,1922-10-07,"PF","Essendon",6,9,45,"Fitzroy",9,14,68,"M.C.G.",-23,1922,"Finals",20,"Away","Fitzroy","Essendon",23
1942,1922-10-14,"GF","Collingwood",9,14,68,"Fitzroy",11,13,79,"M.C.G.",-11,1922,"Finals",21,"Away","Fitzroy","Collingwood",11
1943,1923-05-05,"R1","Fitzroy",11,13,79,"Carlton",8,8,56,"Brunswick St",23,1923,"Regular",1,"Home","Fitzroy","Carlton",23
1944,1923-05-05,"R1","Sydney",12,7,79,"Collingwood",16,5,101,"Lake Oval",-22,1923,"Regular",1,"Away","Collingwood","Sydney",22
1945,1923-05-05,"R1","Essendon",15,13,103,"St Kilda",8,12,60,"Windy Hill",43,1923,"Regular",1,"Home","Essendon","St Kilda",43
1946,1923-05-05,"R1","Melbourne",7,8,50,"Richmond",7,13,55,"M.C.G.",-5,1923,"Regular",1,"Away","Richmond","Melbourne",5
1947,1923-05-12,"R2","Carlton",8,8,56,"St Kilda",14,16,100,"Princes Park",-44,1923,"Regular",2,"Away","St Kilda","Carlton",44
1948,1923-05-12,"R2","Collingwood",9,11,65,"Essendon",12,7,79,"Victoria Park",-14,1923,"Regular",2,"Away","Essendon","Collingwood",14
1949,1923-05-12,"R2","Fitzroy",9,11,65,"Sydney",9,9,63,"Brunswick St",2,1923,"Regular",2,"Home","Fitzroy","Sydney",2
1950,1923-05-12,"R2","Geelong",5,22,52,"Melbourne",11,14,80,"Corio Oval",-28,1923,"Regular",2,"Away","Melbourne","Geelong",28
1951,1923-05-19,"R3","Richmond",7,10,52,"Carlton",8,12,60,"Punt Rd",-8,1923,"Regular",3,"Away","Carlton","Richmond",8
1952,1923-05-19,"R3","St Kilda",10,9,69,"Collingwood",6,12,48,"Junction Oval",21,1923,"Regular",3,"Home","St Kilda","Collingwood",21
1953,1923-05-19,"R3","Sydney",4,15,39,"Essendon",6,13,49,"Lake Oval",-10,1923,"Regular",3,"Away","Essendon","Sydney",10
1954,1923-05-19,"R3","Geelong",10,11,71,"Fitzroy",8,13,61,"Corio Oval",10,1923,"Regular",3,"Home","Geelong","Fitzroy",10
1955,1923-05-26,"R4","Carlton",9,11,65,"Essendon",14,19,103,"Princes Park",-38,1923,"Regular",4,"Away","Essendon","Carlton",38
1956,1923-05-26,"R4","Collingwood",16,23,119,"Geelong",10,12,72,"Victoria Park",47,1923,"Regular",4,"Home","Collingwood","Geelong",47
1957,1923-05-26,"R4","Melbourne",11,18,84,"Sydney",6,13,49,"M.C.G.",35,1923,"Regular",4,"Home","Melbourne","Sydney",35
1958,1923-05-26,"R4","Richmond",8,8,56,"St Kilda",8,13,61,"Punt Rd",-5,1923,"Regular",4,"Away","St Kilda","Richmond",5
1959,1923-06-02,"R5","Essendon",4,13,37,"Fitzroy",8,12,60,"Windy Hill",-23,1923,"Regular",5,"Away","Fitzroy","Essendon",23
1960,1923-06-02,"R5","St Kilda",8,15,63,"Melbourne",12,13,85,"Junction Oval",-22,1923,"Regular",5,"Away","Melbourne","St Kilda",22
1961,1923-06-04,"R5","Collingwood",11,16,82,"Richmond",5,14,44,"Victoria Park",38,1923,"Regular",5,"Home","Collingwood","Richmond",38
1962,1923-06-04,"R5","Sydney",13,11,89,"Geelong",10,15,75,"Lake Oval",14,1923,"Regular",5,"Home","Sydney","Geelong",14
1963,1923-06-09,"R6","Carlton",5,19,49,"Sydney",7,9,51,"Princes Park",-2,1923,"Regular",6,"Away","Sydney","Carlton",2
1964,1923-06-09,"R6","Richmond",9,11,65,"Essendon",12,15,87,"Punt Rd",-22,1923,"Regular",6,"Away","Essendon","Richmond",22
1965,1923-06-09,"R6","Fitzroy",11,11,77,"Melbourne",9,16,70,"Brunswick St",7,1923,"Regular",6,"Home","Fitzroy","Melbourne",7
1966,1923-06-09,"R6","Geelong",7,16,58,"St Kilda",6,10,46,"Corio Oval",12,1923,"Regular",6,"Home","Geelong","St Kilda",12
1967,1923-06-16,"R7","Collingwood",10,15,75,"Carlton",6,14,50,"Victoria Park",25,1923,"Regular",7,"Home","Collingwood","Carlton",25
1968,1923-06-16,"R7","Melbourne",8,12,60,"Essendon",11,8,74,"M.C.G.",-14,1923,"Regular",7,"Away","Essendon","Melbourne",14
1969,1923-06-16,"R7","St Kilda",4,14,38,"Fitzroy",9,20,74,"Junction Oval",-36,1923,"Regular",7,"Away","Fitzroy","St Kilda",36
1970,1923-06-16,"R7","Geelong",6,14,50,"Richmond",8,8,56,"Corio Oval",-6,1923,"Regular",7,"Away","Richmond","Geelong",6
1971,1923-06-23,"R8","Melbourne",9,11,65,"Carlton",11,8,74,"M.C.G.",-9,1923,"Regular",8,"Away","Carlton","Melbourne",9
1972,1923-06-23,"R8","Fitzroy",7,11,53,"Collingwood",7,5,47,"Brunswick St",6,1923,"Regular",8,"Home","Fitzroy","Collingwood",6
1973,1923-06-23,"R8","Essendon",14,13,97,"Geelong",8,6,54,"Windy Hill",43,1923,"Regular",8,"Home","Essendon","Geelong",43
1974,1923-06-23,"R8","Sydney",12,13,85,"Richmond",4,10,34,"Lake Oval",51,1923,"Regular",8,"Home","Sydney","Richmond",51
1975,1923-07-07,"R9","Carlton",13,10,88,"Geelong",13,15,93,"Princes Park",-5,1923,"Regular",9,"Away","Geelong","Carlton",5
1976,1923-07-07,"R9","Collingwood",11,10,76,"Melbourne",6,6,42,"Victoria Park",34,1923,"Regular",9,"Home","Collingwood","Melbourne",34
1977,1923-07-07,"R9","Richmond",6,15,51,"Fitzroy",10,10,70,"Punt Rd",-19,1923,"Regular",9,"Away","Fitzroy","Richmond",19
1978,1923-07-07,"R9","St Kilda",7,14,56,"Sydney",6,9,45,"Junction Oval",11,1923,"Regular",9,"Home","St Kilda","Sydney",11
1979,1923-07-14,"R10","Carlton",13,8,86,"Fitzroy",12,13,85,"Princes Park",1,1923,"Regular",10,"Home","Carlton","Fitzroy",1
1980,1923-07-14,"R10","Collingwood",8,8,56,"Sydney",11,11,77,"Victoria Park",-21,1923,"Regular",10,"Away","Sydney","Collingwood",21
1981,1923-07-14,"R10","St Kilda",5,5,35,"Essendon",1,12,18,"Junction Oval",17,1923,"Regular",10,"Home","St Kilda","Essendon",17
1982,1923-07-14,"R10","Richmond",11,17,83,"Melbourne",11,12,78,"Punt Rd",5,1923,"Regular",10,"Home","Richmond","Melbourne",5
1983,1923-07-21,"R11","St Kilda",7,14,56,"Carlton",6,11,47,"Junction Oval",9,1923,"Regular",11,"Home","St Kilda","Carlton",9
1984,1923-07-21,"R11","Essendon",13,13,91,"Collingwood",7,9,51,"Windy Hill",40,1923,"Regular",11,"Home","Essendon","Collingwood",40
1985,1923-07-21,"R11","Sydney",8,12,60,"Fitzroy",8,8,56,"Lake Oval",4,1923,"Regular",11,"Home","Sydney","Fitzroy",4
1986,1923-07-21,"R11","Melbourne",8,8,56,"Geelong",10,15,75,"M.C.G.",-19,1923,"Regular",11,"Away","Geelong","Melbourne",19
1987,1923-07-28,"R12","Carlton",8,11,59,"Richmond",5,10,40,"Princes Park",19,1923,"Regular",12,"Home","Carlton","Richmond",19
1988,1923-07-28,"R12","Collingwood",6,7,43,"St Kilda",4,7,31,"Victoria Park",12,1923,"Regular",12,"Home","Collingwood","St Kilda",12
1989,1923-07-28,"R12","Essendon",10,8,68,"Sydney",7,9,51,"Windy Hill",17,1923,"Regular",12,"Home","Essendon","Sydney",17
1990,1923-07-28,"R12","Fitzroy",6,11,47,"Geelong",7,10,52,"Brunswick St",-5,1923,"Regular",12,"Away","Geelong","Fitzroy",5
1991,1923-08-04,"R13","Essendon",15,13,103,"Carlton",5,7,37,"Windy Hill",66,1923,"Regular",13,"Home","Essendon","Carlton",66
1992,1923-08-04,"R13","Geelong",9,18,72,"Collingwood",3,8,26,"Corio Oval",46,1923,"Regular",13,"Home","Geelong","Collingwood",46
1993,1923-08-04,"R13","Sydney",9,13,67,"Melbourne",5,11,41,"Lake Oval",26,1923,"Regular",13,"Home","Sydney","Melbourne",26
1994,1923-08-04,"R13","St Kilda",8,12,60,"Richmond",3,7,25,"Junction Oval",35,1923,"Regular",13,"Home","St Kilda","Richmond",35
1995,1923-08-11,"R14","Richmond",11,10,76,"Collingwood",6,19,55,"Punt Rd",21,1923,"Regular",14,"Home","Richmond","Collingwood",21
1996,1923-08-11,"R14","Fitzroy",10,18,78,"Essendon",8,9,57,"Brunswick St",21,1923,"Regular",14,"Home","Fitzroy","Essendon",21
1997,1923-08-11,"R14","Geelong",8,15,63,"Sydney",10,10,70,"Corio Oval",-7,1923,"Regular",14,"Away","Sydney","Geelong",7
1998,1923-08-11,"R14","Melbourne",6,13,49,"St Kilda",11,18,84,"M.C.G.",-35,1923,"Regular",14,"Away","St Kilda","Melbourne",35
1999,1923-08-25,"R15","Sydney",10,8,68,"Carlton",13,11,89,"Lake Oval",-21,1923,"Regular",15,"Away","Carlton","Sydney",21
2000,1923-08-25,"R15","Essendon",9,8,62,"Richmond",8,6,54,"Windy Hill",8,1923,"Regular",15,"Home","Essendon","Richmond",8
2001,1923-08-25,"R15","Melbourne",7,4,46,"Fitzroy",11,14,80,"M.C.G.",-34,1923,"Regular",15,"Away","Fitzroy","Melbourne",34
2002,1923-08-25,"R15","St Kilda",9,17,71,"Geelong",13,9,87,"Junction Oval",-16,1923,"Regular",15,"Away","Geelong","St Kilda",16
2003,1923-09-01,"R16","Carlton",10,12,72,"Collingwood",10,12,72,"Princes Park",0,1923,"Regular",16,"Home","Carlton","Collingwood",0
2004,1923-09-01,"R16","Essendon",13,20,98,"Melbourne",6,5,41,"Windy Hill",57,1923,"Regular",16,"Home","Essendon","Melbourne",57
2005,1923-09-01,"R16","Fitzroy",13,19,97,"St Kilda",9,15,69,"Brunswick St",28,1923,"Regular",16,"Home","Fitzroy","St Kilda",28
2006,1923-09-01,"R16","Richmond",10,19,79,"Geelong",13,13,91,"Punt Rd",-12,1923,"Regular",16,"Away","Geelong","Richmond",12
2007,1923-09-08,"R17","Carlton",9,20,74,"Melbourne",7,4,46,"Princes Park",28,1923,"Regular",17,"Home","Carlton","Melbourne",28
2008,1923-09-08,"R17","Collingwood",12,12,84,"Fitzroy",6,13,49,"Victoria Park",35,1923,"Regular",17,"Home","Collingwood","Fitzroy",35
2009,1923-09-08,"R17","Geelong",9,6,60,"Essendon",8,14,62,"Corio Oval",-2,1923,"Regular",17,"Away","Essendon","Geelong",2
2010,1923-09-08,"R17","Richmond",8,7,55,"Sydney",14,16,100,"Punt Rd",-45,1923,"Regular",17,"Away","Sydney","Richmond",45
2011,1923-09-15,"R18","Geelong",15,13,103,"Carlton",4,14,38,"Corio Oval",65,1923,"Regular",18,"Home","Geelong","Carlton",65
2012,1923-09-15,"R18","Melbourne",11,21,87,"Collingwood",21,12,138,"M.C.G.",-51,1923,"Regular",18,"Away","Collingwood","Melbourne",51
2013,1923-09-15,"R18","Fitzroy",13,11,89,"Richmond",11,15,81,"Brunswick St",8,1923,"Regular",18,"Home","Fitzroy","Richmond",8
2014,1923-09-15,"R18","Sydney",8,20,68,"St Kilda",7,6,48,"Lake Oval",20,1923,"Regular",18,"Home","Sydney","St Kilda",20
2015,1923-09-22,"SF","Fitzroy",14,13,97,"Geelong",8,14,62,"M.C.G.",35,1923,"Finals",19,"Home","Fitzroy","Geelong",35
2016,1923-09-29,"SF","Essendon",8,9,57,"Sydney",10,14,74,"M.C.G.",-17,1923,"Finals",19,"Away","Sydney","Essendon",17
2017,1923-10-06,"PF","Fitzroy",7,13,55,"Sydney",6,7,43,"M.C.G.",12,1923,"Finals",20,"Home","Fitzroy","Sydney",12
2018,1923-10-20,"GF","Essendon",8,15,63,"Fitzroy",6,10,46,"M.C.G.",17,1923,"Finals",21,"Home","Essendon","Fitzroy",17
2019,1924-04-26,"R1","Fitzroy",16,9,105,"Carlton",15,13,103,"Brunswick St",2,1924,"Regular",1,"Home","Fitzroy","Carlton",2
2020,1924-04-26,"R1","Essendon",8,15,63,"Collingwood",12,7,79,"Windy Hill",-16,1924,"Regular",1,"Away","Collingwood","Essendon",16
2021,1924-04-26,"R1","St Kilda",12,12,84,"Melbourne",11,16,82,"Junction Oval",2,1924,"Regular",1,"Home","St Kilda","Melbourne",2
2022,1924-04-26,"R1","Richmond",10,7,67,"Sydney",13,16,94,"Punt Rd",-27,1924,"Regular",1,"Away","Sydney","Richmond",27
2023,1924-05-03,"R2","Carlton",7,14,56,"Essendon",7,14,56,"Princes Park",0,1924,"Regular",2,"Home","Carlton","Essendon",0
2024,1924-05-03,"R2","Collingwood",10,17,77,"St Kilda",7,15,57,"Victoria Park",20,1924,"Regular",2,"Home","Collingwood","St Kilda",20
2025,1924-05-03,"R2","Sydney",7,15,57,"Fitzroy",12,14,86,"Lake Oval",-29,1924,"Regular",2,"Away","Fitzroy","Sydney",29
2026,1924-05-03,"R2","Geelong",10,15,75,"Richmond",7,11,53,"Corio Oval",22,1924,"Regular",2,"Home","Geelong","Richmond",22
2027,1924-05-10,"R3","St Kilda",9,22,76,"Carlton",13,12,90,"Junction Oval",-14,1924,"Regular",3,"Away","Carlton","St Kilda",14
2028,1924-05-10,"R3","Melbourne",8,13,61,"Collingwood",8,14,62,"M.C.G.",-1,1924,"Regular",3,"Away","Collingwood","Melbourne",1
2029,1924-05-10,"R3","Essendon",12,13,85,"Sydney",8,11,59,"Windy Hill",26,1924,"Regular",3,"Home","Essendon","Sydney",26
2030,1924-05-10,"R3","Fitzroy",14,13,97,"Geelong",10,14,74,"Brunswick St",23,1924,"Regular",3,"Home","Fitzroy","Geelong",23
2031,1924-05-17,"R4","Carlton",11,10,76,"Melbourne",14,25,109,"Princes Park",-33,1924,"Regular",4,"Away","Melbourne","Carlton",33
2032,1924-05-17,"R4","Geelong",8,12,60,"Essendon",12,8,80,"Corio Oval",-20,1924,"Regular",4,"Away","Essendon","Geelong",20
2033,1924-05-17,"R4","Richmond",5,18,48,"Fitzroy",10,14,74,"Punt Rd",-26,1924,"Regular",4,"Away","Fitzroy","Richmond",26
2034,1924-05-17,"R4","Sydney",12,9,81,"St Kilda",7,11,53,"Lake Oval",28,1924,"Regular",4,"Home","Sydney","St Kilda",28
2035,1924-05-24,"R5","Collingwood",19,17,131,"Carlton",16,11,107,"Victoria Park",24,1924,"Regular",5,"Home","Collingwood","Carlton",24
2036,1924-05-24,"R5","Essendon",13,16,94,"Richmond",3,13,31,"Windy Hill",63,1924,"Regular",5,"Home","Essendon","Richmond",63
2037,1924-05-24,"R5","St Kilda",13,24,102,"Geelong",11,10,76,"Junction Oval",26,1924,"Regular",5,"Home","St Kilda","Geelong",26
2038,1924-05-24,"R5","Melbourne",10,16,76,"Sydney",10,9,69,"M.C.G.",7,1924,"Regular",5,"Home","Melbourne","Sydney",7
2039,1924-05-31,"R6","Sydney",9,15,69,"Collingwood",8,8,56,"Lake Oval",13,1924,"Regular",6,"Home","Sydney","Collingwood",13
2040,1924-05-31,"R6","Fitzroy",10,8,68,"Essendon",8,13,61,"Brunswick St",7,1924,"Regular",6,"Home","Fitzroy","Essendon",7
2041,1924-05-31,"R6","Geelong",9,19,73,"Melbourne",9,9,63,"Corio Oval",10,1924,"Regular",6,"Home","Geelong","Melbourne",10
2042,1924-05-31,"R6","Richmond",9,19,73,"St Kilda",8,6,54,"Punt Rd",19,1924,"Regular",6,"Home","Richmond","St Kilda",19
2043,1924-06-07,"R7","Carlton",10,12,72,"Sydney",11,12,78,"Princes Park",-6,1924,"Regular",7,"Away","Sydney","Carlton",6
2044,1924-06-07,"R7","Collingwood",10,16,76,"Geelong",11,16,82,"Victoria Park",-6,1924,"Regular",7,"Away","Geelong","Collingwood",6
2045,1924-06-09,"R7","St Kilda",12,13,85,"Fitzroy",14,9,93,"Junction Oval",-8,1924,"Regular",7,"Away","Fitzroy","St Kilda",8
2046,1924-06-09,"R7","Melbourne",11,17,83,"Richmond",13,9,87,"M.C.G.",-4,1924,"Regular",7,"Away","Richmond","Melbourne",4
2047,1924-06-14,"R8","Geelong",9,12,66,"Carlton",6,15,51,"Corio Oval",15,1924,"Regular",8,"Home","Geelong","Carlton",15
2048,1924-06-14,"R8","Richmond",12,23,95,"Collingwood",10,10,70,"Punt Rd",25,1924,"Regular",8,"Home","Richmond","Collingwood",25
2049,1924-06-14,"R8","Essendon",16,17,113,"St Kilda",3,13,31,"Windy Hill",82,1924,"Regular",8,"Home","Essendon","St Kilda",82
2050,1924-06-14,"R8","Fitzroy",12,15,87,"Melbourne",5,11,41,"Brunswick St",46,1924,"Regular",8,"Home","Fitzroy","Melbourne",46
2051,1924-06-21,"R9","Carlton",3,10,28,"Richmond",5,8,38,"Princes Park",-10,1924,"Regular",9,"Away","Richmond","Carlton",10
2052,1924-06-21,"R9","Collingwood",7,9,51,"Fitzroy",9,14,68,"Victoria Park",-17,1924,"Regular",9,"Away","Fitzroy","Collingwood",17
2053,1924-06-21,"R9","Melbourne",5,12,42,"Essendon",10,11,71,"M.C.G.",-29,1924,"Regular",9,"Away","Essendon","Melbourne",29
2054,1924-06-21,"R9","Sydney",7,6,48,"Geelong",7,3,45,"Lake Oval",3,1924,"Regular",9,"Home","Sydney","Geelong",3
2055,1924-06-28,"R10","Carlton",15,14,104,"Fitzroy",8,8,56,"Princes Park",48,1924,"Regular",10,"Home","Carlton","Fitzroy",48
2056,1924-06-28,"R10","Collingwood",4,10,34,"Essendon",8,12,60,"Victoria Park",-26,1924,"Regular",10,"Away","Essendon","Collingwood",26
2057,1924-06-28,"R10","Melbourne",8,15,63,"St Kilda",6,15,51,"M.C.G.",12,1924,"Regular",10,"Home","Melbourne","St Kilda",12
2058,1924-06-28,"R10","Sydney",9,7,61,"Richmond",5,13,43,"Lake Oval",18,1924,"Regular",10,"Home","Sydney","Richmond",18
2059,1924-07-05,"R11","Essendon",10,19,79,"Carlton",8,14,62,"Windy Hill",17,1924,"Regular",11,"Home","Essendon","Carlton",17
2060,1924-07-05,"R11","St Kilda",16,16,112,"Collingwood",6,16,52,"Junction Oval",60,1924,"Regular",11,"Home","St Kilda","Collingwood",60
2061,1924-07-05,"R11","Fitzroy",4,17,41,"Sydney",9,10,64,"Brunswick St",-23,1924,"Regular",11,"Away","Sydney","Fitzroy",23
2062,1924-07-05,"R11","Richmond",10,20,80,"Geelong",9,8,62,"Punt Rd",18,1924,"Regular",11,"Home","Richmond","Geelong",18
2063,1924-07-12,"R12","Carlton",14,15,99,"St Kilda",8,8,56,"Princes Park",43,1924,"Regular",12,"Home","Carlton","St Kilda",43
2064,1924-07-12,"R12","Collingwood",11,10,76,"Melbourne",7,11,53,"Victoria Park",23,1924,"Regular",12,"Home","Collingwood","Melbourne",23
2065,1924-07-12,"R12","Sydney",9,8,62,"Essendon",6,13,49,"Lake Oval",13,1924,"Regular",12,"Home","Sydney","Essendon",13
2066,1924-07-12,"R12","Geelong",9,14,68,"Fitzroy",9,11,65,"Corio Oval",3,1924,"Regular",12,"Home","Geelong","Fitzroy",3
2067,1924-07-19,"R13","Melbourne",7,13,55,"Carlton",9,8,62,"M.C.G.",-7,1924,"Regular",13,"Away","Carlton","Melbourne",7
2068,1924-07-19,"R13","Essendon",10,14,74,"Geelong",8,14,62,"Windy Hill",12,1924,"Regular",13,"Home","Essendon","Geelong",12
2069,1924-07-19,"R13","Fitzroy",7,12,54,"Richmond",8,16,64,"Brunswick St",-10,1924,"Regular",13,"Away","Richmond","Fitzroy",10
2070,1924-07-19,"R13","St Kilda",13,14,92,"Sydney",12,16,88,"Junction Oval",4,1924,"Regular",13,"Home","St Kilda","Sydney",4
2071,1924-07-26,"R14","Carlton",10,12,72,"Collingwood",12,12,84,"Princes Park",-12,1924,"Regular",14,"Away","Collingwood","Carlton",12
2072,1924-07-26,"R14","Richmond",7,14,56,"Essendon",12,13,85,"Punt Rd",-29,1924,"Regular",14,"Away","Essendon","Richmond",29
2073,1924-07-26,"R14","Geelong",18,15,123,"St Kilda",7,6,48,"Corio Oval",75,1924,"Regular",14,"Home","Geelong","St Kilda",75
2074,1924-07-26,"R14","Sydney",12,13,85,"Melbourne",5,8,38,"Lake Oval",47,1924,"Regular",14,"Home","Sydney","Melbourne",47
2075,1924-08-02,"R15","Collingwood",9,16,70,"Sydney",6,15,51,"Victoria Park",19,1924,"Regular",15,"Home","Collingwood","Sydney",19
2076,1924-08-02,"R15","Essendon",9,19,73,"Fitzroy",9,7,61,"Windy Hill",12,1924,"Regular",15,"Home","Essendon","Fitzroy",12
2077,1924-08-02,"R15","Melbourne",5,9,39,"Geelong",8,8,56,"M.C.G.",-17,1924,"Regular",15,"Away","Geelong","Melbourne",17
2078,1924-08-02,"R15","St Kilda",5,9,39,"Richmond",11,12,78,"Junction Oval",-39,1924,"Regular",15,"Away","Richmond","St Kilda",39
2079,1924-08-23,"R16","Sydney",13,19,97,"Carlton",4,7,31,"Lake Oval",66,1924,"Regular",16,"Home","Sydney","Carlton",66
2080,1924-08-23,"R16","Geelong",9,19,73,"Collingwood",5,6,36,"Corio Oval",37,1924,"Regular",16,"Home","Geelong","Collingwood",37
2081,1924-08-23,"R16","Fitzroy",16,13,109,"St Kilda",6,10,46,"Brunswick St",63,1924,"Regular",16,"Home","Fitzroy","St Kilda",63
2082,1924-08-23,"R16","Richmond",17,19,121,"Melbourne",9,21,75,"Punt Rd",46,1924,"Regular",16,"Home","Richmond","Melbourne",46
2083,1924-08-30,"R17","Carlton",9,7,61,"Geelong",6,18,54,"Princes Park",7,1924,"Regular",17,"Home","Carlton","Geelong",7
2084,1924-08-30,"R17","Collingwood",6,13,49,"Richmond",8,13,61,"Victoria Park",-12,1924,"Regular",17,"Away","Richmond","Collingwood",12
2085,1924-08-30,"R17","St Kilda",9,5,59,"Essendon",11,17,83,"Junction Oval",-24,1924,"Regular",17,"Away","Essendon","St Kilda",24
2086,1924-08-30,"R17","Melbourne",9,13,67,"Fitzroy",16,14,110,"M.C.G.",-43,1924,"Regular",17,"Away","Fitzroy","Melbourne",43
2087,1924-09-06,"R18","Richmond",12,16,88,"Carlton",8,12,60,"Punt Rd",28,1924,"Regular",18,"Home","Richmond","Carlton",28
2088,1924-09-06,"R18","Fitzroy",6,14,50,"Collingwood",11,20,86,"Brunswick St",-36,1924,"Regular",18,"Away","Collingwood","Fitzroy",36
2089,1924-09-06,"R18","Essendon",12,10,82,"Melbourne",14,12,96,"Windy Hill",-14,1924,"Regular",18,"Away","Melbourne","Essendon",14
2090,1924-09-06,"R18","Geelong",9,13,67,"Sydney",9,14,68,"Corio Oval",-1,1924,"Regular",18,"Away","Sydney","Geelong",1
2091,1924-09-13,"SF","Essendon",8,10,58,"Fitzroy",2,6,18,"M.C.G.",40,1924,"Finals",19,"Home","Essendon","Fitzroy",40
2092,1924-09-13,"SF","Sydney",9,3,57,"Richmond",13,7,85,"Windy Hill",-28,1924,"Finals",19,"Away","Richmond","Sydney",28
2093,1924-09-20,"SF","Essendon",10,12,72,"Sydney",4,15,39,"M.C.G.",33,1924,"Finals",19,"Home","Essendon","Sydney",33
2094,1924-09-20,"SF","Fitzroy",11,10,76,"Richmond",8,8,56,"Princes Park",20,1924,"Finals",19,"Home","Fitzroy","Richmond",20
2095,1924-09-27,"SF","Essendon",6,11,47,"Richmond",9,13,67,"Lake Oval",-20,1924,"Finals",19,"Away","Richmond","Essendon",20
2096,1924-09-27,"SF","Sydney",13,8,86,"Fitzroy",10,13,73,"M.C.G.",13,1924,"Finals",19,"Home","Sydney","Fitzroy",13
2097,1925-05-02,"R1","Sydney",9,14,68,"Carlton",4,6,30,"Lake Oval",38,1925,"Regular",1,"Home","Sydney","Carlton",38
2098,1925-05-02,"R1","Essendon",14,14,98,"Collingwood",10,13,73,"Windy Hill",25,1925,"Regular",1,"Home","Essendon","Collingwood",25
2099,1925-05-02,"R1","Fitzroy",8,15,63,"Footscray",8,6,54,"Brunswick St",9,1925,"Regular",1,"Home","Fitzroy","Footscray",9
2100,1925-05-02,"R1","Geelong",8,11,59,"North Melbourne",9,13,67,"Corio Oval",-8,1925,"Regular",1,"Away","North Melbourne","Geelong",8
2101,1925-05-02,"R1","Hawthorn",5,8,38,"Richmond",11,11,77,"Glenferrie Oval",-39,1925,"Regular",1,"Away","Richmond","Hawthorn",39
2102,1925-05-02,"R1","Melbourne",9,19,73,"St Kilda",3,8,26,"M.C.G.",47,1925,"Regular",1,"Home","Melbourne","St Kilda",47
2103,1925-05-09,"R2","Carlton",7,14,56,"Essendon",14,17,101,"Princes Park",-45,1925,"Regular",2,"Away","Essendon","Carlton",45
2104,1925-05-09,"R2","Collingwood",10,11,71,"Melbourne",7,12,54,"Victoria Park",17,1925,"Regular",2,"Home","Collingwood","Melbourne",17
2105,1925-05-09,"R2","North Melbourne",6,3,39,"Fitzroy",8,16,64,"Arden St",-25,1925,"Regular",2,"Away","Fitzroy","North Melbourne",25
2106,1925-05-09,"R2","Footscray",10,10,70,"Sydney",8,12,60,"Western Oval",10,1925,"Regular",2,"Home","Footscray","Sydney",10
2107,1925-05-09,"R2","Richmond",9,5,59,"Geelong",13,14,92,"Punt Rd",-33,1925,"Regular",2,"Away","Geelong","Richmond",33
2108,1925-05-09,"R2","St Kilda",17,12,114,"Hawthorn",8,12,60,"Junction Oval",54,1925,"Regular",2,"Home","St Kilda","Hawthorn",54
2109,1925-05-16,"R3","Melbourne",12,12,84,"Carlton",4,14,38,"M.C.G.",46,1925,"Regular",3,"Home","Melbourne","Carlton",46
2110,1925-05-16,"R3","Hawthorn",9,11,65,"Collingwood",11,16,82,"Glenferrie Oval",-17,1925,"Regular",3,"Away","Collingwood","Hawthorn",17
2111,1925-05-16,"R3","Essendon",16,15,111,"Footscray",9,9,63,"Windy Hill",48,1925,"Regular",3,"Home","Essendon","Footscray",48
2112,1925-05-16,"R3","Fitzroy",17,11,113,"Richmond",8,11,59,"Brunswick St",54,1925,"Regular",3,"Home","Fitzroy","Richmond",54
2113,1925-05-16,"R3","Geelong",9,8,62,"St Kilda",3,12,30,"Corio Oval",32,1925,"Regular",3,"Home","Geelong","St Kilda",32
2114,1925-05-16,"R3","Sydney",12,10,82,"North Melbourne",8,13,61,"Lake Oval",21,1925,"Regular",3,"Home","Sydney","North Melbourne",21
2115,1925-05-23,"R4","Carlton",10,10,70,"Hawthorn",6,13,49,"Princes Park",21,1925,"Regular",4,"Home","Carlton","Hawthorn",21
2116,1925-05-23,"R4","Collingwood",13,9,87,"Geelong",13,12,90,"Victoria Park",-3,1925,"Regular",4,"Away","Geelong","Collingwood",3
2117,1925-05-23,"R4","North Melbourne",5,17,47,"Essendon",13,10,88,"Arden St",-41,1925,"Regular",4,"Away","Essendon","North Melbourne",41
2118,1925-05-23,"R4","St Kilda",5,8,38,"Fitzroy",12,12,84,"Junction Oval",-46,1925,"Regular",4,"Away","Fitzroy","St Kilda",46
2119,1925-05-23,"R4","Footscray",6,6,42,"Melbourne",9,16,70,"Western Oval",-28,1925,"Regular",4,"Away","Melbourne","Footscray",28
2120,1925-05-23,"R4","Richmond",11,9,75,"Sydney",10,10,70,"Punt Rd",5,1925,"Regular",4,"Home","Richmond","Sydney",5
2121,1925-05-30,"R5","Geelong",22,12,144,"Carlton",10,12,72,"Corio Oval",72,1925,"Regular",5,"Home","Geelong","Carlton",72
2122,1925-05-30,"R5","Fitzroy",6,11,47,"Collingwood",7,10,52,"Brunswick St",-5,1925,"Regular",5,"Away","Collingwood","Fitzroy",5
2123,1925-05-30,"R5","Essendon",10,7,67,"Richmond",8,13,61,"Windy Hill",6,1925,"Regular",5,"Home","Essendon","Richmond",6
2124,1925-05-30,"R5","Hawthorn",10,14,74,"Footscray",8,10,58,"Glenferrie Oval",16,1925,"Regular",5,"Home","Hawthorn","Footscray",16
2125,1925-05-30,"R5","Melbourne",12,13,85,"North Melbourne",10,5,65,"M.C.G.",20,1925,"Regular",5,"Home","Melbourne","North Melbourne",20
2126,1925-05-30,"R5","Sydney",16,9,105,"St Kilda",10,13,73,"Lake Oval",32,1925,"Regular",5,"Home","Sydney","St Kilda",32
2127,1925-06-06,"R6","Footscray",9,8,62,"Geelong",12,11,83,"Western Oval",-21,1925,"Regular",6,"Away","Geelong","Footscray",21
2128,1925-06-06,"R6","North Melbourne",8,13,61,"Hawthorn",8,9,57,"Arden St",4,1925,"Regular",6,"Home","North Melbourne","Hawthorn",4
2129,1925-06-06,"R6","Richmond",9,16,70,"Melbourne",10,10,70,"Punt Rd",0,1925,"Regular",6,"Home","Richmond","Melbourne",0
2130,1925-06-08,"R6","Carlton",9,7,61,"Fitzroy",11,13,79,"Princes Park",-18,1925,"Regular",6,"Away","Fitzroy","Carlton",18
2131,1925-06-08,"R6","Collingwood",13,14,92,"Sydney",7,11,53,"Victoria Park",39,1925,"Regular",6,"Home","Collingwood","Sydney",39
2132,1925-06-08,"R6","St Kilda",13,14,92,"Essendon",8,12,60,"Junction Oval",32,1925,"Regular",6,"Home","St Kilda","Essendon",32
2133,1925-06-13,"R7","Carlton",9,12,66,"Richmond",5,13,43,"Princes Park",23,1925,"Regular",7,"Home","Carlton","Richmond",23
2134,1925-06-13,"R7","St Kilda",11,10,76,"Collingwood",5,10,40,"Junction Oval",36,1925,"Regular",7,"Home","St Kilda","Collingwood",36
2135,1925-06-13,"R7","Essendon",9,11,65,"Sydney",8,9,57,"Windy Hill",8,1925,"Regular",7,"Home","Essendon","Sydney",8
2136,1925-06-13,"R7","Melbourne",12,11,83,"Fitzroy",6,9,45,"M.C.G.",38,1925,"Regular",7,"Home","Melbourne","Fitzroy",38
2137,1925-06-13,"R7","Footscray",7,12,54,"North Melbourne",11,12,78,"Western Oval",-24,1925,"Regular",7,"Away","North Melbourne","Footscray",24
2138,1925-06-13,"R7","Geelong",15,11,101,"Hawthorn",7,7,49,"Corio Oval",52,1925,"Regular",7,"Home","Geelong","Hawthorn",52
2139,1925-06-20,"R8","Collingwood",11,12,78,"Carlton",9,10,64,"Victoria Park",14,1925,"Regular",8,"Home","Collingwood","Carlton",14
2140,1925-06-20,"R8","Hawthorn",9,7,61,"Essendon",10,14,74,"Glenferrie Oval",-13,1925,"Regular",8,"Away","Essendon","Hawthorn",13
2141,1925-06-20,"R8","Fitzroy",7,15,57,"Geelong",9,15,69,"Brunswick St",-12,1925,"Regular",8,"Away","Geelong","Fitzroy",12
2142,1925-06-20,"R8","Richmond",9,21,75,"Footscray",12,9,81,"Punt Rd",-6,1925,"Regular",8,"Away","Footscray","Richmond",6
2143,1925-06-20,"R8","Sydney",7,12,54,"Melbourne",14,16,100,"Lake Oval",-46,1925,"Regular",8,"Away","Melbourne","Sydney",46
2144,1925-06-20,"R8","North Melbourne",9,9,63,"St Kilda",10,8,68,"Arden St",-5,1925,"Regular",8,"Away","St Kilda","North Melbourne",5
2145,1925-06-27,"R9","Carlton",14,11,95,"North Melbourne",10,7,67,"Princes Park",28,1925,"Regular",9,"Home","Carlton","North Melbourne",28
2146,1925-06-27,"R9","Collingwood",11,14,80,"Richmond",8,12,60,"Victoria Park",20,1925,"Regular",9,"Home","Collingwood","Richmond",20
2147,1925-06-27,"R9","Essendon",9,7,61,"Fitzroy",8,9,57,"Windy Hill",4,1925,"Regular",9,"Home","Essendon","Fitzroy",4
2148,1925-06-27,"R9","St Kilda",18,24,132,"Footscray",13,6,84,"Junction Oval",48,1925,"Regular",9,"Home","St Kilda","Footscray",48
2149,1925-06-27,"R9","Geelong",15,9,99,"Melbourne",10,15,75,"Corio Oval",24,1925,"Regular",9,"Home","Geelong","Melbourne",24
2150,1925-06-27,"R9","Sydney",15,14,104,"Hawthorn",5,7,37,"Lake Oval",67,1925,"Regular",9,"Home","Sydney","Hawthorn",67
2151,1925-07-11,"R10","St Kilda",8,17,65,"Carlton",5,10,40,"Junction Oval",25,1925,"Regular",10,"Home","St Kilda","Carlton",25
2152,1925-07-11,"R10","Footscray",9,8,62,"Collingwood",15,16,106,"Western Oval",-44,1925,"Regular",10,"Away","Collingwood","Footscray",44
2153,1925-07-11,"R10","Melbourne",8,7,55,"Essendon",5,8,38,"M.C.G.",17,1925,"Regular",10,"Home","Melbourne","Essendon",17
2154,1925-07-11,"R10","Fitzroy",19,11,125,"Hawthorn",5,11,41,"Brunswick St",84,1925,"Regular",10,"Home","Fitzroy","Hawthorn",84
2155,1925-07-11,"R10","Geelong",18,13,121,"Sydney",3,10,28,"Corio Oval",93,1925,"Regular",10,"Home","Geelong","Sydney",93
2156,1925-07-11,"R10","North Melbourne",7,9,51,"Richmond",10,9,69,"Arden St",-18,1925,"Regular",10,"Away","Richmond","North Melbourne",18
2157,1925-07-18,"R11","Carlton",9,12,66,"Footscray",7,11,53,"Princes Park",13,1925,"Regular",11,"Home","Carlton","Footscray",13
2158,1925-07-18,"R11","Collingwood",16,17,113,"North Melbourne",11,4,70,"Victoria Park",43,1925,"Regular",11,"Home","Collingwood","North Melbourne",43
2159,1925-07-18,"R11","Essendon",9,11,65,"Geelong",11,10,76,"Windy Hill",-11,1925,"Regular",11,"Away","Geelong","Essendon",11
2160,1925-07-18,"R11","Sydney",6,11,47,"Fitzroy",12,12,84,"Lake Oval",-37,1925,"Regular",11,"Away","Fitzroy","Sydney",37
2161,1925-07-18,"R11","Hawthorn",6,10,46,"Melbourne",14,18,102,"Glenferrie Oval",-56,1925,"Regular",11,"Away","Melbourne","Hawthorn",56
2162,1925-07-18,"R11","Richmond",8,14,62,"St Kilda",6,9,45,"Punt Rd",17,1925,"Regular",11,"Home","Richmond","St Kilda",17
2163,1925-08-01,"R12","Carlton",9,9,63,"Sydney",9,20,74,"Princes Park",-11,1925,"Regular",12,"Away","Sydney","Carlton",11
2164,1925-08-01,"R12","Collingwood",15,19,109,"Essendon",4,5,29,"Victoria Park",80,1925,"Regular",12,"Home","Collingwood","Essendon",80
2165,1925-08-01,"R12","Footscray",13,13,91,"Fitzroy",7,8,50,"Western Oval",41,1925,"Regular",12,"Home","Footscray","Fitzroy",41
2166,1925-08-01,"R12","North Melbourne",9,5,59,"Geelong",22,22,154,"Arden St",-95,1925,"Regular",12,"Away","Geelong","North Melbourne",95
2167,1925-08-01,"R12","Richmond",6,11,47,"Hawthorn",3,11,29,"Punt Rd",18,1925,"Regular",12,"Home","Richmond","Hawthorn",18
2168,1925-08-01,"R12","St Kilda",7,9,51,"Melbourne",10,10,70,"Junction Oval",-19,1925,"Regular",12,"Away","Melbourne","St Kilda",19
2169,1925-08-08,"R13","Essendon",15,11,101,"Carlton",8,14,62,"Windy Hill",39,1925,"Regular",13,"Home","Essendon","Carlton",39
2170,1925-08-08,"R13","Melbourne",7,10,52,"Collingwood",9,11,65,"M.C.G.",-13,1925,"Regular",13,"Away","Collingwood","Melbourne",13
2171,1925-08-08,"R13","Fitzroy",17,18,120,"North Melbourne",11,8,74,"Brunswick St",46,1925,"Regular",13,"Home","Fitzroy","North Melbourne",46
2172,1925-08-08,"R13","Sydney",13,14,92,"Footscray",12,15,87,"Lake Oval",5,1925,"Regular",13,"Home","Sydney","Footscray",5
2173,1925-08-08,"R13","Geelong",11,20,86,"Richmond",4,8,32,"Corio Oval",54,1925,"Regular",13,"Home","Geelong","Richmond",54
2174,1925-08-08,"R13","Hawthorn",8,11,59,"St Kilda",8,8,56,"Glenferrie Oval",3,1925,"Regular",13,"Home","Hawthorn","St Kilda",3
2175,1925-08-22,"R14","Carlton",6,9,45,"Melbourne",18,14,122,"Princes Park",-77,1925,"Regular",14,"Away","Melbourne","Carlton",77
2176,1925-08-22,"R14","Collingwood",11,18,84,"Hawthorn",8,12,60,"Victoria Park",24,1925,"Regular",14,"Home","Collingwood","Hawthorn",24
2177,1925-08-22,"R14","Footscray",5,13,43,"Essendon",9,15,69,"Western Oval",-26,1925,"Regular",14,"Away","Essendon","Footscray",26
2178,1925-08-22,"R14","Richmond",8,7,55,"Fitzroy",9,7,61,"Punt Rd",-6,1925,"Regular",14,"Away","Fitzroy","Richmond",6
2179,1925-08-22,"R14","St Kilda",9,8,62,"Geelong",7,9,51,"Junction Oval",11,1925,"Regular",14,"Home","St Kilda","Geelong",11
2180,1925-08-22,"R14","North Melbourne",12,8,80,"Sydney",7,16,58,"Arden St",22,1925,"Regular",14,"Home","North Melbourne","Sydney",22
2181,1925-08-29,"R15","Hawthorn",7,10,52,"Carlton",11,14,80,"Glenferrie Oval",-28,1925,"Regular",15,"Away","Carlton","Hawthorn",28
2182,1925-08-29,"R15","Geelong",11,8,74,"Collingwood",8,17,65,"Corio Oval",9,1925,"Regular",15,"Home","Geelong","Collingwood",9
2183,1925-08-29,"R15","Essendon",14,19,103,"North Melbourne",6,9,45,"Windy Hill",58,1925,"Regular",15,"Home","Essendon","North Melbourne",58
2184,1925-08-29,"R15","Fitzroy",11,12,78,"St Kilda",8,7,55,"Brunswick St",23,1925,"Regular",15,"Home","Fitzroy","St Kilda",23
2185,1925-08-29,"R15","Melbourne",10,9,69,"Footscray",9,13,67,"M.C.G.",2,1925,"Regular",15,"Home","Melbourne","Footscray",2
2186,1925-08-29,"R15","Sydney",6,9,45,"Richmond",9,9,63,"Lake Oval",-18,1925,"Regular",15,"Away","Richmond","Sydney",18
2187,1925-09-05,"R16","Carlton",14,10,94,"Geelong",15,13,103,"Princes Park",-9,1925,"Regular",16,"Away","Geelong","Carlton",9
2188,1925-09-05,"R16","Collingwood",12,13,85,"Fitzroy",14,15,99,"Victoria Park",-14,1925,"Regular",16,"Away","Fitzroy","Collingwood",14
2189,1925-09-05,"R16","Richmond",7,8,50,"Essendon",10,14,74,"Punt Rd",-24,1925,"Regular",16,"Away","Essendon","Richmond",24
2190,1925-09-05,"R16","Footscray",15,10,100,"Hawthorn",10,10,70,"Western Oval",30,1925,"Regular",16,"Home","Footscray","Hawthorn",30
2191,1925-09-05,"R16","North Melbourne",11,7,73,"Melbourne",6,10,46,"Arden St",27,1925,"Regular",16,"Home","North Melbourne","Melbourne",27
2192,1925-09-05,"R16","St Kilda",11,9,75,"Sydney",9,8,62,"Junction Oval",13,1925,"Regular",16,"Home","St Kilda","Sydney",13
2193,1925-09-12,"R17","Fitzroy",7,24,66,"Carlton",9,10,64,"Brunswick St",2,1925,"Regular",17,"Home","Fitzroy","Carlton",2
2194,1925-09-12,"R17","Sydney",4,6,30,"Collingwood",14,11,95,"Lake Oval",-65,1925,"Regular",17,"Away","Collingwood","Sydney",65
2195,1925-09-12,"R17","Essendon",10,7,67,"St Kilda",8,10,58,"Windy Hill",9,1925,"Regular",17,"Home","Essendon","St Kilda",9
2196,1925-09-12,"R17","Geelong",14,16,100,"Footscray",9,7,61,"Corio Oval",39,1925,"Regular",17,"Home","Geelong","Footscray",39
2197,1925-09-12,"R17","Hawthorn",7,13,55,"North Melbourne",4,6,30,"Glenferrie Oval",25,1925,"Regular",17,"Home","Hawthorn","North Melbourne",25
2198,1925-09-12,"R17","Melbourne",9,9,63,"Richmond",2,12,24,"M.C.G.",39,1925,"Regular",17,"Home","Melbourne","Richmond",39
2199,1925-09-19,"SF","Essendon",10,8,68,"Collingwood",12,6,78,"M.C.G.",-10,1925,"Finals",18,"Away","Collingwood","Essendon",10
2200,1925-09-26,"SF","Geelong",13,8,86,"Melbourne",14,17,101,"M.C.G.",-15,1925,"Finals",18,"Away","Melbourne","Geelong",15
2201,1925-10-03,"PF","Melbourne",3,8,26,"Collingwood",8,15,63,"M.C.G.",-37,1925,"Finals",19,"Away","Collingwood","Melbourne",37
2202,1925-10-10,"GF","Geelong",10,19,79,"Collingwood",9,15,69,"M.C.G.",10,1925,"Finals",20,"Home","Geelong","Collingwood",10
2203,1926-05-01,"R1","Hawthorn",6,14,50,"Carlton",9,16,70,"Glenferrie Oval",-20,1926,"Regular",1,"Away","Carlton","Hawthorn",20
2204,1926-05-01,"R1","Fitzroy",7,13,55,"Collingwood",14,10,94,"Brunswick St",-39,1926,"Regular",1,"Away","Collingwood","Fitzroy",39
2205,1926-05-01,"R1","Essendon",15,14,104,"North Melbourne",6,17,53,"Windy Hill",51,1926,"Regular",1,"Home","Essendon","North Melbourne",51
2206,1926-05-01,"R1","Geelong",13,15,93,"Footscray",3,9,27,"Corio Oval",66,1926,"Regular",1,"Home","Geelong","Footscray",66
2207,1926-05-01,"R1","Melbourne",13,14,92,"St Kilda",8,15,63,"M.C.G.",29,1926,"Regular",1,"Home","Melbourne","St Kilda",29
2208,1926-05-01,"R1","Sydney",11,11,77,"Richmond",12,13,85,"Lake Oval",-8,1926,"Regular",1,"Away","Richmond","Sydney",8
2209,1926-05-08,"R2","Carlton",9,15,69,"Melbourne",8,10,58,"Princes Park",11,1926,"Regular",2,"Home","Carlton","Melbourne",11
2210,1926-05-08,"R2","Collingwood",6,11,47,"Essendon",10,18,78,"Victoria Park",-31,1926,"Regular",2,"Away","Essendon","Collingwood",31
2211,1926-05-08,"R2","Richmond",18,8,116,"Fitzroy",8,10,58,"Punt Rd",58,1926,"Regular",2,"Home","Richmond","Fitzroy",58
2212,1926-05-08,"R2","Footscray",8,9,57,"Sydney",13,12,90,"Western Oval",-33,1926,"Regular",2,"Away","Sydney","Footscray",33
2213,1926-05-08,"R2","St Kilda",15,15,105,"Geelong",16,14,110,"Junction Oval",-5,1926,"Regular",2,"Away","Geelong","St Kilda",5
2214,1926-05-08,"R2","North Melbourne",5,8,38,"Hawthorn",5,12,42,"Arden St",-4,1926,"Regular",2,"Away","Hawthorn","North Melbourne",4
2215,1926-05-15,"R3","Geelong",9,10,64,"Carlton",8,12,60,"Corio Oval",4,1926,"Regular",3,"Home","Geelong","Carlton",4
2216,1926-05-15,"R3","Hawthorn",6,11,47,"Collingwood",17,17,119,"Glenferrie Oval",-72,1926,"Regular",3,"Away","Collingwood","Hawthorn",72
2217,1926-05-15,"R3","Essendon",10,9,69,"Richmond",8,13,61,"Windy Hill",8,1926,"Regular",3,"Home","Essendon","Richmond",8
2218,1926-05-15,"R3","Fitzroy",11,13,79,"Footscray",11,12,78,"Brunswick St",1,1926,"Regular",3,"Home","Fitzroy","Footscray",1
2219,1926-05-15,"R3","Melbourne",17,17,119,"North Melbourne",14,5,89,"M.C.G.",30,1926,"Regular",3,"Home","Melbourne","North Melbourne",30
2220,1926-05-15,"R3","Sydney",6,11,47,"St Kilda",6,14,50,"Lake Oval",-3,1926,"Regular",3,"Away","St Kilda","Sydney",3
2221,1926-05-22,"R4","Carlton",10,11,71,"Sydney",9,12,66,"Princes Park",5,1926,"Regular",4,"Home","Carlton","Sydney",5
2222,1926-05-22,"R4","Collingwood",12,12,84,"Melbourne",12,7,79,"Victoria Park",5,1926,"Regular",4,"Home","Collingwood","Melbourne",5
2223,1926-05-22,"R4","Footscray",7,5,47,"Essendon",6,13,49,"Western Oval",-2,1926,"Regular",4,"Away","Essendon","Footscray",2
2224,1926-05-22,"R4","St Kilda",9,8,62,"Fitzroy",7,9,51,"Junction Oval",11,1926,"Regular",4,"Home","St Kilda","Fitzroy",11
2225,1926-05-22,"R4","North Melbourne",7,8,50,"Geelong",7,16,58,"Arden St",-8,1926,"Regular",4,"Away","Geelong","North Melbourne",8
2226,1926-05-22,"R4","Richmond",16,16,112,"Hawthorn",14,16,100,"Punt Rd",12,1926,"Regular",4,"Home","Richmond","Hawthorn",12
2227,1926-05-29,"R5","Fitzroy",7,16,58,"Carlton",7,6,48,"Brunswick St",10,1926,"Regular",5,"Home","Fitzroy","Carlton",10
2228,1926-05-29,"R5","Geelong",9,14,68,"Collingwood",10,15,75,"Corio Oval",-7,1926,"Regular",5,"Away","Collingwood","Geelong",7
2229,1926-05-29,"R5","Essendon",13,7,85,"St Kilda",5,8,38,"Windy Hill",47,1926,"Regular",5,"Home","Essendon","St Kilda",47
2230,1926-05-29,"R5","Hawthorn",9,13,67,"Footscray",14,16,100,"Glenferrie Oval",-33,1926,"Regular",5,"Away","Footscray","Hawthorn",33
2231,1926-05-29,"R5","Melbourne",19,8,122,"Richmond",12,17,89,"M.C.G.",33,1926,"Regular",5,"Home","Melbourne","Richmond",33
2232,1926-05-29,"R5","Sydney",10,15,75,"North Melbourne",11,7,73,"Lake Oval",2,1926,"Regular",5,"Home","Sydney","North Melbourne",2
2233,1926-06-05,"R6","Carlton",10,13,73,"Essendon",6,15,51,"Princes Park",22,1926,"Regular",6,"Home","Carlton","Essendon",22
2234,1926-06-05,"R6","Collingwood",12,16,88,"Sydney",8,11,59,"Victoria Park",29,1926,"Regular",6,"Home","Collingwood","Sydney",29
2235,1926-06-05,"R6","North Melbourne",11,11,77,"Fitzroy",11,15,81,"Arden St",-4,1926,"Regular",6,"Away","Fitzroy","North Melbourne",4
2236,1926-06-05,"R6","Footscray",6,10,46,"Melbourne",15,15,105,"Western Oval",-59,1926,"Regular",6,"Away","Melbourne","Footscray",59
2237,1926-06-05,"R6","Richmond",10,13,73,"Geelong",12,11,83,"Punt Rd",-10,1926,"Regular",6,"Away","Geelong","Richmond",10
2238,1926-06-05,"R6","St Kilda",12,7,79,"Hawthorn",6,14,50,"Junction Oval",29,1926,"Regular",6,"Home","St Kilda","Hawthorn",29
2239,1926-06-07,"R7","Footscray",10,11,71,"Carlton",14,9,93,"Western Oval",-22,1926,"Regular",7,"Away","Carlton","Footscray",22
2240,1926-06-07,"R7","St Kilda",9,12,66,"Collingwood",10,16,76,"Junction Oval",-10,1926,"Regular",7,"Away","Collingwood","St Kilda",10
2241,1926-06-07,"R7","Geelong",13,11,89,"Essendon",7,9,51,"Corio Oval",38,1926,"Regular",7,"Home","Geelong","Essendon",38
2242,1926-06-07,"R7","Fitzroy",11,15,81,"Hawthorn",14,12,96,"Brunswick St",-15,1926,"Regular",7,"Away","Hawthorn","Fitzroy",15
2243,1926-06-07,"R7","Melbourne",12,16,88,"Sydney",8,17,65,"M.C.G.",23,1926,"Regular",7,"Home","Melbourne","Sydney",23
2244,1926-06-07,"R7","North Melbourne",10,13,73,"Richmond",10,14,74,"Arden St",-1,1926,"Regular",7,"Away","Richmond","North Melbourne",1
2245,1926-06-19,"R8","Carlton",17,7,109,"North Melbourne",7,10,52,"Princes Park",57,1926,"Regular",8,"Home","Carlton","North Melbourne",57
2246,1926-06-19,"R8","Collingwood",28,16,184,"Footscray",8,10,58,"Victoria Park",126,1926,"Regular",8,"Home","Collingwood","Footscray",126
2247,1926-06-19,"R8","Essendon",10,9,69,"Melbourne",11,9,75,"Windy Hill",-6,1926,"Regular",8,"Away","Melbourne","Essendon",6
2248,1926-06-19,"R8","Sydney",13,15,93,"Fitzroy",9,5,59,"Lake Oval",34,1926,"Regular",8,"Home","Sydney","Fitzroy",34
2249,1926-06-19,"R8","Hawthorn",10,12,72,"Geelong",18,10,118,"Glenferrie Oval",-46,1926,"Regular",8,"Away","Geelong","Hawthorn",46
2250,1926-06-19,"R8","Richmond",11,19,85,"St Kilda",9,12,66,"Punt Rd",19,1926,"Regular",8,"Home","Richmond","St Kilda",19
2251,1926-06-26,"R9","Carlton",10,10,70,"Collingwood",6,13,49,"Princes Park",21,1926,"Regular",9,"Home","Carlton","Collingwood",21
2252,1926-06-26,"R9","Sydney",9,15,69,"Essendon",8,9,57,"Lake Oval",12,1926,"Regular",9,"Home","Sydney","Essendon",12
2253,1926-06-26,"R9","Fitzroy",10,9,69,"Geelong",12,12,84,"Brunswick St",-15,1926,"Regular",9,"Away","Geelong","Fitzroy",15
2254,1926-06-26,"R9","Footscray",8,8,56,"Richmond",9,13,67,"Western Oval",-11,1926,"Regular",9,"Away","Richmond","Footscray",11
2255,1926-06-26,"R9","Melbourne",21,28,154,"Hawthorn",1,7,13,"M.C.G.",141,1926,"Regular",9,"Home","Melbourne","Hawthorn",141
2256,1926-06-26,"R9","North Melbourne",4,9,33,"St Kilda",5,17,47,"Arden St",-14,1926,"Regular",9,"Away","St Kilda","North Melbourne",14
2257,1926-07-03,"R10","Richmond",7,17,59,"Carlton",8,6,54,"Punt Rd",5,1926,"Regular",10,"Home","Richmond","Carlton",5
2258,1926-07-03,"R10","North Melbourne",8,5,53,"Collingwood",10,16,76,"Arden St",-23,1926,"Regular",10,"Away","Collingwood","North Melbourne",23
2259,1926-07-03,"R10","Fitzroy",6,13,49,"Essendon",11,12,78,"Brunswick St",-29,1926,"Regular",10,"Away","Essendon","Fitzroy",29
2260,1926-07-03,"R10","St Kilda",7,17,59,"Footscray",10,7,67,"Junction Oval",-8,1926,"Regular",10,"Away","Footscray","St Kilda",8
2261,1926-07-03,"R10","Geelong",8,19,67,"Melbourne",8,5,53,"Corio Oval",14,1926,"Regular",10,"Home","Geelong","Melbourne",14
2262,1926-07-03,"R10","Hawthorn",8,10,58,"Sydney",11,16,82,"Glenferrie Oval",-24,1926,"Regular",10,"Away","Sydney","Hawthorn",24
2263,1926-07-10,"R11","Carlton",11,14,80,"St Kilda",9,9,63,"Princes Park",17,1926,"Regular",11,"Home","Carlton","St Kilda",17
2264,1926-07-10,"R11","Collingwood",14,15,99,"Richmond",5,11,41,"Victoria Park",58,1926,"Regular",11,"Home","Collingwood","Richmond",58
2265,1926-07-10,"R11","Essendon",11,8,74,"Hawthorn",7,5,47,"Windy Hill",27,1926,"Regular",11,"Home","Essendon","Hawthorn",27
2266,1926-07-10,"R11","Melbourne",14,15,99,"Fitzroy",8,12,60,"M.C.G.",39,1926,"Regular",11,"Home","Melbourne","Fitzroy",39
2267,1926-07-10,"R11","Footscray",14,9,93,"North Melbourne",10,8,68,"Western Oval",25,1926,"Regular",11,"Home","Footscray","North Melbourne",25
2268,1926-07-10,"R11","Sydney",9,13,67,"Geelong",8,8,56,"Lake Oval",11,1926,"Regular",11,"Home","Sydney","Geelong",11
2269,1926-07-17,"R12","Carlton",8,17,65,"Hawthorn",8,9,57,"Princes Park",8,1926,"Regular",12,"Home","Carlton","Hawthorn",8
2270,1926-07-17,"R12","Collingwood",18,16,124,"Fitzroy",11,16,82,"Victoria Park",42,1926,"Regular",12,"Home","Collingwood","Fitzroy",42
2271,1926-07-17,"R12","North Melbourne",4,8,32,"Essendon",6,14,50,"Arden St",-18,1926,"Regular",12,"Away","Essendon","North Melbourne",18
2272,1926-07-17,"R12","Footscray",7,14,56,"Geelong",15,17,107,"Western Oval",-51,1926,"Regular",12,"Away","Geelong","Footscray",51
2273,1926-07-17,"R12","St Kilda",3,11,29,"Melbourne",17,16,118,"Junction Oval",-89,1926,"Regular",12,"Away","Melbourne","St Kilda",89
2274,1926-07-17,"R12","Richmond",10,15,75,"Sydney",16,12,108,"Punt Rd",-33,1926,"Regular",12,"Away","Sydney","Richmond",33
2275,1926-08-07,"R13","Melbourne",12,18,90,"Carlton",8,10,58,"M.C.G.",32,1926,"Regular",13,"Home","Melbourne","Carlton",32
2276,1926-08-07,"R13","Essendon",6,10,46,"Collingwood",10,9,69,"Windy Hill",-23,1926,"Regular",13,"Away","Collingwood","Essendon",23
2277,1926-08-07,"R13","Fitzroy",10,17,77,"Richmond",12,20,92,"Brunswick St",-15,1926,"Regular",13,"Away","Richmond","Fitzroy",15
2278,1926-08-07,"R13","Sydney",15,17,107,"Footscray",6,12,48,"Lake Oval",59,1926,"Regular",13,"Home","Sydney","Footscray",59
2279,1926-08-07,"R13","Geelong",12,18,90,"St Kilda",5,8,38,"Corio Oval",52,1926,"Regular",13,"Home","Geelong","St Kilda",52
2280,1926-08-07,"R13","Hawthorn",10,10,70,"North Melbourne",10,10,70,"Glenferrie Oval",0,1926,"Regular",13,"Home","Hawthorn","North Melbourne",0
2281,1926-08-14,"R14","Carlton",12,10,82,"Geelong",10,15,75,"Princes Park",7,1926,"Regular",14,"Home","Carlton","Geelong",7
2282,1926-08-14,"R14","Collingwood",16,8,104,"Hawthorn",3,10,28,"Victoria Park",76,1926,"Regular",14,"Home","Collingwood","Hawthorn",76
2283,1926-08-14,"R14","Richmond",8,14,62,"Essendon",10,7,67,"Punt Rd",-5,1926,"Regular",14,"Away","Essendon","Richmond",5
2284,1926-08-14,"R14","Footscray",8,15,63,"Fitzroy",14,21,105,"Western Oval",-42,1926,"Regular",14,"Away","Fitzroy","Footscray",42
2285,1926-08-14,"R14","North Melbourne",10,7,67,"Melbourne",9,16,70,"Arden St",-3,1926,"Regular",14,"Away","Melbourne","North Melbourne",3
2286,1926-08-14,"R14","St Kilda",7,11,53,"Sydney",10,21,81,"Junction Oval",-28,1926,"Regular",14,"Away","Sydney","St Kilda",28
2287,1926-08-21,"R15","Sydney",12,13,85,"Carlton",9,8,62,"Lake Oval",23,1926,"Regular",15,"Home","Sydney","Carlton",23
2288,1926-08-21,"R15","Melbourne",6,7,43,"Collingwood",13,15,93,"M.C.G.",-50,1926,"Regular",15,"Away","Collingwood","Melbourne",50
2289,1926-08-21,"R15","Essendon",18,15,123,"Footscray",9,9,63,"Windy Hill",60,1926,"Regular",15,"Home","Essendon","Footscray",60
2290,1926-08-21,"R15","Fitzroy",18,18,126,"St Kilda",9,10,64,"Brunswick St",62,1926,"Regular",15,"Home","Fitzroy","St Kilda",62
2291,1926-08-21,"R15","Geelong",15,22,112,"North Melbourne",7,6,48,"Corio Oval",64,1926,"Regular",15,"Home","Geelong","North Melbourne",64
2292,1926-08-21,"R15","Hawthorn",10,9,69,"Richmond",14,18,102,"Glenferrie Oval",-33,1926,"Regular",15,"Away","Richmond","Hawthorn",33
2293,1926-08-28,"R16","Carlton",18,18,126,"Fitzroy",15,14,104,"Princes Park",22,1926,"Regular",16,"Home","Carlton","Fitzroy",22
2294,1926-08-28,"R16","Collingwood",8,16,64,"Geelong",14,13,97,"Victoria Park",-33,1926,"Regular",16,"Away","Geelong","Collingwood",33
2295,1926-08-28,"R16","St Kilda",2,11,23,"Essendon",14,11,95,"Junction Oval",-72,1926,"Regular",16,"Away","Essendon","St Kilda",72
2296,1926-08-28,"R16","Footscray",9,19,73,"Hawthorn",11,14,80,"Western Oval",-7,1926,"Regular",16,"Away","Hawthorn","Footscray",7
2297,1926-08-28,"R16","Richmond",10,8,68,"Melbourne",13,16,94,"Punt Rd",-26,1926,"Regular",16,"Away","Melbourne","Richmond",26
2298,1926-08-28,"R16","North Melbourne",9,16,70,"Sydney",15,16,106,"Arden St",-36,1926,"Regular",16,"Away","Sydney","North Melbourne",36
2299,1926-09-04,"R17","Essendon",13,8,86,"Carlton",11,11,77,"Windy Hill",9,1926,"Regular",17,"Home","Essendon","Carlton",9
2300,1926-09-04,"R17","Sydney",8,9,57,"Collingwood",9,9,63,"Lake Oval",-6,1926,"Regular",17,"Away","Collingwood","Sydney",6
2301,1926-09-04,"R17","Fitzroy",17,18,120,"North Melbourne",13,7,85,"Brunswick St",35,1926,"Regular",17,"Home","Fitzroy","North Melbourne",35
2302,1926-09-04,"R17","Melbourne",20,20,140,"Footscray",9,14,68,"M.C.G.",72,1926,"Regular",17,"Home","Melbourne","Footscray",72
2303,1926-09-04,"R17","Geelong",19,16,130,"Richmond",8,18,66,"Corio Oval",64,1926,"Regular",17,"Home","Geelong","Richmond",64
2304,1926-09-04,"R17","Hawthorn",10,10,70,"St Kilda",12,14,86,"Glenferrie Oval",-16,1926,"Regular",17,"Away","St Kilda","Hawthorn",16
2305,1926-09-11,"R18","Collingwood",12,24,96,"Carlton",7,5,47,"Victoria Park",49,1926,"Regular",18,"Home","Collingwood","Carlton",49
2306,1926-09-11,"R18","Essendon",9,17,71,"Sydney",10,14,74,"Windy Hill",-3,1926,"Regular",18,"Away","Sydney","Essendon",3
2307,1926-09-11,"R18","Geelong",15,14,104,"Fitzroy",6,13,49,"Corio Oval",55,1926,"Regular",18,"Home","Geelong","Fitzroy",55
2308,1926-09-11,"R18","Richmond",6,13,49,"Footscray",13,15,93,"Punt Rd",-44,1926,"Regular",18,"Away","Footscray","Richmond",44
2309,1926-09-11,"R18","Hawthorn",11,12,78,"Melbourne",18,13,121,"Glenferrie Oval",-43,1926,"Regular",18,"Away","Melbourne","Hawthorn",43
2310,1926-09-11,"R18","St Kilda",13,12,90,"North Melbourne",11,5,71,"Junction Oval",19,1926,"Regular",18,"Home","St Kilda","North Melbourne",19
2311,1926-09-18,"SF","Geelong",10,10,70,"Essendon",17,15,117,"M.C.G.",-47,1926,"Finals",19,"Away","Essendon","Geelong",47
2312,1926-09-25,"SF","Collingwood",12,12,84,"Melbourne",13,17,95,"M.C.G.",-11,1926,"Finals",19,"Away","Melbourne","Collingwood",11
2313,1926-10-02,"PF","Melbourne",6,6,42,"Essendon",5,9,39,"M.C.G.",3,1926,"Finals",20,"Home","Melbourne","Essendon",3
2314,1926-10-09,"GF","Collingwood",9,8,62,"Melbourne",17,17,119,"M.C.G.",-57,1926,"Finals",21,"Away","Melbourne","Collingwood",57
2315,1927-04-30,"R1","Carlton",9,15,69,"Sydney",10,10,70,"Princes Park",-1,1927,"Regular",1,"Away","Sydney","Carlton",1
2316,1927-04-30,"R1","Collingwood",16,11,107,"Geelong",12,12,84,"Victoria Park",23,1927,"Regular",1,"Home","Collingwood","Geelong",23
2317,1927-04-30,"R1","Footscray",10,3,63,"Essendon",16,14,110,"Western Oval",-47,1927,"Regular",1,"Away","Essendon","Footscray",47
2318,1927-04-30,"R1","North Melbourne",9,21,75,"Fitzroy",10,11,71,"Arden St",4,1927,"Regular",1,"Home","North Melbourne","Fitzroy",4
2319,1927-04-30,"R1","St Kilda",12,16,88,"Hawthorn",11,2,68,"Junction Oval",20,1927,"Regular",1,"Home","St Kilda","Hawthorn",20
2320,1927-04-30,"R1","Melbourne",16,19,115,"Richmond",9,11,65,"M.C.G.",50,1927,"Regular",1,"Home","Melbourne","Richmond",50
2321,1927-05-07,"R2","Fitzroy",11,6,72,"Carlton",14,15,99,"Brunswick St",-27,1927,"Regular",2,"Away","Carlton","Fitzroy",27
2322,1927-05-07,"R2","Hawthorn",7,9,51,"Collingwood",11,11,77,"Glenferrie Oval",-26,1927,"Regular",2,"Away","Collingwood","Hawthorn",26
2323,1927-05-07,"R2","Essendon",8,6,54,"North Melbourne",10,5,65,"Windy Hill",-11,1927,"Regular",2,"Away","North Melbourne","Essendon",11
2324,1927-05-07,"R2","Geelong",14,20,104,"Footscray",8,12,60,"Corio Oval",44,1927,"Regular",2,"Home","Geelong","Footscray",44
2325,1927-05-07,"R2","Sydney",12,11,83,"Melbourne",7,11,53,"Lake Oval",30,1927,"Regular",2,"Home","Sydney","Melbourne",30
2326,1927-05-07,"R2","Richmond",8,11,59,"St Kilda",6,12,48,"Punt Rd",11,1927,"Regular",2,"Home","Richmond","St Kilda",11
2327,1927-05-14,"R3","Carlton",7,5,47,"Essendon",4,12,36,"Princes Park",11,1927,"Regular",3,"Home","Carlton","Essendon",11
2328,1927-05-14,"R3","Collingwood",6,13,49,"Richmond",7,13,55,"Victoria Park",-6,1927,"Regular",3,"Away","Richmond","Collingwood",6
2329,1927-05-14,"R3","Melbourne",13,15,93,"Fitzroy",8,11,59,"M.C.G.",34,1927,"Regular",3,"Home","Melbourne","Fitzroy",34
2330,1927-05-14,"R3","Footscray",10,18,78,"Hawthorn",7,10,52,"Western Oval",26,1927,"Regular",3,"Home","Footscray","Hawthorn",26
2331,1927-05-14,"R3","North Melbourne",8,5,53,"Geelong",7,13,55,"Arden St",-2,1927,"Regular",3,"Away","Geelong","North Melbourne",2
2332,1927-05-14,"R3","St Kilda",8,15,63,"Sydney",7,13,55,"Junction Oval",8,1927,"Regular",3,"Home","St Kilda","Sydney",8
2333,1927-05-21,"R4","Geelong",18,15,123,"Carlton",11,11,77,"Corio Oval",46,1927,"Regular",4,"Home","Geelong","Carlton",46
2334,1927-05-21,"R4","Sydney",9,13,67,"Collingwood",16,10,106,"Lake Oval",-39,1927,"Regular",4,"Away","Collingwood","Sydney",39
2335,1927-05-21,"R4","Essendon",8,12,60,"Melbourne",11,12,78,"Windy Hill",-18,1927,"Regular",4,"Away","Melbourne","Essendon",18
2336,1927-05-21,"R4","Fitzroy",13,14,92,"St Kilda",11,9,75,"Brunswick St",17,1927,"Regular",4,"Home","Fitzroy","St Kilda",17
2337,1927-05-21,"R4","Richmond",13,22,100,"Footscray",3,12,30,"Punt Rd",70,1927,"Regular",4,"Home","Richmond","Footscray",70
2338,1927-05-21,"R4","Hawthorn",8,8,56,"North Melbourne",20,13,133,"Glenferrie Oval",-77,1927,"Regular",4,"Away","North Melbourne","Hawthorn",77
2339,1927-05-28,"R5","Carlton",14,12,96,"Hawthorn",6,16,52,"Princes Park",44,1927,"Regular",5,"Home","Carlton","Hawthorn",44
2340,1927-05-28,"R5","Collingwood",18,15,123,"Fitzroy",9,5,59,"Victoria Park",64,1927,"Regular",5,"Home","Collingwood","Fitzroy",64
2341,1927-05-28,"R5","St Kilda",14,7,91,"Essendon",12,10,82,"Junction Oval",9,1927,"Regular",5,"Home","St Kilda","Essendon",9
2342,1927-05-28,"R5","Footscray",7,13,55,"Sydney",6,13,49,"Western Oval",6,1927,"Regular",5,"Home","Footscray","Sydney",6
2343,1927-05-28,"R5","Melbourne",7,16,58,"Geelong",12,13,85,"M.C.G.",-27,1927,"Regular",5,"Away","Geelong","Melbourne",27
2344,1927-05-28,"R5","North Melbourne",5,8,38,"Richmond",12,11,83,"Arden St",-45,1927,"Regular",5,"Away","Richmond","North Melbourne",45
2345,1927-06-04,"R6","Essendon",7,7,49,"Collingwood",7,14,56,"Windy Hill",-7,1927,"Regular",6,"Away","Collingwood","Essendon",7
2346,1927-06-04,"R6","Geelong",12,17,89,"St Kilda",11,4,70,"Corio Oval",19,1927,"Regular",6,"Home","Geelong","St Kilda",19
2347,1927-06-04,"R6","Hawthorn",12,8,80,"Melbourne",17,10,112,"Glenferrie Oval",-32,1927,"Regular",6,"Away","Melbourne","Hawthorn",32
2348,1927-06-06,"R6","Richmond",12,18,90,"Carlton",17,8,110,"Punt Rd",-20,1927,"Regular",6,"Away","Carlton","Richmond",20
2349,1927-06-06,"R6","Fitzroy",8,13,61,"Footscray",13,13,91,"Brunswick St",-30,1927,"Regular",6,"Away","Footscray","Fitzroy",30
2350,1927-06-06,"R6","Sydney",14,13,97,"North Melbourne",9,9,63,"Lake Oval",34,1927,"Regular",6,"Home","Sydney","North Melbourne",34
2351,1927-06-11,"R7","Carlton",10,6,66,"Footscray",6,12,48,"Princes Park",18,1927,"Regular",7,"Home","Carlton","Footscray",18
2352,1927-06-11,"R7","Collingwood",25,19,169,"St Kilda",7,15,57,"Victoria Park",112,1927,"Regular",7,"Home","Collingwood","St Kilda",112
2353,1927-06-11,"R7","Essendon",9,10,64,"Geelong",11,11,77,"Windy Hill",-13,1927,"Regular",7,"Away","Geelong","Essendon",13
2354,1927-06-11,"R7","Hawthorn",11,11,77,"Fitzroy",15,13,103,"Glenferrie Oval",-26,1927,"Regular",7,"Away","Fitzroy","Hawthorn",26
2355,1927-06-11,"R7","Melbourne",15,21,111,"North Melbourne",3,9,27,"M.C.G.",84,1927,"Regular",7,"Home","Melbourne","North Melbourne",84
2356,1927-06-11,"R7","Sydney",10,11,71,"Richmond",15,17,107,"Lake Oval",-36,1927,"Regular",7,"Away","Richmond","Sydney",36
2357,1927-06-18,"R8","North Melbourne",4,11,35,"Carlton",9,15,69,"Arden St",-34,1927,"Regular",8,"Away","Carlton","North Melbourne",34
2358,1927-06-18,"R8","Footscray",4,12,36,"Collingwood",7,16,58,"Western Oval",-22,1927,"Regular",8,"Away","Collingwood","Footscray",22
2359,1927-06-18,"R8","Richmond",15,12,102,"Essendon",11,13,79,"Punt Rd",23,1927,"Regular",8,"Home","Richmond","Essendon",23
2360,1927-06-18,"R8","Fitzroy",14,11,95,"Sydney",11,14,80,"Brunswick St",15,1927,"Regular",8,"Home","Fitzroy","Sydney",15
2361,1927-06-18,"R8","Geelong",22,23,155,"Hawthorn",8,8,56,"Corio Oval",99,1927,"Regular",8,"Home","Geelong","Hawthorn",99
2362,1927-06-18,"R8","St Kilda",8,7,55,"Melbourne",15,15,105,"Junction Oval",-50,1927,"Regular",8,"Away","Melbourne","St Kilda",50
2363,1927-06-25,"R9","Collingwood",13,5,83,"Carlton",14,11,95,"Victoria Park",-12,1927,"Regular",9,"Away","Carlton","Collingwood",12
2364,1927-06-25,"R9","Essendon",12,12,84,"Sydney",15,9,99,"Windy Hill",-15,1927,"Regular",9,"Away","Sydney","Essendon",15
2365,1927-06-25,"R9","Geelong",12,15,87,"Fitzroy",12,8,80,"Corio Oval",7,1927,"Regular",9,"Home","Geelong","Fitzroy",7
2366,1927-06-25,"R9","Melbourne",10,13,73,"Footscray",7,9,51,"M.C.G.",22,1927,"Regular",9,"Home","Melbourne","Footscray",22
2367,1927-06-25,"R9","Hawthorn",9,6,60,"Richmond",9,20,74,"Glenferrie Oval",-14,1927,"Regular",9,"Away","Richmond","Hawthorn",14
2368,1927-06-25,"R9","St Kilda",15,7,97,"North Melbourne",13,10,88,"Junction Oval",9,1927,"Regular",9,"Home","St Kilda","North Melbourne",9
2369,1927-07-02,"R10","Carlton",8,7,55,"Melbourne",10,10,70,"Princes Park",-15,1927,"Regular",10,"Away","Melbourne","Carlton",15
2370,1927-07-02,"R10","Collingwood",8,11,59,"North Melbourne",3,11,29,"Victoria Park",30,1927,"Regular",10,"Home","Collingwood","North Melbourne",30
2371,1927-07-02,"R10","Essendon",6,12,48,"Fitzroy",7,6,48,"Windy Hill",0,1927,"Regular",10,"Home","Essendon","Fitzroy",0
2372,1927-07-02,"R10","Footscray",3,12,30,"St Kilda",5,13,43,"Western Oval",-13,1927,"Regular",10,"Away","St Kilda","Footscray",13
2373,1927-07-02,"R10","Richmond",9,15,69,"Geelong",7,11,53,"Punt Rd",16,1927,"Regular",10,"Home","Richmond","Geelong",16
2374,1927-07-02,"R10","Sydney",13,19,97,"Hawthorn",5,11,41,"Lake Oval",56,1927,"Regular",10,"Home","Sydney","Hawthorn",56
2375,1927-07-09,"R11","St Kilda",6,8,44,"Carlton",21,9,135,"Junction Oval",-91,1927,"Regular",11,"Away","Carlton","St Kilda",91
2376,1927-07-09,"R11","Melbourne",10,12,72,"Collingwood",11,13,79,"M.C.G.",-7,1927,"Regular",11,"Away","Collingwood","Melbourne",7
2377,1927-07-09,"R11","Hawthorn",9,17,71,"Essendon",11,12,78,"Glenferrie Oval",-7,1927,"Regular",11,"Away","Essendon","Hawthorn",7
2378,1927-07-09,"R11","Fitzroy",8,7,55,"Richmond",17,9,111,"Brunswick St",-56,1927,"Regular",11,"Away","Richmond","Fitzroy",56
2379,1927-07-09,"R11","North Melbourne",9,18,72,"Footscray",15,10,100,"Arden St",-28,1927,"Regular",11,"Away","Footscray","North Melbourne",28
2380,1927-07-09,"R11","Geelong",10,12,72,"Sydney",9,12,66,"Corio Oval",6,1927,"Regular",11,"Home","Geelong","Sydney",6
2381,1927-07-16,"R12","Sydney",12,8,80,"Carlton",8,21,69,"Lake Oval",11,1927,"Regular",12,"Home","Sydney","Carlton",11
2382,1927-07-16,"R12","Geelong",7,7,49,"Collingwood",9,11,65,"Corio Oval",-16,1927,"Regular",12,"Away","Collingwood","Geelong",16
2383,1927-07-16,"R12","Essendon",12,19,91,"Footscray",8,9,57,"Windy Hill",34,1927,"Regular",12,"Home","Essendon","Footscray",34
2384,1927-07-16,"R12","Fitzroy",14,5,89,"North Melbourne",10,14,74,"Brunswick St",15,1927,"Regular",12,"Home","Fitzroy","North Melbourne",15
2385,1927-07-16,"R12","Hawthorn",7,12,54,"St Kilda",8,11,59,"Glenferrie Oval",-5,1927,"Regular",12,"Away","St Kilda","Hawthorn",5
2386,1927-07-16,"R12","Richmond",10,15,75,"Melbourne",6,8,44,"Punt Rd",31,1927,"Regular",12,"Home","Richmond","Melbourne",31
2387,1927-07-23,"R13","Carlton",11,10,76,"Fitzroy",9,16,70,"Princes Park",6,1927,"Regular",13,"Home","Carlton","Fitzroy",6
2388,1927-07-23,"R13","Collingwood",18,13,121,"Hawthorn",6,11,47,"Victoria Park",74,1927,"Regular",13,"Home","Collingwood","Hawthorn",74
2389,1927-07-23,"R13","North Melbourne",7,8,50,"Essendon",7,12,54,"Arden St",-4,1927,"Regular",13,"Away","Essendon","North Melbourne",4
2390,1927-07-23,"R13","Footscray",9,6,60,"Geelong",10,19,79,"Western Oval",-19,1927,"Regular",13,"Away","Geelong","Footscray",19
2391,1927-07-23,"R13","Melbourne",20,20,140,"Sydney",11,5,71,"M.C.G.",69,1927,"Regular",13,"Home","Melbourne","Sydney",69
2392,1927-07-23,"R13","St Kilda",9,17,71,"Richmond",16,14,110,"Junction Oval",-39,1927,"Regular",13,"Away","Richmond","St Kilda",39
2393,1927-07-30,"R14","Essendon",8,15,63,"Carlton",10,11,71,"Windy Hill",-8,1927,"Regular",14,"Away","Carlton","Essendon",8
2394,1927-07-30,"R14","Richmond",9,7,61,"Collingwood",12,12,84,"Punt Rd",-23,1927,"Regular",14,"Away","Collingwood","Richmond",23
2395,1927-07-30,"R14","Fitzroy",13,11,89,"Melbourne",11,11,77,"Brunswick St",12,1927,"Regular",14,"Home","Fitzroy","Melbourne",12
2396,1927-07-30,"R14","Hawthorn",8,19,67,"Footscray",11,19,85,"Glenferrie Oval",-18,1927,"Regular",14,"Away","Footscray","Hawthorn",18
2397,1927-07-30,"R14","Geelong",17,21,123,"North Melbourne",3,11,29,"Corio Oval",94,1927,"Regular",14,"Home","Geelong","North Melbourne",94
2398,1927-07-30,"R14","Sydney",13,20,98,"St Kilda",8,9,57,"Lake Oval",41,1927,"Regular",14,"Home","Sydney","St Kilda",41
2399,1927-08-06,"R15","Carlton",10,6,66,"Geelong",13,20,98,"Princes Park",-32,1927,"Regular",15,"Away","Geelong","Carlton",32
2400,1927-08-06,"R15","Collingwood",18,14,122,"Sydney",6,7,43,"Victoria Park",79,1927,"Regular",15,"Home","Collingwood","Sydney",79
2401,1927-08-06,"R15","Melbourne",20,20,140,"Essendon",8,2,50,"M.C.G.",90,1927,"Regular",15,"Home","Melbourne","Essendon",90
2402,1927-08-06,"R15","St Kilda",13,11,89,"Fitzroy",11,16,82,"Junction Oval",7,1927,"Regular",15,"Home","St Kilda","Fitzroy",7
2403,1927-08-06,"R15","Footscray",7,8,50,"Richmond",11,15,81,"Western Oval",-31,1927,"Regular",15,"Away","Richmond","Footscray",31
2404,1927-08-06,"R15","North Melbourne",11,10,76,"Hawthorn",15,9,99,"Arden St",-23,1927,"Regular",15,"Away","Hawthorn","North Melbourne",23
2405,1927-08-27,"R16","Hawthorn",10,10,70,"Carlton",14,14,98,"Glenferrie Oval",-28,1927,"Regular",16,"Away","Carlton","Hawthorn",28
2406,1927-08-27,"R16","Fitzroy",14,11,95,"Collingwood",13,10,88,"Brunswick St",7,1927,"Regular",16,"Home","Fitzroy","Collingwood",7
2407,1927-08-27,"R16","Essendon",9,18,72,"St Kilda",7,6,48,"Windy Hill",24,1927,"Regular",16,"Home","Essendon","St Kilda",24
2408,1927-08-27,"R16","Sydney",9,20,74,"Footscray",10,10,70,"Lake Oval",4,1927,"Regular",16,"Home","Sydney","Footscray",4
2409,1927-08-27,"R16","Geelong",13,8,86,"Melbourne",9,7,61,"Corio Oval",25,1927,"Regular",16,"Home","Geelong","Melbourne",25
2410,1927-08-27,"R16","Richmond",14,15,99,"North Melbourne",9,8,62,"Punt Rd",37,1927,"Regular",16,"Home","Richmond","North Melbourne",37
2411,1927-09-03,"R17","Carlton",4,6,30,"Richmond",3,5,23,"Princes Park",7,1927,"Regular",17,"Home","Carlton","Richmond",7
2412,1927-09-03,"R17","Collingwood",3,13,31,"Essendon",4,6,30,"Victoria Park",1,1927,"Regular",17,"Home","Collingwood","Essendon",1
2413,1927-09-03,"R17","Footscray",15,11,101,"Fitzroy",9,18,72,"Western Oval",29,1927,"Regular",17,"Home","Footscray","Fitzroy",29
2414,1927-09-03,"R17","St Kilda",9,18,72,"Geelong",8,22,70,"Junction Oval",2,1927,"Regular",17,"Home","St Kilda","Geelong",2
2415,1927-09-03,"R17","Melbourne",10,13,73,"Hawthorn",3,15,33,"M.C.G.",40,1927,"Regular",17,"Home","Melbourne","Hawthorn",40
2416,1927-09-03,"R17","North Melbourne",8,12,60,"Sydney",11,12,78,"Arden St",-18,1927,"Regular",17,"Away","Sydney","North Melbourne",18
2417,1927-09-10,"R18","Carlton",15,16,106,"St Kilda",7,9,51,"Princes Park",55,1927,"Regular",18,"Home","Carlton","St Kilda",55
2418,1927-09-10,"R18","North Melbourne",7,14,56,"Collingwood",11,16,82,"Arden St",-26,1927,"Regular",18,"Away","Collingwood","North Melbourne",26
2419,1927-09-10,"R18","Fitzroy",5,13,43,"Essendon",14,10,94,"Brunswick St",-51,1927,"Regular",18,"Away","Essendon","Fitzroy",51
2420,1927-09-10,"R18","Footscray",10,6,66,"Melbourne",10,13,73,"Western Oval",-7,1927,"Regular",18,"Away","Melbourne","Footscray",7
2421,1927-09-10,"R18","Sydney",14,11,95,"Geelong",15,15,105,"Lake Oval",-10,1927,"Regular",18,"Away","Geelong","Sydney",10
2422,1927-09-10,"R18","Richmond",16,23,119,"Hawthorn",6,17,53,"Punt Rd",66,1927,"Regular",18,"Home","Richmond","Hawthorn",66
2423,1927-09-17,"SF","Richmond",12,10,82,"Carlton",11,10,76,"M.C.G.",6,1927,"Finals",19,"Home","Richmond","Carlton",6
2424,1927-09-24,"SF","Collingwood",16,18,114,"Geelong",7,6,48,"M.C.G.",66,1927,"Finals",19,"Home","Collingwood","Geelong",66
2425,1927-10-01,"GF","Collingwood",2,13,25,"Richmond",1,7,13,"M.C.G.",12,1927,"Finals",20,"Home","Collingwood","Richmond",12
2426,1928-04-21,"R1","Fitzroy",11,13,79,"Carlton",18,9,117,"Brunswick St",-38,1928,"Regular",1,"Away","Carlton","Fitzroy",38
2427,1928-04-21,"R1","Geelong",8,12,60,"Collingwood",9,12,66,"Corio Oval",-6,1928,"Regular",1,"Away","Collingwood","Geelong",6
2428,1928-04-21,"R1","Essendon",11,6,72,"Melbourne",13,7,85,"Windy Hill",-13,1928,"Regular",1,"Away","Melbourne","Essendon",13
2429,1928-04-21,"R1","Sydney",14,16,100,"Footscray",15,9,99,"Lake Oval",1,1928,"Regular",1,"Home","Sydney","Footscray",1
2430,1928-04-21,"R1","Hawthorn",9,13,67,"St Kilda",10,10,70,"Glenferrie Oval",-3,1928,"Regular",1,"Away","St Kilda","Hawthorn",3
2431,1928-04-21,"R1","Richmond",14,15,99,"North Melbourne",2,9,21,"Punt Rd",78,1928,"Regular",1,"Home","Richmond","North Melbourne",78
2432,1928-04-28,"R2","Carlton",13,9,87,"Richmond",10,6,66,"Princes Park",21,1928,"Regular",2,"Home","Carlton","Richmond",21
2433,1928-04-28,"R2","Collingwood",14,18,102,"Fitzroy",9,13,67,"Victoria Park",35,1928,"Regular",2,"Home","Collingwood","Fitzroy",35
2434,1928-04-28,"R2","Footscray",10,9,69,"Essendon",10,13,73,"Western Oval",-4,1928,"Regular",2,"Away","Essendon","Footscray",4
2435,1928-04-28,"R2","Melbourne",6,11,47,"Geelong",4,16,40,"M.C.G.",7,1928,"Regular",2,"Home","Melbourne","Geelong",7
2436,1928-04-28,"R2","North Melbourne",10,16,76,"Hawthorn",8,13,61,"Arden St",15,1928,"Regular",2,"Home","North Melbourne","Hawthorn",15
2437,1928-04-28,"R2","St Kilda",14,12,96,"Sydney",17,15,117,"Junction Oval",-21,1928,"Regular",2,"Away","Sydney","St Kilda",21
2438,1928-05-05,"R3","Hawthorn",7,17,59,"Carlton",14,9,93,"Glenferrie Oval",-34,1928,"Regular",3,"Away","Carlton","Hawthorn",34
2439,1928-05-05,"R3","Richmond",5,14,44,"Collingwood",5,12,42,"Punt Rd",2,1928,"Regular",3,"Home","Richmond","Collingwood",2
2440,1928-05-05,"R3","Essendon",12,13,85,"Sydney",5,11,41,"Windy Hill",44,1928,"Regular",3,"Home","Essendon","Sydney",44
2441,1928-05-05,"R3","Fitzroy",12,12,84,"Melbourne",17,16,118,"Brunswick St",-34,1928,"Regular",3,"Away","Melbourne","Fitzroy",34
2442,1928-05-05,"R3","Geelong",10,17,77,"Footscray",12,9,81,"Corio Oval",-4,1928,"Regular",3,"Away","Footscray","Geelong",4
2443,1928-05-05,"R3","St Kilda",11,11,77,"North Melbourne",10,15,75,"Junction Oval",2,1928,"Regular",3,"Home","St Kilda","North Melbourne",2
2444,1928-05-12,"R4","Carlton",16,24,120,"St Kilda",3,6,24,"Princes Park",96,1928,"Regular",4,"Home","Carlton","St Kilda",96
2445,1928-05-12,"R4","Collingwood",15,22,112,"Hawthorn",5,9,39,"Victoria Park",73,1928,"Regular",4,"Home","Collingwood","Hawthorn",73
2446,1928-05-12,"R4","Essendon",6,11,47,"Geelong",6,14,50,"Windy Hill",-3,1928,"Regular",4,"Away","Geelong","Essendon",3
2447,1928-05-12,"R4","Footscray",11,11,77,"Fitzroy",10,4,64,"Western Oval",13,1928,"Regular",4,"Home","Footscray","Fitzroy",13
2448,1928-05-12,"R4","Melbourne",7,13,55,"Richmond",6,15,51,"M.C.G.",4,1928,"Regular",4,"Home","Melbourne","Richmond",4
2449,1928-05-12,"R4","Sydney",10,9,69,"North Melbourne",10,10,70,"Lake Oval",-1,1928,"Regular",4,"Away","North Melbourne","Sydney",1
2450,1928-05-19,"R5","North Melbourne",11,15,81,"Carlton",9,11,65,"Arden St",16,1928,"Regular",5,"Home","North Melbourne","Carlton",16
2451,1928-05-19,"R5","St Kilda",11,8,74,"Collingwood",15,12,102,"Junction Oval",-28,1928,"Regular",5,"Away","Collingwood","St Kilda",28
2452,1928-05-19,"R5","Fitzroy",11,18,84,"Essendon",13,17,95,"Brunswick St",-11,1928,"Regular",5,"Away","Essendon","Fitzroy",11
2453,1928-05-19,"R5","Richmond",13,22,100,"Footscray",12,14,86,"Punt Rd",14,1928,"Regular",5,"Home","Richmond","Footscray",14
2454,1928-05-19,"R5","Geelong",15,15,105,"Sydney",11,15,81,"Corio Oval",24,1928,"Regular",5,"Home","Geelong","Sydney",24
2455,1928-05-19,"R5","Hawthorn",14,17,101,"Melbourne",16,14,110,"Glenferrie Oval",-9,1928,"Regular",5,"Away","Melbourne","Hawthorn",9
2456,1928-05-26,"R6","Sydney",12,10,82,"Carlton",12,13,85,"Lake Oval",-3,1928,"Regular",6,"Away","Carlton","Sydney",3
2457,1928-05-26,"R6","Collingwood",12,12,84,"North Melbourne",6,9,45,"Victoria Park",39,1928,"Regular",6,"Home","Collingwood","North Melbourne",39
2458,1928-05-26,"R6","Essendon",10,8,68,"Richmond",7,19,61,"Windy Hill",7,1928,"Regular",6,"Home","Essendon","Richmond",7
2459,1928-05-26,"R6","Geelong",19,8,122,"Fitzroy",2,27,39,"Corio Oval",83,1928,"Regular",6,"Home","Geelong","Fitzroy",83
2460,1928-05-26,"R6","Footscray",17,19,121,"Hawthorn",7,3,45,"Western Oval",76,1928,"Regular",6,"Home","Footscray","Hawthorn",76
2461,1928-05-26,"R6","Melbourne",13,8,86,"St Kilda",11,8,74,"M.C.G.",12,1928,"Regular",6,"Home","Melbourne","St Kilda",12
2462,1928-06-02,"R7","Carlton",12,12,84,"Collingwood",13,9,87,"Princes Park",-3,1928,"Regular",7,"Away","Collingwood","Carlton",3
2463,1928-06-02,"R7","Hawthorn",7,15,57,"Essendon",13,20,98,"Glenferrie Oval",-41,1928,"Regular",7,"Away","Essendon","Hawthorn",41
2464,1928-06-02,"R7","Fitzroy",17,11,113,"Sydney",11,11,77,"Brunswick St",36,1928,"Regular",7,"Home","Fitzroy","Sydney",36
2465,1928-06-02,"R7","St Kilda",9,17,71,"Footscray",11,6,72,"Junction Oval",-1,1928,"Regular",7,"Away","Footscray","St Kilda",1
2466,1928-06-02,"R7","Richmond",12,21,93,"Geelong",13,12,90,"Punt Rd",3,1928,"Regular",7,"Home","Richmond","Geelong",3
2467,1928-06-02,"R7","North Melbourne",5,7,37,"Melbourne",14,16,100,"Arden St",-63,1928,"Regular",7,"Away","Melbourne","North Melbourne",63
2468,1928-06-04,"R8","Melbourne",10,14,74,"Carlton",9,10,64,"M.C.G.",10,1928,"Regular",8,"Home","Melbourne","Carlton",10
2469,1928-06-04,"R8","Sydney",9,14,68,"Collingwood",13,7,85,"Lake Oval",-17,1928,"Regular",8,"Away","Collingwood","Sydney",17
2470,1928-06-04,"R8","Essendon",10,7,67,"St Kilda",11,10,76,"Windy Hill",-9,1928,"Regular",8,"Away","St Kilda","Essendon",9
2471,1928-06-04,"R8","Fitzroy",17,13,115,"Richmond",19,6,120,"Brunswick St",-5,1928,"Regular",8,"Away","Richmond","Fitzroy",5
2472,1928-06-04,"R8","Footscray",18,15,123,"North Melbourne",8,13,61,"Western Oval",62,1928,"Regular",8,"Home","Footscray","North Melbourne",62
2473,1928-06-04,"R8","Geelong",15,21,111,"Hawthorn",3,9,27,"Corio Oval",84,1928,"Regular",8,"Home","Geelong","Hawthorn",84
2474,1928-06-09,"R9","Carlton",9,7,61,"Footscray",8,14,62,"Princes Park",-1,1928,"Regular",9,"Away","Footscray","Carlton",1
2475,1928-06-09,"R9","Collingwood",13,14,92,"Melbourne",11,14,80,"Victoria Park",12,1928,"Regular",9,"Home","Collingwood","Melbourne",12
2476,1928-06-09,"R9","North Melbourne",9,5,59,"Essendon",10,10,70,"Arden St",-11,1928,"Regular",9,"Away","Essendon","North Melbourne",11
2477,1928-06-09,"R9","Hawthorn",10,12,72,"Fitzroy",15,16,106,"Glenferrie Oval",-34,1928,"Regular",9,"Away","Fitzroy","Hawthorn",34
2478,1928-06-09,"R9","St Kilda",14,13,97,"Geelong",10,6,66,"Junction Oval",31,1928,"Regular",9,"Home","St Kilda","Geelong",31
2479,1928-06-09,"R9","Richmond",21,16,142,"Sydney",9,12,66,"Punt Rd",76,1928,"Regular",9,"Home","Richmond","Sydney",76
2480,1928-06-23,"R10","Essendon",9,12,66,"Carlton",10,18,78,"Windy Hill",-12,1928,"Regular",10,"Away","Carlton","Essendon",12
2481,1928-06-23,"R10","Footscray",9,10,64,"Collingwood",11,12,78,"Western Oval",-14,1928,"Regular",10,"Away","Collingwood","Footscray",14
2482,1928-06-23,"R10","Fitzroy",8,13,61,"St Kilda",12,16,88,"Brunswick St",-27,1928,"Regular",10,"Away","St Kilda","Fitzroy",27
2483,1928-06-23,"R10","Geelong",11,11,77,"North Melbourne",8,4,52,"Corio Oval",25,1928,"Regular",10,"Home","Geelong","North Melbourne",25
2484,1928-06-23,"R10","Richmond",13,24,102,"Hawthorn",11,10,76,"Punt Rd",26,1928,"Regular",10,"Home","Richmond","Hawthorn",26
2485,1928-06-23,"R10","Sydney",11,12,78,"Melbourne",13,12,90,"Lake Oval",-12,1928,"Regular",10,"Away","Melbourne","Sydney",12
2486,1928-06-30,"R11","Carlton",20,12,132,"Geelong",15,14,104,"Princes Park",28,1928,"Regular",11,"Home","Carlton","Geelong",28
2487,1928-06-30,"R11","Collingwood",12,13,85,"Essendon",8,9,57,"Victoria Park",28,1928,"Regular",11,"Home","Collingwood","Essendon",28
2488,1928-06-30,"R11","North Melbourne",7,14,56,"Fitzroy",15,12,102,"Arden St",-46,1928,"Regular",11,"Away","Fitzroy","North Melbourne",46
2489,1928-06-30,"R11","Melbourne",10,8,68,"Footscray",8,8,56,"M.C.G.",12,1928,"Regular",11,"Home","Melbourne","Footscray",12
2490,1928-06-30,"R11","Hawthorn",14,11,95,"Sydney",15,10,100,"Glenferrie Oval",-5,1928,"Regular",11,"Away","Sydney","Hawthorn",5
2491,1928-06-30,"R11","St Kilda",9,11,65,"Richmond",12,9,81,"Junction Oval",-16,1928,"Regular",11,"Away","Richmond","St Kilda",16
2492,1928-07-07,"R12","Carlton",12,10,82,"Fitzroy",12,14,86,"Princes Park",-4,1928,"Regular",12,"Away","Fitzroy","Carlton",4
2493,1928-07-07,"R12","Collingwood",9,13,67,"Geelong",12,6,78,"Victoria Park",-11,1928,"Regular",12,"Away","Geelong","Collingwood",11
2494,1928-07-07,"R12","Melbourne",8,19,67,"Essendon",12,17,89,"M.C.G.",-22,1928,"Regular",12,"Away","Essendon","Melbourne",22
2495,1928-07-07,"R12","Footscray",13,13,91,"Sydney",13,11,89,"Western Oval",2,1928,"Regular",12,"Home","Footscray","Sydney",2
2496,1928-07-07,"R12","St Kilda",20,14,134,"Hawthorn",12,13,85,"Junction Oval",49,1928,"Regular",12,"Home","St Kilda","Hawthorn",49
2497,1928-07-07,"R12","North Melbourne",8,5,53,"Richmond",12,18,90,"Arden St",-37,1928,"Regular",12,"Away","Richmond","North Melbourne",37
2498,1928-07-14,"R13","Richmond",15,15,105,"Carlton",11,13,79,"Punt Rd",26,1928,"Regular",13,"Home","Richmond","Carlton",26
2499,1928-07-14,"R13","Fitzroy",7,12,54,"Collingwood",14,15,99,"Brunswick St",-45,1928,"Regular",13,"Away","Collingwood","Fitzroy",45
2500,1928-07-14,"R13","Essendon",15,14,104,"Footscray",11,8,74,"Windy Hill",30,1928,"Regular",13,"Home","Essendon","Footscray",30
2501,1928-07-14,"R13","Geelong",6,15,51,"Melbourne",7,13,55,"Corio Oval",-4,1928,"Regular",13,"Away","Melbourne","Geelong",4
2502,1928-07-14,"R13","Hawthorn",8,17,65,"North Melbourne",10,9,69,"Glenferrie Oval",-4,1928,"Regular",13,"Away","North Melbourne","Hawthorn",4
2503,1928-07-14,"R13","Sydney",10,10,70,"St Kilda",18,13,121,"Lake Oval",-51,1928,"Regular",13,"Away","St Kilda","Sydney",51
2504,1928-07-28,"R14","Carlton",22,17,149,"Hawthorn",11,13,79,"Princes Park",70,1928,"Regular",14,"Home","Carlton","Hawthorn",70
2505,1928-07-28,"R14","Collingwood",11,15,81,"Richmond",10,13,73,"Victoria Park",8,1928,"Regular",14,"Home","Collingwood","Richmond",8
2506,1928-07-28,"R14","Sydney",11,17,83,"Essendon",18,11,119,"Lake Oval",-36,1928,"Regular",14,"Away","Essendon","Sydney",36
2507,1928-07-28,"R14","Melbourne",18,18,126,"Fitzroy",11,13,79,"M.C.G.",47,1928,"Regular",14,"Home","Melbourne","Fitzroy",47
2508,1928-07-28,"R14","Footscray",8,9,57,"Geelong",8,8,56,"Western Oval",1,1928,"Regular",14,"Home","Footscray","Geelong",1
2509,1928-07-28,"R14","North Melbourne",11,12,78,"St Kilda",21,11,137,"Arden St",-59,1928,"Regular",14,"Away","St Kilda","North Melbourne",59
2510,1928-08-04,"R15","St Kilda",13,15,93,"Carlton",10,9,69,"Junction Oval",24,1928,"Regular",15,"Home","St Kilda","Carlton",24
2511,1928-08-04,"R15","Hawthorn",9,9,63,"Collingwood",17,18,120,"Glenferrie Oval",-57,1928,"Regular",15,"Away","Collingwood","Hawthorn",57
2512,1928-08-04,"R15","Geelong",4,14,38,"Essendon",12,10,82,"Corio Oval",-44,1928,"Regular",15,"Away","Essendon","Geelong",44
2513,1928-08-04,"R15","Fitzroy",13,12,90,"Footscray",12,17,89,"Brunswick St",1,1928,"Regular",15,"Home","Fitzroy","Footscray",1
2514,1928-08-04,"R15","Richmond",11,13,79,"Melbourne",7,8,50,"Punt Rd",29,1928,"Regular",15,"Home","Richmond","Melbourne",29
2515,1928-08-04,"R15","North Melbourne",12,10,82,"Sydney",11,14,80,"Arden St",2,1928,"Regular",15,"Home","North Melbourne","Sydney",2
2516,1928-08-11,"R16","Carlton",10,12,72,"North Melbourne",6,10,46,"Princes Park",26,1928,"Regular",16,"Home","Carlton","North Melbourne",26
2517,1928-08-11,"R16","Collingwood",15,16,106,"St Kilda",6,14,50,"Victoria Park",56,1928,"Regular",16,"Home","Collingwood","St Kilda",56
2518,1928-08-11,"R16","Essendon",7,12,54,"Fitzroy",8,14,62,"Windy Hill",-8,1928,"Regular",16,"Away","Fitzroy","Essendon",8
2519,1928-08-11,"R16","Footscray",8,6,54,"Richmond",10,17,77,"Western Oval",-23,1928,"Regular",16,"Away","Richmond","Footscray",23
2520,1928-08-11,"R16","Sydney",15,14,104,"Geelong",9,13,67,"Lake Oval",37,1928,"Regular",16,"Home","Sydney","Geelong",37
2521,1928-08-11,"R16","Melbourne",12,16,88,"Hawthorn",9,10,64,"M.C.G.",24,1928,"Regular",16,"Home","Melbourne","Hawthorn",24
2522,1928-08-18,"R17","Carlton",9,20,74,"Sydney",8,8,56,"Princes Park",18,1928,"Regular",17,"Home","Carlton","Sydney",18
2523,1928-08-18,"R17","North Melbourne",8,9,57,"Collingwood",8,17,65,"Arden St",-8,1928,"Regular",17,"Away","Collingwood","North Melbourne",8
2524,1928-08-18,"R17","Richmond",22,14,146,"Essendon",11,11,77,"Punt Rd",69,1928,"Regular",17,"Home","Richmond","Essendon",69
2525,1928-08-18,"R17","Fitzroy",16,9,105,"Geelong",12,9,81,"Brunswick St",24,1928,"Regular",17,"Home","Fitzroy","Geelong",24
2526,1928-08-18,"R17","Hawthorn",8,8,56,"Footscray",19,9,123,"Glenferrie Oval",-67,1928,"Regular",17,"Away","Footscray","Hawthorn",67
2527,1928-08-18,"R17","St Kilda",12,10,82,"Melbourne",11,15,81,"Junction Oval",1,1928,"Regular",17,"Home","St Kilda","Melbourne",1
2528,1928-09-01,"R18","Collingwood",8,19,67,"Carlton",12,15,87,"Victoria Park",-20,1928,"Regular",18,"Away","Carlton","Collingwood",20
2529,1928-09-01,"R18","Essendon",16,22,118,"Hawthorn",9,6,60,"Windy Hill",58,1928,"Regular",18,"Home","Essendon","Hawthorn",58
2530,1928-09-01,"R18","Sydney",14,16,100,"Fitzroy",13,12,90,"Lake Oval",10,1928,"Regular",18,"Home","Sydney","Fitzroy",10
2531,1928-09-01,"R18","Footscray",9,13,67,"St Kilda",10,10,70,"Western Oval",-3,1928,"Regular",18,"Away","St Kilda","Footscray",3
2532,1928-09-01,"R18","Geelong",9,9,63,"Richmond",15,21,111,"Corio Oval",-48,1928,"Regular",18,"Away","Richmond","Geelong",48
2533,1928-09-01,"R18","Melbourne",18,19,127,"North Melbourne",6,4,40,"M.C.G.",87,1928,"Regular",18,"Home","Melbourne","North Melbourne",87
2534,1928-09-08,"SF","Richmond",17,15,117,"Carlton",9,10,64,"M.C.G.",53,1928,"Finals",19,"Home","Richmond","Carlton",53
2535,1928-09-15,"SF","Collingwood",9,8,62,"Melbourne",9,8,62,"M.C.G.",0,1928,"Finals",19,"Home","Collingwood","Melbourne",0
2536,1928-09-22,"SF","Collingwood",10,8,68,"Melbourne",9,10,64,"M.C.G.",4,1928,"Finals",19,"Home","Collingwood","Melbourne",4
2537,1928-09-29,"GF","Collingwood",13,18,96,"Richmond",9,9,63,"M.C.G.",33,1928,"Finals",20,"Home","Collingwood","Richmond",33
2538,1929-04-27,"R1","Carlton",19,17,131,"Essendon",8,10,58,"Princes Park",73,1929,"Regular",1,"Home","Carlton","Essendon",73
2539,1929-04-27,"R1","Collingwood",15,2,92,"Richmond",11,9,75,"Victoria Park",17,1929,"Regular",1,"Home","Collingwood","Richmond",17
2540,1929-04-27,"R1","Footscray",10,18,78,"Fitzroy",10,9,69,"Western Oval",9,1929,"Regular",1,"Home","Footscray","Fitzroy",9
2541,1929-04-27,"R1","North Melbourne",8,6,54,"Geelong",12,20,92,"Arden St",-38,1929,"Regular",1,"Away","Geelong","North Melbourne",38
2542,1929-04-27,"R1","St Kilda",12,10,82,"Hawthorn",8,10,58,"Junction Oval",24,1929,"Regular",1,"Home","St Kilda","Hawthorn",24
2543,1929-04-27,"R1","Melbourne",12,8,80,"Sydney",7,16,58,"M.C.G.",22,1929,"Regular",1,"Home","Melbourne","Sydney",22
2544,1929-05-04,"R2","Richmond",16,23,119,"Carlton",16,13,109,"Punt Rd",10,1929,"Regular",2,"Home","Richmond","Carlton",10
2545,1929-05-04,"R2","Hawthorn",11,7,73,"Collingwood",18,18,126,"Glenferrie Oval",-53,1929,"Regular",2,"Away","Collingwood","Hawthorn",53
2546,1929-05-04,"R2","Essendon",17,10,112,"Footscray",16,8,104,"Windy Hill",8,1929,"Regular",2,"Home","Essendon","Footscray",8
2547,1929-05-04,"R2","Fitzroy",14,23,107,"North Melbourne",8,7,55,"Brunswick St",52,1929,"Regular",2,"Home","Fitzroy","North Melbourne",52
2548,1929-05-04,"R2","Geelong",12,15,87,"Melbourne",3,10,28,"Corio Oval",59,1929,"Regular",2,"Home","Geelong","Melbourne",59
2549,1929-05-04,"R2","Sydney",12,17,89,"St Kilda",9,9,63,"Lake Oval",26,1929,"Regular",2,"Home","Sydney","St Kilda",26
2550,1929-05-11,"R3","Carlton",13,28,106,"Hawthorn",9,14,68,"Princes Park",38,1929,"Regular",3,"Home","Carlton","Hawthorn",38
2551,1929-05-11,"R3","Collingwood",19,20,134,"Sydney",4,14,38,"Victoria Park",96,1929,"Regular",3,"Home","Collingwood","Sydney",96
2552,1929-05-11,"R3","Essendon",9,9,63,"Richmond",15,17,107,"Windy Hill",-44,1929,"Regular",3,"Away","Richmond","Essendon",44
2553,1929-05-11,"R3","Melbourne",15,17,107,"Fitzroy",12,4,76,"M.C.G.",31,1929,"Regular",3,"Home","Melbourne","Fitzroy",31
2554,1929-05-11,"R3","Footscray",8,16,64,"North Melbourne",7,11,53,"Western Oval",11,1929,"Regular",3,"Home","Footscray","North Melbourne",11
2555,1929-05-11,"R3","St Kilda",8,9,57,"Geelong",8,12,60,"Junction Oval",-3,1929,"Regular",3,"Away","Geelong","St Kilda",3
2556,1929-05-18,"R4","Sydney",9,19,73,"Carlton",10,19,79,"Lake Oval",-6,1929,"Regular",4,"Away","Carlton","Sydney",6
2557,1929-05-18,"R4","Geelong",6,13,49,"Collingwood",12,13,85,"Corio Oval",-36,1929,"Regular",4,"Away","Collingwood","Geelong",36
2558,1929-05-18,"R4","Hawthorn",10,10,70,"Essendon",10,15,75,"Glenferrie Oval",-5,1929,"Regular",4,"Away","Essendon","Hawthorn",5
2559,1929-05-18,"R4","Fitzroy",12,8,80,"St Kilda",16,21,117,"Brunswick St",-37,1929,"Regular",4,"Away","St Kilda","Fitzroy",37
2560,1929-05-18,"R4","Richmond",14,19,103,"Footscray",11,19,85,"Punt Rd",18,1929,"Regular",4,"Home","Richmond","Footscray",18
2561,1929-05-18,"R4","North Melbourne",6,5,41,"Melbourne",14,15,99,"Arden St",-58,1929,"Regular",4,"Away","Melbourne","North Melbourne",58
2562,1929-05-25,"R5","Carlton",10,13,73,"Geelong",8,7,55,"Princes Park",18,1929,"Regular",5,"Home","Carlton","Geelong",18
2563,1929-05-25,"R5","Collingwood",16,19,115,"Fitzroy",8,11,59,"Victoria Park",56,1929,"Regular",5,"Home","Collingwood","Fitzroy",56
2564,1929-05-25,"R5","Essendon",10,18,78,"Sydney",7,10,52,"Windy Hill",26,1929,"Regular",5,"Home","Essendon","Sydney",26
2565,1929-05-25,"R5","Footscray",10,15,75,"Melbourne",11,9,75,"Western Oval",0,1929,"Regular",5,"Home","Footscray","Melbourne",0
2566,1929-05-25,"R5","Richmond",16,22,118,"Hawthorn",12,5,77,"Punt Rd",41,1929,"Regular",5,"Home","Richmond","Hawthorn",41
2567,1929-05-25,"R5","St Kilda",18,13,121,"North Melbourne",7,13,55,"Junction Oval",66,1929,"Regular",5,"Home","St Kilda","North Melbourne",66
2568,1929-06-01,"R6","Fitzroy",10,13,73,"Carlton",20,12,132,"Brunswick St",-59,1929,"Regular",6,"Away","Carlton","Fitzroy",59
2569,1929-06-01,"R6","North Melbourne",11,15,81,"Collingwood",20,12,132,"Arden St",-51,1929,"Regular",6,"Away","Collingwood","North Melbourne",51
2570,1929-06-01,"R6","Sydney",11,14,80,"Richmond",10,17,77,"Lake Oval",3,1929,"Regular",6,"Home","Sydney","Richmond",3
2571,1929-06-03,"R6","Geelong",7,13,55,"Essendon",8,12,60,"Corio Oval",-5,1929,"Regular",6,"Away","Essendon","Geelong",5
2572,1929-06-03,"R6","Footscray",16,24,120,"Hawthorn",7,15,57,"Western Oval",63,1929,"Regular",6,"Home","Footscray","Hawthorn",63
2573,1929-06-03,"R6","Melbourne",8,13,61,"St Kilda",8,11,59,"M.C.G.",2,1929,"Regular",6,"Home","Melbourne","St Kilda",2
2574,1929-06-15,"R7","Carlton",15,17,107,"North Melbourne",7,10,52,"Princes Park",55,1929,"Regular",7,"Home","Carlton","North Melbourne",55
2575,1929-06-15,"R7","Collingwood",12,11,83,"Melbourne",9,5,59,"Victoria Park",24,1929,"Regular",7,"Home","Collingwood","Melbourne",24
2576,1929-06-15,"R7","Essendon",18,25,133,"Fitzroy",12,8,80,"Windy Hill",53,1929,"Regular",7,"Home","Essendon","Fitzroy",53
2577,1929-06-15,"R7","St Kilda",13,14,92,"Footscray",8,13,61,"Junction Oval",31,1929,"Regular",7,"Home","St Kilda","Footscray",31
2578,1929-06-15,"R7","Richmond",13,15,93,"Geelong",12,13,85,"Punt Rd",8,1929,"Regular",7,"Home","Richmond","Geelong",8
2579,1929-06-15,"R7","Hawthorn",15,8,98,"Sydney",11,13,79,"Glenferrie Oval",19,1929,"Regular",7,"Home","Hawthorn","Sydney",19
2580,1929-06-22,"R8","Melbourne",5,12,42,"Carlton",10,17,77,"M.C.G.",-35,1929,"Regular",8,"Away","Carlton","Melbourne",35
2581,1929-06-22,"R8","St Kilda",7,8,50,"Collingwood",7,12,54,"Junction Oval",-4,1929,"Regular",8,"Away","Collingwood","St Kilda",4
2582,1929-06-22,"R8","North Melbourne",4,14,38,"Essendon",10,12,72,"Arden St",-34,1929,"Regular",8,"Away","Essendon","North Melbourne",34
2583,1929-06-22,"R8","Fitzroy",13,8,86,"Richmond",19,13,127,"Brunswick St",-41,1929,"Regular",8,"Away","Richmond","Fitzroy",41
2584,1929-06-22,"R8","Footscray",11,9,75,"Sydney",8,13,61,"Western Oval",14,1929,"Regular",8,"Home","Footscray","Sydney",14
2585,1929-06-22,"R8","Geelong",8,8,56,"Hawthorn",2,13,25,"Corio Oval",31,1929,"Regular",8,"Home","Geelong","Hawthorn",31
2586,1929-06-29,"R9","Carlton",12,22,94,"St Kilda",7,15,57,"Princes Park",37,1929,"Regular",9,"Home","Carlton","St Kilda",37
2587,1929-06-29,"R9","Collingwood",20,19,139,"Footscray",14,10,94,"Victoria Park",45,1929,"Regular",9,"Home","Collingwood","Footscray",45
2588,1929-06-29,"R9","Essendon",11,10,76,"Melbourne",12,10,82,"Windy Hill",-6,1929,"Regular",9,"Away","Melbourne","Essendon",6
2589,1929-06-29,"R9","Hawthorn",13,15,93,"Fitzroy",8,10,58,"Glenferrie Oval",35,1929,"Regular",9,"Home","Hawthorn","Fitzroy",35
2590,1929-06-29,"R9","Sydney",10,13,73,"Geelong",10,15,75,"Lake Oval",-2,1929,"Regular",9,"Away","Geelong","Sydney",2
2591,1929-06-29,"R9","Richmond",19,15,129,"North Melbourne",11,10,76,"Punt Rd",53,1929,"Regular",9,"Home","Richmond","North Melbourne",53
2592,1929-07-06,"R10","Collingwood",15,15,105,"Carlton",11,10,76,"Victoria Park",29,1929,"Regular",10,"Home","Collingwood","Carlton",29
2593,1929-07-06,"R10","St Kilda",9,9,63,"Essendon",7,6,48,"Junction Oval",15,1929,"Regular",10,"Home","St Kilda","Essendon",15
2594,1929-07-06,"R10","Fitzroy",12,14,86,"Sydney",17,8,110,"Brunswick St",-24,1929,"Regular",10,"Away","Sydney","Fitzroy",24
2595,1929-07-06,"R10","Footscray",9,13,67,"Geelong",9,5,59,"Western Oval",8,1929,"Regular",10,"Home","Footscray","Geelong",8
2596,1929-07-06,"R10","North Melbourne",8,6,54,"Hawthorn",8,18,66,"Arden St",-12,1929,"Regular",10,"Away","Hawthorn","North Melbourne",12
2597,1929-07-06,"R10","Melbourne",10,8,68,"Richmond",9,11,65,"M.C.G.",3,1929,"Regular",10,"Home","Melbourne","Richmond",3
2598,1929-07-13,"R11","Carlton",15,20,110,"Footscray",6,7,43,"Princes Park",67,1929,"Regular",11,"Home","Carlton","Footscray",67
2599,1929-07-13,"R11","Essendon",11,7,73,"Collingwood",13,14,92,"Windy Hill",-19,1929,"Regular",11,"Away","Collingwood","Essendon",19
2600,1929-07-13,"R11","Geelong",15,6,96,"Fitzroy",10,11,71,"Corio Oval",25,1929,"Regular",11,"Home","Geelong","Fitzroy",25
2601,1929-07-13,"R11","Hawthorn",5,13,43,"Melbourne",7,11,53,"Glenferrie Oval",-10,1929,"Regular",11,"Away","Melbourne","Hawthorn",10
2602,1929-07-13,"R11","Sydney",17,14,116,"North Melbourne",12,9,81,"Lake Oval",35,1929,"Regular",11,"Home","Sydney","North Melbourne",35
2603,1929-07-13,"R11","Richmond",13,13,91,"St Kilda",7,11,53,"Punt Rd",38,1929,"Regular",11,"Home","Richmond","St Kilda",38
2604,1929-07-20,"R12","Essendon",8,7,55,"Carlton",7,17,59,"Windy Hill",-4,1929,"Regular",12,"Away","Carlton","Essendon",4
2605,1929-07-20,"R12","Richmond",11,9,75,"Collingwood",16,21,117,"Punt Rd",-42,1929,"Regular",12,"Away","Collingwood","Richmond",42
2606,1929-07-20,"R12","Fitzroy",9,15,69,"Footscray",12,16,88,"Brunswick St",-19,1929,"Regular",12,"Away","Footscray","Fitzroy",19
2607,1929-07-20,"R12","Geelong",11,14,80,"North Melbourne",8,6,54,"Corio Oval",26,1929,"Regular",12,"Home","Geelong","North Melbourne",26
2608,1929-07-20,"R12","Hawthorn",7,9,51,"St Kilda",15,12,102,"Glenferrie Oval",-51,1929,"Regular",12,"Away","St Kilda","Hawthorn",51
2609,1929-07-20,"R12","Sydney",12,10,82,"Melbourne",9,15,69,"Lake Oval",13,1929,"Regular",12,"Home","Sydney","Melbourne",13
2610,1929-07-27,"R13","Carlton",8,9,57,"Richmond",13,15,93,"Princes Park",-36,1929,"Regular",13,"Away","Richmond","Carlton",36
2611,1929-07-27,"R13","Collingwood",22,10,142,"Hawthorn",7,14,56,"Victoria Park",86,1929,"Regular",13,"Home","Collingwood","Hawthorn",86
2612,1929-07-27,"R13","Footscray",11,11,77,"Essendon",10,18,78,"Western Oval",-1,1929,"Regular",13,"Away","Essendon","Footscray",1
2613,1929-07-27,"R13","North Melbourne",12,13,85,"Fitzroy",15,12,102,"Arden St",-17,1929,"Regular",13,"Away","Fitzroy","North Melbourne",17
2614,1929-07-27,"R13","Melbourne",6,14,50,"Geelong",6,12,48,"M.C.G.",2,1929,"Regular",13,"Home","Melbourne","Geelong",2
2615,1929-07-27,"R13","St Kilda",15,9,99,"Sydney",8,8,56,"Junction Oval",43,1929,"Regular",13,"Home","St Kilda","Sydney",43
2616,1929-08-03,"R14","Hawthorn",5,7,37,"Carlton",7,8,50,"Glenferrie Oval",-13,1929,"Regular",14,"Away","Carlton","Hawthorn",13
2617,1929-08-03,"R14","Sydney",6,7,43,"Collingwood",10,10,70,"Lake Oval",-27,1929,"Regular",14,"Away","Collingwood","Sydney",27
2618,1929-08-03,"R14","Richmond",10,14,74,"Essendon",10,14,74,"Punt Rd",0,1929,"Regular",14,"Home","Richmond","Essendon",0
2619,1929-08-03,"R14","Fitzroy",5,11,41,"Melbourne",11,11,77,"Brunswick St",-36,1929,"Regular",14,"Away","Melbourne","Fitzroy",36
2620,1929-08-03,"R14","North Melbourne",9,8,62,"Footscray",7,7,49,"Arden St",13,1929,"Regular",14,"Home","North Melbourne","Footscray",13
2621,1929-08-03,"R14","Geelong",9,6,60,"St Kilda",11,5,71,"Corio Oval",-11,1929,"Regular",14,"Away","St Kilda","Geelong",11
2622,1929-08-10,"R15","Carlton",17,17,119,"Sydney",11,15,81,"Princes Park",38,1929,"Regular",15,"Home","Carlton","Sydney",38
2623,1929-08-10,"R15","Collingwood",13,9,87,"Geelong",8,12,60,"Victoria Park",27,1929,"Regular",15,"Home","Collingwood","Geelong",27
2624,1929-08-10,"R15","Essendon",15,10,100,"Hawthorn",13,14,92,"Windy Hill",8,1929,"Regular",15,"Home","Essendon","Hawthorn",8
2625,1929-08-10,"R15","St Kilda",21,16,142,"Fitzroy",10,15,75,"Junction Oval",67,1929,"Regular",15,"Home","St Kilda","Fitzroy",67
2626,1929-08-10,"R15","Footscray",11,6,72,"Richmond",14,15,99,"Western Oval",-27,1929,"Regular",15,"Away","Richmond","Footscray",27
2627,1929-08-10,"R15","Melbourne",15,17,107,"North Melbourne",6,14,50,"M.C.G.",57,1929,"Regular",15,"Home","Melbourne","North Melbourne",57
2628,1929-08-17,"R16","Geelong",2,13,25,"Carlton",5,9,39,"Corio Oval",-14,1929,"Regular",16,"Away","Carlton","Geelong",14
2629,1929-08-17,"R16","Fitzroy",8,7,55,"Collingwood",16,15,111,"Brunswick St",-56,1929,"Regular",16,"Away","Collingwood","Fitzroy",56
2630,1929-08-17,"R16","Sydney",14,10,94,"Essendon",13,10,88,"Lake Oval",6,1929,"Regular",16,"Home","Sydney","Essendon",6
2631,1929-08-17,"R16","Melbourne",11,16,82,"Footscray",6,5,41,"M.C.G.",41,1929,"Regular",16,"Home","Melbourne","Footscray",41
2632,1929-08-17,"R16","Hawthorn",8,10,58,"Richmond",11,14,80,"Glenferrie Oval",-22,1929,"Regular",16,"Away","Richmond","Hawthorn",22
2633,1929-08-17,"R16","North Melbourne",9,8,62,"St Kilda",20,12,132,"Arden St",-70,1929,"Regular",16,"Away","St Kilda","North Melbourne",70
2634,1929-08-24,"R17","Carlton",15,18,108,"Fitzroy",9,15,69,"Princes Park",39,1929,"Regular",17,"Home","Carlton","Fitzroy",39
2635,1929-08-24,"R17","Collingwood",21,12,138,"North Melbourne",8,13,61,"Victoria Park",77,1929,"Regular",17,"Home","Collingwood","North Melbourne",77
2636,1929-08-24,"R17","Essendon",7,11,53,"Geelong",6,15,51,"Windy Hill",2,1929,"Regular",17,"Home","Essendon","Geelong",2
2637,1929-08-24,"R17","Hawthorn",10,17,77,"Footscray",5,3,33,"Glenferrie Oval",44,1929,"Regular",17,"Home","Hawthorn","Footscray",44
2638,1929-08-24,"R17","St Kilda",9,12,66,"Melbourne",6,13,49,"Junction Oval",17,1929,"Regular",17,"Home","St Kilda","Melbourne",17
2639,1929-08-24,"R17","Richmond",18,28,136,"Sydney",10,5,65,"Punt Rd",71,1929,"Regular",17,"Home","Richmond","Sydney",71
2640,1929-08-31,"R18","North Melbourne",8,8,56,"Carlton",8,15,63,"Arden St",-7,1929,"Regular",18,"Away","Carlton","North Melbourne",7
2641,1929-08-31,"R18","Melbourne",5,10,40,"Collingwood",14,12,96,"M.C.G.",-56,1929,"Regular",18,"Away","Collingwood","Melbourne",56
2642,1929-08-31,"R18","Fitzroy",11,18,84,"Essendon",7,11,53,"Brunswick St",31,1929,"Regular",18,"Home","Fitzroy","Essendon",31
2643,1929-08-31,"R18","Footscray",4,18,42,"St Kilda",9,13,67,"Western Oval",-25,1929,"Regular",18,"Away","St Kilda","Footscray",25
2644,1929-08-31,"R18","Geelong",12,10,82,"Richmond",5,12,42,"Corio Oval",40,1929,"Regular",18,"Home","Geelong","Richmond",40
2645,1929-08-31,"R18","Sydney",13,10,88,"Hawthorn",11,5,71,"Lake Oval",17,1929,"Regular",18,"Home","Sydney","Hawthorn",17
2646,1929-09-07,"SF","Carlton",12,9,81,"St Kilda",11,7,73,"M.C.G.",8,1929,"Finals",19,"Home","Carlton","St Kilda",8
2647,1929-09-14,"SF","Collingwood",8,13,61,"Richmond",18,15,123,"M.C.G.",-62,1929,"Finals",19,"Away","Richmond","Collingwood",62
2648,1929-09-21,"PF","Carlton",14,7,91,"Richmond",15,7,97,"M.C.G.",-6,1929,"Finals",20,"Away","Richmond","Carlton",6
2649,1929-09-28,"GF","Collingwood",11,13,79,"Richmond",7,8,50,"M.C.G.",29,1929,"Finals",21,"Home","Collingwood","Richmond",29
2650,1930-05-03,"R1","Essendon",7,9,51,"Carlton",8,10,58,"Windy Hill",-7,1930,"Regular",1,"Away","Carlton","Essendon",7
2651,1930-05-03,"R1","Richmond",7,18,60,"Collingwood",10,14,74,"Punt Rd",-14,1930,"Regular",1,"Away","Collingwood","Richmond",14
2652,1930-05-03,"R1","Fitzroy",12,14,86,"Footscray",11,6,72,"Brunswick St",14,1930,"Regular",1,"Home","Fitzroy","Footscray",14
2653,1930-05-03,"R1","Geelong",18,13,121,"North Melbourne",2,7,19,"Corio Oval",102,1930,"Regular",1,"Home","Geelong","North Melbourne",102
2654,1930-05-03,"R1","Hawthorn",16,7,103,"St Kilda",14,8,92,"Glenferrie Oval",11,1930,"Regular",1,"Home","Hawthorn","St Kilda",11
2655,1930-05-03,"R1","Sydney",9,16,70,"Melbourne",13,17,95,"Lake Oval",-25,1930,"Regular",1,"Away","Melbourne","Sydney",25
2656,1930-05-10,"R2","Carlton",17,14,116,"Richmond",7,5,47,"Princes Park",69,1930,"Regular",2,"Home","Carlton","Richmond",69
2657,1930-05-10,"R2","Collingwood",11,12,78,"Hawthorn",10,10,70,"Victoria Park",8,1930,"Regular",2,"Home","Collingwood","Hawthorn",8
2658,1930-05-10,"R2","Footscray",10,14,74,"Essendon",9,4,58,"Western Oval",16,1930,"Regular",2,"Home","Footscray","Essendon",16
2659,1930-05-10,"R2","North Melbourne",6,9,45,"Fitzroy",9,11,65,"Arden St",-20,1930,"Regular",2,"Away","Fitzroy","North Melbourne",20
2660,1930-05-10,"R2","Melbourne",14,16,100,"Geelong",8,15,63,"M.C.G.",37,1930,"Regular",2,"Home","Melbourne","Geelong",37
2661,1930-05-10,"R2","St Kilda",16,10,106,"Sydney",11,12,78,"Junction Oval",28,1930,"Regular",2,"Home","St Kilda","Sydney",28
2662,1930-05-17,"R3","Hawthorn",10,12,72,"Carlton",13,9,87,"Glenferrie Oval",-15,1930,"Regular",3,"Away","Carlton","Hawthorn",15
2663,1930-05-17,"R3","Sydney",12,12,84,"Collingwood",16,19,115,"Lake Oval",-31,1930,"Regular",3,"Away","Collingwood","Sydney",31
2664,1930-05-17,"R3","Richmond",10,17,77,"Essendon",12,7,79,"Punt Rd",-2,1930,"Regular",3,"Away","Essendon","Richmond",2
2665,1930-05-17,"R3","Fitzroy",15,9,99,"Melbourne",15,14,104,"Brunswick St",-5,1930,"Regular",3,"Away","Melbourne","Fitzroy",5
2666,1930-05-17,"R3","North Melbourne",11,8,74,"Footscray",16,20,116,"Arden St",-42,1930,"Regular",3,"Away","Footscray","North Melbourne",42
2667,1930-05-17,"R3","Geelong",10,10,70,"St Kilda",9,6,60,"Corio Oval",10,1930,"Regular",3,"Home","Geelong","St Kilda",10
2668,1930-05-24,"R4","Carlton",20,18,138,"Sydney",11,18,84,"Princes Park",54,1930,"Regular",4,"Home","Carlton","Sydney",54
2669,1930-05-24,"R4","Collingwood",10,12,72,"Geelong",12,18,90,"Victoria Park",-18,1930,"Regular",4,"Away","Geelong","Collingwood",18
2670,1930-05-24,"R4","Essendon",14,12,96,"Hawthorn",8,13,61,"Windy Hill",35,1930,"Regular",4,"Home","Essendon","Hawthorn",35
2671,1930-05-24,"R4","St Kilda",15,18,108,"Fitzroy",8,10,58,"Junction Oval",50,1930,"Regular",4,"Home","St Kilda","Fitzroy",50
2672,1930-05-24,"R4","Footscray",9,10,64,"Richmond",14,7,91,"Western Oval",-27,1930,"Regular",4,"Away","Richmond","Footscray",27
2673,1930-05-24,"R4","Melbourne",18,15,123,"North Melbourne",15,12,102,"M.C.G.",21,1930,"Regular",4,"Home","Melbourne","North Melbourne",21
2674,1930-05-31,"R5","Geelong",8,10,58,"Carlton",10,6,66,"Corio Oval",-8,1930,"Regular",5,"Away","Carlton","Geelong",8
2675,1930-05-31,"R5","Fitzroy",10,11,71,"Collingwood",9,12,66,"Brunswick St",5,1930,"Regular",5,"Home","Fitzroy","Collingwood",5
2676,1930-05-31,"R5","Sydney",6,15,51,"Essendon",15,14,104,"Lake Oval",-53,1930,"Regular",5,"Away","Essendon","Sydney",53
2677,1930-05-31,"R5","Melbourne",17,18,120,"Footscray",9,8,62,"M.C.G.",58,1930,"Regular",5,"Home","Melbourne","Footscray",58
2678,1930-05-31,"R5","Hawthorn",8,11,59,"Richmond",11,11,77,"Glenferrie Oval",-18,1930,"Regular",5,"Away","Richmond","Hawthorn",18
2679,1930-05-31,"R5","North Melbourne",14,15,99,"St Kilda",10,11,71,"Arden St",28,1930,"Regular",5,"Home","North Melbourne","St Kilda",28
2680,1930-06-07,"R6","Carlton",17,16,118,"Fitzroy",6,12,48,"Princes Park",70,1930,"Regular",6,"Home","Carlton","Fitzroy",70
2681,1930-06-07,"R6","Collingwood",15,24,114,"North Melbourne",8,9,57,"Victoria Park",57,1930,"Regular",6,"Home","Collingwood","North Melbourne",57
2682,1930-06-07,"R6","Footscray",8,9,57,"Hawthorn",8,8,56,"Western Oval",1,1930,"Regular",6,"Home","Footscray","Hawthorn",1
2683,1930-06-09,"R6","Essendon",16,11,107,"Geelong",9,12,66,"Windy Hill",41,1930,"Regular",6,"Home","Essendon","Geelong",41
2684,1930-06-09,"R6","St Kilda",11,10,76,"Melbourne",10,7,67,"Junction Oval",9,1930,"Regular",6,"Home","St Kilda","Melbourne",9
2685,1930-06-09,"R6","Richmond",11,15,81,"Sydney",9,12,66,"Punt Rd",15,1930,"Regular",6,"Home","Richmond","Sydney",15
2686,1930-06-14,"R7","North Melbourne",9,9,63,"Carlton",15,23,113,"Arden St",-50,1930,"Regular",7,"Away","Carlton","North Melbourne",50
2687,1930-06-14,"R7","Melbourne",11,13,79,"Collingwood",14,13,97,"M.C.G.",-18,1930,"Regular",7,"Away","Collingwood","Melbourne",18
2688,1930-06-14,"R7","Fitzroy",13,13,91,"Essendon",16,10,106,"Brunswick St",-15,1930,"Regular",7,"Away","Essendon","Fitzroy",15
2689,1930-06-14,"R7","Footscray",7,14,56,"St Kilda",10,12,72,"Western Oval",-16,1930,"Regular",7,"Away","St Kilda","Footscray",16
2690,1930-06-14,"R7","Geelong",9,15,69,"Richmond",10,10,70,"Corio Oval",-1,1930,"Regular",7,"Away","Richmond","Geelong",1
2691,1930-06-14,"R7","Sydney",17,11,113,"Hawthorn",9,10,64,"Lake Oval",49,1930,"Regular",7,"Home","Sydney","Hawthorn",49
2692,1930-06-21,"R8","Carlton",9,16,70,"Melbourne",9,18,72,"Princes Park",-2,1930,"Regular",8,"Away","Melbourne","Carlton",2
2693,1930-06-21,"R8","Collingwood",22,11,143,"St Kilda",14,8,92,"Victoria Park",51,1930,"Regular",8,"Home","Collingwood","St Kilda",51
2694,1930-06-21,"R8","Essendon",11,11,77,"North Melbourne",8,8,56,"Windy Hill",21,1930,"Regular",8,"Home","Essendon","North Melbourne",21
2695,1930-06-21,"R8","Richmond",14,16,100,"Fitzroy",10,12,72,"Punt Rd",28,1930,"Regular",8,"Home","Richmond","Fitzroy",28
2696,1930-06-21,"R8","Sydney",15,19,109,"Footscray",8,12,60,"Lake Oval",49,1930,"Regular",8,"Home","Sydney","Footscray",49
2697,1930-06-21,"R8","Hawthorn",9,18,72,"Geelong",6,11,47,"Glenferrie Oval",25,1930,"Regular",8,"Home","Hawthorn","Geelong",25
2698,1930-06-28,"R9","St Kilda",12,5,77,"Carlton",13,14,92,"Junction Oval",-15,1930,"Regular",9,"Away","Carlton","St Kilda",15
2699,1930-06-28,"R9","Footscray",5,14,44,"Collingwood",19,10,124,"Western Oval",-80,1930,"Regular",9,"Away","Collingwood","Footscray",80
2700,1930-06-28,"R9","Melbourne",17,12,114,"Essendon",11,22,88,"M.C.G.",26,1930,"Regular",9,"Home","Melbourne","Essendon",26
2701,1930-06-28,"R9","Fitzroy",18,11,119,"Hawthorn",13,17,95,"Brunswick St",24,1930,"Regular",9,"Home","Fitzroy","Hawthorn",24
2702,1930-06-28,"R9","Geelong",14,12,96,"Sydney",11,6,72,"Corio Oval",24,1930,"Regular",9,"Home","Geelong","Sydney",24
2703,1930-06-28,"R9","North Melbourne",5,13,43,"Richmond",14,20,104,"Arden St",-61,1930,"Regular",9,"Away","Richmond","North Melbourne",61
2704,1930-07-05,"R10","Carlton",16,20,116,"Collingwood",16,16,112,"Princes Park",4,1930,"Regular",10,"Home","Carlton","Collingwood",4
2705,1930-07-05,"R10","Essendon",13,20,98,"St Kilda",9,20,74,"Windy Hill",24,1930,"Regular",10,"Home","Essendon","St Kilda",24
2706,1930-07-05,"R10","Sydney",13,16,94,"Fitzroy",12,12,84,"Lake Oval",10,1930,"Regular",10,"Home","Sydney","Fitzroy",10
2707,1930-07-05,"R10","Geelong",15,8,98,"Footscray",7,16,58,"Corio Oval",40,1930,"Regular",10,"Home","Geelong","Footscray",40
2708,1930-07-05,"R10","Hawthorn",11,15,81,"North Melbourne",11,11,77,"Glenferrie Oval",4,1930,"Regular",10,"Home","Hawthorn","North Melbourne",4
2709,1930-07-05,"R10","Richmond",14,20,104,"Melbourne",7,10,52,"Punt Rd",52,1930,"Regular",10,"Home","Richmond","Melbourne",52
2710,1930-07-12,"R11","Footscray",8,3,51,"Carlton",12,14,86,"Western Oval",-35,1930,"Regular",11,"Away","Carlton","Footscray",35
2711,1930-07-12,"R11","Collingwood",14,14,98,"Essendon",9,14,68,"Victoria Park",30,1930,"Regular",11,"Home","Collingwood","Essendon",30
2712,1930-07-12,"R11","Fitzroy",8,14,62,"Geelong",10,15,75,"Brunswick St",-13,1930,"Regular",11,"Away","Geelong","Fitzroy",13
2713,1930-07-12,"R11","Melbourne",12,10,82,"Hawthorn",6,5,41,"M.C.G.",41,1930,"Regular",11,"Home","Melbourne","Hawthorn",41
2714,1930-07-12,"R11","North Melbourne",6,9,45,"Sydney",10,20,80,"Arden St",-35,1930,"Regular",11,"Away","Sydney","North Melbourne",35
2715,1930-07-12,"R11","St Kilda",5,6,36,"Richmond",7,18,60,"Junction Oval",-24,1930,"Regular",11,"Away","Richmond","St Kilda",24
2716,1930-07-19,"R12","Carlton",15,16,106,"Geelong",13,13,91,"Princes Park",15,1930,"Regular",12,"Home","Carlton","Geelong",15
2717,1930-07-19,"R12","Collingwood",25,17,167,"Fitzroy",13,16,94,"Victoria Park",73,1930,"Regular",12,"Home","Collingwood","Fitzroy",73
2718,1930-07-19,"R12","Essendon",15,16,106,"Sydney",16,12,108,"Windy Hill",-2,1930,"Regular",12,"Away","Sydney","Essendon",2
2719,1930-07-19,"R12","Footscray",8,10,58,"Melbourne",7,19,61,"Western Oval",-3,1930,"Regular",12,"Away","Melbourne","Footscray",3
2720,1930-07-19,"R12","Richmond",15,19,109,"Hawthorn",7,7,49,"Punt Rd",60,1930,"Regular",12,"Home","Richmond","Hawthorn",60
2721,1930-07-19,"R12","St Kilda",18,15,123,"North Melbourne",7,6,48,"Junction Oval",75,1930,"Regular",12,"Home","St Kilda","North Melbourne",75
2722,1930-07-26,"R13","Fitzroy",10,9,69,"Carlton",10,16,76,"Brunswick St",-7,1930,"Regular",13,"Away","Carlton","Fitzroy",7
2723,1930-07-26,"R13","North Melbourne",4,15,39,"Collingwood",18,13,121,"Arden St",-82,1930,"Regular",13,"Away","Collingwood","North Melbourne",82
2724,1930-07-26,"R13","Geelong",13,14,92,"Essendon",9,9,63,"Corio Oval",29,1930,"Regular",13,"Home","Geelong","Essendon",29
2725,1930-07-26,"R13","Hawthorn",11,10,76,"Footscray",11,7,73,"Glenferrie Oval",3,1930,"Regular",13,"Home","Hawthorn","Footscray",3
2726,1930-07-26,"R13","Melbourne",12,10,82,"St Kilda",9,11,65,"M.C.G.",17,1930,"Regular",13,"Home","Melbourne","St Kilda",17
2727,1930-07-26,"R13","Sydney",11,11,77,"Richmond",10,11,71,"Lake Oval",6,1930,"Regular",13,"Home","Sydney","Richmond",6
2728,1930-08-16,"R14","Carlton",23,17,155,"North Melbourne",3,9,27,"Princes Park",128,1930,"Regular",14,"Home","Carlton","North Melbourne",128
2729,1930-08-16,"R14","Collingwood",15,14,104,"Melbourne",8,9,57,"Victoria Park",47,1930,"Regular",14,"Home","Collingwood","Melbourne",47
2730,1930-08-16,"R14","Essendon",12,19,91,"Fitzroy",10,11,71,"Windy Hill",20,1930,"Regular",14,"Home","Essendon","Fitzroy",20
2731,1930-08-16,"R14","St Kilda",9,7,61,"Footscray",7,10,52,"Junction Oval",9,1930,"Regular",14,"Home","St Kilda","Footscray",9
2732,1930-08-16,"R14","Richmond",9,11,65,"Geelong",10,11,71,"Punt Rd",-6,1930,"Regular",14,"Away","Geelong","Richmond",6
2733,1930-08-16,"R14","Hawthorn",11,7,73,"Sydney",14,10,94,"Glenferrie Oval",-21,1930,"Regular",14,"Away","Sydney","Hawthorn",21
2734,1930-08-23,"R15","Melbourne",12,11,83,"Carlton",11,11,77,"M.C.G.",6,1930,"Regular",15,"Home","Melbourne","Carlton",6
2735,1930-08-23,"R15","St Kilda",14,7,91,"Collingwood",17,13,115,"Junction Oval",-24,1930,"Regular",15,"Away","Collingwood","St Kilda",24
2736,1930-08-23,"R15","North Melbourne",6,12,48,"Essendon",14,11,95,"Arden St",-47,1930,"Regular",15,"Away","Essendon","North Melbourne",47
2737,1930-08-23,"R15","Fitzroy",11,5,71,"Richmond",8,12,60,"Brunswick St",11,1930,"Regular",15,"Home","Fitzroy","Richmond",11
2738,1930-08-23,"R15","Footscray",8,18,66,"Sydney",11,18,84,"Western Oval",-18,1930,"Regular",15,"Away","Sydney","Footscray",18
2739,1930-08-23,"R15","Geelong",18,17,125,"Hawthorn",6,7,43,"Corio Oval",82,1930,"Regular",15,"Home","Geelong","Hawthorn",82
2740,1930-08-30,"R16","Carlton",16,12,108,"St Kilda",15,7,97,"Princes Park",11,1930,"Regular",16,"Home","Carlton","St Kilda",11
2741,1930-08-30,"R16","Collingwood",16,20,116,"Footscray",10,17,77,"Victoria Park",39,1930,"Regular",16,"Home","Collingwood","Footscray",39
2742,1930-08-30,"R16","Essendon",13,11,89,"Melbourne",12,7,79,"Windy Hill",10,1930,"Regular",16,"Home","Essendon","Melbourne",10
2743,1930-08-30,"R16","Hawthorn",3,16,34,"Fitzroy",15,14,104,"Glenferrie Oval",-70,1930,"Regular",16,"Away","Fitzroy","Hawthorn",70
2744,1930-08-30,"R16","Sydney",12,16,88,"Geelong",15,14,104,"Lake Oval",-16,1930,"Regular",16,"Away","Geelong","Sydney",16
2745,1930-08-30,"R16","Richmond",20,15,135,"North Melbourne",5,10,40,"Punt Rd",95,1930,"Regular",16,"Home","Richmond","North Melbourne",95
2746,1930-09-06,"R17","Collingwood",16,10,106,"Carlton",12,11,83,"Victoria Park",23,1930,"Regular",17,"Home","Collingwood","Carlton",23
2747,1930-09-06,"R17","St Kilda",12,18,90,"Essendon",7,11,53,"Junction Oval",37,1930,"Regular",17,"Home","St Kilda","Essendon",37
2748,1930-09-06,"R17","Fitzroy",15,19,109,"Sydney",14,8,92,"Brunswick St",17,1930,"Regular",17,"Home","Fitzroy","Sydney",17
2749,1930-09-06,"R17","Footscray",15,8,98,"Geelong",11,15,81,"Western Oval",17,1930,"Regular",17,"Home","Footscray","Geelong",17
2750,1930-09-06,"R17","North Melbourne",7,9,51,"Hawthorn",9,12,66,"Arden St",-15,1930,"Regular",17,"Away","Hawthorn","North Melbourne",15
2751,1930-09-06,"R17","Melbourne",8,14,62,"Richmond",12,14,86,"M.C.G.",-24,1930,"Regular",17,"Away","Richmond","Melbourne",24
2752,1930-09-13,"R18","Carlton",10,22,82,"Footscray",3,8,26,"Princes Park",56,1930,"Regular",18,"Home","Carlton","Footscray",56
2753,1930-09-13,"R18","Essendon",10,6,66,"Collingwood",17,7,109,"Windy Hill",-43,1930,"Regular",18,"Away","Collingwood","Essendon",43
2754,1930-09-13,"R18","Geelong",10,18,78,"Fitzroy",4,14,38,"Corio Oval",40,1930,"Regular",18,"Home","Geelong","Fitzroy",40
2755,1930-09-13,"R18","Hawthorn",12,18,90,"Melbourne",10,17,77,"Glenferrie Oval",13,1930,"Regular",18,"Home","Hawthorn","Melbourne",13
2756,1930-09-13,"R18","Sydney",15,19,109,"North Melbourne",5,6,36,"Lake Oval",73,1930,"Regular",18,"Home","Sydney","North Melbourne",73
2757,1930-09-13,"R18","Richmond",7,11,53,"St Kilda",8,15,63,"Punt Rd",-10,1930,"Regular",18,"Away","St Kilda","Richmond",10
2758,1930-09-20,"SF","Carlton",8,21,69,"Geelong",13,11,89,"M.C.G.",-20,1930,"Finals",19,"Away","Geelong","Carlton",20
2759,1930-09-27,"SF","Collingwood",14,10,94,"Richmond",14,7,91,"M.C.G.",3,1930,"Finals",19,"Home","Collingwood","Richmond",3
2760,1930-10-04,"PF","Collingwood",9,11,65,"Geelong",12,19,91,"M.C.G.",-26,1930,"Finals",20,"Away","Geelong","Collingwood",26
2761,1930-10-11,"GF","Collingwood",14,16,100,"Geelong",9,16,70,"M.C.G.",30,1930,"Finals",21,"Home","Collingwood","Geelong",30
2762,1931-05-02,"R1","Carlton",15,8,98,"Richmond",14,23,107,"Princes Park",-9,1931,"Regular",1,"Away","Richmond","Carlton",9
2763,1931-05-02,"R1","Collingwood",13,14,92,"Geelong",12,15,87,"Victoria Park",5,1931,"Regular",1,"Home","Collingwood","Geelong",5
2764,1931-05-02,"R1","St Kilda",13,14,92,"Essendon",11,14,80,"Junction Oval",12,1931,"Regular",1,"Home","St Kilda","Essendon",12
2765,1931-05-02,"R1","Melbourne",15,16,106,"Fitzroy",14,10,94,"M.C.G.",12,1931,"Regular",1,"Home","Melbourne","Fitzroy",12
2766,1931-05-02,"R1","Footscray",8,13,61,"Hawthorn",9,6,60,"Western Oval",1,1931,"Regular",1,"Home","Footscray","Hawthorn",1
2767,1931-05-02,"R1","North Melbourne",11,17,83,"Sydney",19,21,135,"Arden St",-52,1931,"Regular",1,"Away","Sydney","North Melbourne",52
2768,1931-05-09,"R2","Fitzroy",13,15,93,"Carlton",19,19,133,"Brunswick St",-40,1931,"Regular",2,"Away","Carlton","Fitzroy",40
2769,1931-05-09,"R2","Hawthorn",8,17,65,"Collingwood",11,18,84,"Glenferrie Oval",-19,1931,"Regular",2,"Away","Collingwood","Hawthorn",19
2770,1931-05-09,"R2","Essendon",12,5,77,"Melbourne",10,13,73,"Windy Hill",4,1931,"Regular",2,"Home","Essendon","Melbourne",4
2771,1931-05-09,"R2","Sydney",13,13,91,"Footscray",16,15,111,"Lake Oval",-20,1931,"Regular",2,"Away","Footscray","Sydney",20
2772,1931-05-09,"R2","Geelong",20,6,126,"St Kilda",7,12,54,"Corio Oval",72,1931,"Regular",2,"Home","Geelong","St Kilda",72
2773,1931-05-09,"R2","Richmond",30,19,199,"North Melbourne",4,7,31,"Punt Rd",168,1931,"Regular",2,"Home","Richmond","North Melbourne",168
2774,1931-05-16,"R3","Carlton",18,18,126,"Essendon",5,14,44,"Princes Park",82,1931,"Regular",3,"Home","Carlton","Essendon",82
2775,1931-05-16,"R3","Collingwood",13,16,94,"Sydney",10,13,73,"Victoria Park",21,1931,"Regular",3,"Home","Collingwood","Sydney",21
2776,1931-05-16,"R3","North Melbourne",6,12,48,"Fitzroy",12,16,88,"Arden St",-40,1931,"Regular",3,"Away","Fitzroy","North Melbourne",40
2777,1931-05-16,"R3","Footscray",7,10,52,"Richmond",13,16,94,"Western Oval",-42,1931,"Regular",3,"Away","Richmond","Footscray",42
2778,1931-05-16,"R3","Melbourne",12,15,87,"Geelong",11,17,83,"M.C.G.",4,1931,"Regular",3,"Home","Melbourne","Geelong",4
2779,1931-05-16,"R3","St Kilda",10,12,72,"Hawthorn",10,8,68,"Junction Oval",4,1931,"Regular",3,"Home","St Kilda","Hawthorn",4
2780,1931-05-23,"R4","Geelong",11,14,80,"Carlton",11,8,74,"Corio Oval",6,1931,"Regular",4,"Home","Geelong","Carlton",6
2781,1931-05-23,"R4","Richmond",10,12,72,"Collingwood",9,14,68,"Punt Rd",4,1931,"Regular",4,"Home","Richmond","Collingwood",4
2782,1931-05-23,"R4","Essendon",12,13,85,"North Melbourne",9,9,63,"Windy Hill",22,1931,"Regular",4,"Home","Essendon","North Melbourne",22
2783,1931-05-23,"R4","Fitzroy",10,15,75,"Footscray",12,12,84,"Brunswick St",-9,1931,"Regular",4,"Away","Footscray","Fitzroy",9
2784,1931-05-23,"R4","Hawthorn",13,16,94,"Melbourne",16,13,109,"Glenferrie Oval",-15,1931,"Regular",4,"Away","Melbourne","Hawthorn",15
2785,1931-05-23,"R4","Sydney",18,19,127,"St Kilda",16,10,106,"Lake Oval",21,1931,"Regular",4,"Home","Sydney","St Kilda",21
2786,1931-05-30,"R5","Carlton",16,11,107,"Collingwood",13,13,91,"Princes Park",16,1931,"Regular",5,"Home","Carlton","Collingwood",16
2787,1931-05-30,"R5","Essendon",10,12,72,"Richmond",11,20,86,"Windy Hill",-14,1931,"Regular",5,"Away","Richmond","Essendon",14
2788,1931-05-30,"R5","Geelong",20,22,142,"Fitzroy",12,9,81,"Corio Oval",61,1931,"Regular",5,"Home","Geelong","Fitzroy",61
2789,1931-05-30,"R5","Melbourne",13,9,87,"Footscray",10,11,71,"M.C.G.",16,1931,"Regular",5,"Home","Melbourne","Footscray",16
2790,1931-05-30,"R5","Hawthorn",11,10,76,"Sydney",11,13,79,"Glenferrie Oval",-3,1931,"Regular",5,"Away","Sydney","Hawthorn",3
2791,1931-05-30,"R5","St Kilda",13,19,97,"North Melbourne",7,10,52,"Junction Oval",45,1931,"Regular",5,"Home","St Kilda","North Melbourne",45
2792,1931-06-08,"R6","Collingwood",15,10,100,"St Kilda",10,17,77,"Victoria Park",23,1931,"Regular",6,"Home","Collingwood","St Kilda",23
2793,1931-06-08,"R6","Sydney",6,8,44,"Geelong",13,15,93,"Lake Oval",-49,1931,"Regular",6,"Away","Geelong","Sydney",49
2794,1931-06-08,"R6","North Melbourne",7,17,59,"Melbourne",15,8,98,"Arden St",-39,1931,"Regular",6,"Away","Melbourne","North Melbourne",39
2795,1931-06-13,"R7","St Kilda",8,11,59,"Carlton",12,18,90,"Junction Oval",-31,1931,"Regular",7,"Away","Carlton","St Kilda",31
2796,1931-06-13,"R7","Melbourne",7,12,54,"Collingwood",10,11,71,"M.C.G.",-17,1931,"Regular",7,"Away","Collingwood","Melbourne",17
2797,1931-06-13,"R7","Essendon",8,12,60,"Hawthorn",12,8,80,"Windy Hill",-20,1931,"Regular",7,"Away","Hawthorn","Essendon",20
2798,1931-06-13,"R7","Fitzroy",14,14,98,"Sydney",16,15,111,"Brunswick St",-13,1931,"Regular",7,"Away","Sydney","Fitzroy",13
2799,1931-06-13,"R7","Footscray",13,8,86,"North Melbourne",5,13,43,"Western Oval",43,1931,"Regular",7,"Home","Footscray","North Melbourne",43
2800,1931-06-13,"R7","Geelong",12,15,87,"Richmond",8,12,60,"Corio Oval",27,1931,"Regular",7,"Home","Geelong","Richmond",27
2801,1931-06-20,"R8","Carlton",18,14,122,"Melbourne",9,4,58,"Princes Park",64,1931,"Regular",8,"Home","Carlton","Melbourne",64
2802,1931-06-20,"R8","Collingwood",22,22,154,"North Melbourne",9,10,64,"Victoria Park",90,1931,"Regular",8,"Home","Collingwood","North Melbourne",90
2803,1931-06-20,"R8","Essendon",7,13,55,"Geelong",13,11,89,"Windy Hill",-34,1931,"Regular",8,"Away","Geelong","Essendon",34
2804,1931-06-20,"R8","Hawthorn",12,8,80,"Fitzroy",7,14,56,"Glenferrie Oval",24,1931,"Regular",8,"Home","Hawthorn","Fitzroy",24
2805,1931-06-20,"R8","St Kilda",7,10,52,"Footscray",11,11,77,"Junction Oval",-25,1931,"Regular",8,"Away","Footscray","St Kilda",25
2806,1931-06-20,"R8","Richmond",12,12,84,"Sydney",7,15,57,"Punt Rd",27,1931,"Regular",8,"Home","Richmond","Sydney",27
2807,1931-06-27,"R6","Footscray",8,8,56,"Carlton",8,11,59,"Western Oval",-3,1931,"Regular",6,"Away","Carlton","Footscray",3
2808,1931-06-27,"R6","Fitzroy",7,14,56,"Essendon",10,10,70,"Brunswick St",-14,1931,"Regular",6,"Away","Essendon","Fitzroy",14
2809,1931-06-27,"R6","Richmond",9,15,69,"Hawthorn",8,10,58,"Punt Rd",11,1931,"Regular",6,"Home","Richmond","Hawthorn",11
2810,1931-07-04,"R9","North Melbourne",7,8,50,"Carlton",20,10,130,"Arden St",-80,1931,"Regular",9,"Away","Carlton","North Melbourne",80
2811,1931-07-04,"R9","Footscray",4,16,40,"Collingwood",6,8,44,"Western Oval",-4,1931,"Regular",9,"Away","Collingwood","Footscray",4
2812,1931-07-04,"R9","Sydney",10,13,73,"Essendon",9,9,63,"Lake Oval",10,1931,"Regular",9,"Home","Sydney","Essendon",10
2813,1931-07-04,"R9","Fitzroy",8,13,61,"Richmond",14,17,101,"Brunswick St",-40,1931,"Regular",9,"Away","Richmond","Fitzroy",40
2814,1931-07-04,"R9","Geelong",13,9,87,"Hawthorn",9,7,61,"Corio Oval",26,1931,"Regular",9,"Home","Geelong","Hawthorn",26
2815,1931-07-04,"R9","Melbourne",4,12,36,"St Kilda",9,9,63,"M.C.G.",-27,1931,"Regular",9,"Away","St Kilda","Melbourne",27
2816,1931-07-11,"R10","Sydney",10,12,72,"Carlton",11,11,77,"Lake Oval",-5,1931,"Regular",10,"Away","Carlton","Sydney",5
2817,1931-07-11,"R10","Essendon",12,9,81,"Collingwood",8,9,57,"Windy Hill",24,1931,"Regular",10,"Home","Essendon","Collingwood",24
2818,1931-07-11,"R10","Fitzroy",8,10,58,"St Kilda",12,18,90,"Brunswick St",-32,1931,"Regular",10,"Away","St Kilda","Fitzroy",32
2819,1931-07-11,"R10","Geelong",7,10,52,"Footscray",3,5,23,"Corio Oval",29,1931,"Regular",10,"Home","Geelong","Footscray",29
2820,1931-07-11,"R10","Hawthorn",14,12,96,"North Melbourne",3,6,24,"Glenferrie Oval",72,1931,"Regular",10,"Home","Hawthorn","North Melbourne",72
2821,1931-07-11,"R10","Richmond",8,18,66,"Melbourne",7,11,53,"Punt Rd",13,1931,"Regular",10,"Home","Richmond","Melbourne",13
2822,1931-07-18,"R11","Carlton",16,15,111,"Hawthorn",5,8,38,"Princes Park",73,1931,"Regular",11,"Home","Carlton","Hawthorn",73
2823,1931-07-18,"R11","Collingwood",14,20,104,"Fitzroy",8,10,58,"Victoria Park",46,1931,"Regular",11,"Home","Collingwood","Fitzroy",46
2824,1931-07-18,"R11","Footscray",8,10,58,"Essendon",12,13,85,"Western Oval",-27,1931,"Regular",11,"Away","Essendon","Footscray",27
2825,1931-07-18,"R11","North Melbourne",9,10,64,"Geelong",19,17,131,"Arden St",-67,1931,"Regular",11,"Away","Geelong","North Melbourne",67
2826,1931-07-18,"R11","Melbourne",4,7,31,"Sydney",12,10,82,"M.C.G.",-51,1931,"Regular",11,"Away","Sydney","Melbourne",51
2827,1931-07-18,"R11","St Kilda",6,12,48,"Richmond",11,19,85,"Junction Oval",-37,1931,"Regular",11,"Away","Richmond","St Kilda",37
2828,1931-07-25,"R12","Richmond",8,17,65,"Carlton",6,12,48,"Punt Rd",17,1931,"Regular",12,"Home","Richmond","Carlton",17
2829,1931-07-25,"R12","Geelong",4,19,43,"Collingwood",4,6,30,"Corio Oval",13,1931,"Regular",12,"Home","Geelong","Collingwood",13
2830,1931-07-25,"R12","Essendon",15,14,104,"St Kilda",9,5,59,"Windy Hill",45,1931,"Regular",12,"Home","Essendon","St Kilda",45
2831,1931-07-25,"R12","Fitzroy",11,11,77,"Melbourne",9,12,66,"Brunswick St",11,1931,"Regular",12,"Home","Fitzroy","Melbourne",11
2832,1931-07-25,"R12","Hawthorn",8,5,53,"Footscray",6,19,55,"Glenferrie Oval",-2,1931,"Regular",12,"Away","Footscray","Hawthorn",2
2833,1931-07-25,"R12","Sydney",13,16,94,"North Melbourne",9,12,66,"Lake Oval",28,1931,"Regular",12,"Home","Sydney","North Melbourne",28
2834,1931-08-01,"R13","Carlton",18,13,121,"Fitzroy",13,11,89,"Princes Park",32,1931,"Regular",13,"Home","Carlton","Fitzroy",32
2835,1931-08-01,"R13","Collingwood",15,13,103,"Hawthorn",7,16,58,"Victoria Park",45,1931,"Regular",13,"Home","Collingwood","Hawthorn",45
2836,1931-08-01,"R13","Melbourne",11,6,72,"Essendon",10,11,71,"M.C.G.",1,1931,"Regular",13,"Home","Melbourne","Essendon",1
2837,1931-08-01,"R13","Footscray",9,14,68,"Sydney",5,11,41,"Western Oval",27,1931,"Regular",13,"Home","Footscray","Sydney",27
2838,1931-08-01,"R13","St Kilda",7,10,52,"Geelong",15,10,100,"Junction Oval",-48,1931,"Regular",13,"Away","Geelong","St Kilda",48
2839,1931-08-01,"R13","North Melbourne",9,15,69,"Richmond",16,12,108,"Arden St",-39,1931,"Regular",13,"Away","Richmond","North Melbourne",39
2840,1931-08-08,"R14","Essendon",18,14,122,"Carlton",11,22,88,"Windy Hill",34,1931,"Regular",14,"Home","Essendon","Carlton",34
2841,1931-08-08,"R14","Sydney",6,23,59,"Collingwood",8,13,61,"Lake Oval",-2,1931,"Regular",14,"Away","Collingwood","Sydney",2
2842,1931-08-08,"R14","Fitzroy",21,12,138,"North Melbourne",8,12,60,"Brunswick St",78,1931,"Regular",14,"Home","Fitzroy","North Melbourne",78
2843,1931-08-08,"R14","Richmond",7,12,54,"Footscray",10,18,78,"Punt Rd",-24,1931,"Regular",14,"Away","Footscray","Richmond",24
2844,1931-08-08,"R14","Geelong",11,11,77,"Melbourne",6,9,45,"Corio Oval",32,1931,"Regular",14,"Home","Geelong","Melbourne",32
2845,1931-08-08,"R14","Hawthorn",11,9,75,"St Kilda",11,11,77,"Glenferrie Oval",-2,1931,"Regular",14,"Away","St Kilda","Hawthorn",2
2846,1931-08-22,"R15","Carlton",5,9,39,"Geelong",3,10,28,"Princes Park",11,1931,"Regular",15,"Home","Carlton","Geelong",11
2847,1931-08-22,"R15","Collingwood",6,10,46,"Richmond",10,10,70,"Victoria Park",-24,1931,"Regular",15,"Away","Richmond","Collingwood",24
2848,1931-08-22,"R15","North Melbourne",9,7,61,"Essendon",11,17,83,"Arden St",-22,1931,"Regular",15,"Away","Essendon","North Melbourne",22
2849,1931-08-22,"R15","Footscray",10,12,72,"Fitzroy",6,6,42,"Western Oval",30,1931,"Regular",15,"Home","Footscray","Fitzroy",30
2850,1931-08-22,"R15","Melbourne",13,15,93,"Hawthorn",2,6,18,"M.C.G.",75,1931,"Regular",15,"Home","Melbourne","Hawthorn",75
2851,1931-08-22,"R15","St Kilda",6,18,54,"Sydney",8,14,62,"Junction Oval",-8,1931,"Regular",15,"Away","Sydney","St Kilda",8
2852,1931-08-29,"R16","Collingwood",20,15,135,"Carlton",10,14,74,"Victoria Park",61,1931,"Regular",16,"Home","Collingwood","Carlton",61
2853,1931-08-29,"R16","Richmond",23,14,152,"Essendon",15,11,101,"Punt Rd",51,1931,"Regular",16,"Home","Richmond","Essendon",51
2854,1931-08-29,"R16","Fitzroy",9,8,62,"Geelong",9,22,76,"Brunswick St",-14,1931,"Regular",16,"Away","Geelong","Fitzroy",14
2855,1931-08-29,"R16","Footscray",10,12,72,"Melbourne",5,8,38,"Western Oval",34,1931,"Regular",16,"Home","Footscray","Melbourne",34
2856,1931-08-29,"R16","Sydney",12,18,90,"Hawthorn",9,5,59,"Lake Oval",31,1931,"Regular",16,"Home","Sydney","Hawthorn",31
2857,1931-08-29,"R16","North Melbourne",7,8,50,"St Kilda",11,15,81,"Arden St",-31,1931,"Regular",16,"Away","St Kilda","North Melbourne",31
2858,1931-09-05,"R17","Carlton",6,14,50,"Footscray",7,12,54,"Princes Park",-4,1931,"Regular",17,"Away","Footscray","Carlton",4
2859,1931-09-05,"R17","St Kilda",21,16,142,"Collingwood",20,8,128,"Junction Oval",14,1931,"Regular",17,"Home","St Kilda","Collingwood",14
2860,1931-09-05,"R17","Essendon",15,7,97,"Fitzroy",12,8,80,"Windy Hill",17,1931,"Regular",17,"Home","Essendon","Fitzroy",17
2861,1931-09-05,"R17","Geelong",16,12,108,"Sydney",8,11,59,"Corio Oval",49,1931,"Regular",17,"Home","Geelong","Sydney",49
2862,1931-09-05,"R17","Hawthorn",5,13,43,"Richmond",13,21,99,"Glenferrie Oval",-56,1931,"Regular",17,"Away","Richmond","Hawthorn",56
2863,1931-09-05,"R17","Melbourne",18,15,123,"North Melbourne",11,13,79,"M.C.G.",44,1931,"Regular",17,"Home","Melbourne","North Melbourne",44
2864,1931-09-12,"R18","Carlton",10,6,66,"St Kilda",6,12,48,"Princes Park",18,1931,"Regular",18,"Home","Carlton","St Kilda",18
2865,1931-09-12,"R18","Collingwood",18,19,127,"Melbourne",8,9,57,"Victoria Park",70,1931,"Regular",18,"Home","Collingwood","Melbourne",70
2866,1931-09-12,"R18","Hawthorn",8,15,63,"Essendon",9,12,66,"Glenferrie Oval",-3,1931,"Regular",18,"Away","Essendon","Hawthorn",3
2867,1931-09-12,"R18","Sydney",5,14,44,"Fitzroy",10,14,74,"Lake Oval",-30,1931,"Regular",18,"Away","Fitzroy","Sydney",30
2868,1931-09-12,"R18","North Melbourne",3,16,34,"Footscray",5,13,43,"Arden St",-9,1931,"Regular",18,"Away","Footscray","North Melbourne",9
2869,1931-09-12,"R18","Richmond",8,8,56,"Geelong",11,17,83,"Punt Rd",-27,1931,"Regular",18,"Away","Geelong","Richmond",27
2870,1931-09-19,"SF","Carlton",20,10,130,"Collingwood",5,12,42,"M.C.G.",88,1931,"Finals",19,"Home","Carlton","Collingwood",88
2871,1931-09-26,"SF","Geelong",10,6,66,"Richmond",15,9,99,"M.C.G.",-33,1931,"Finals",19,"Away","Richmond","Geelong",33
2872,1931-10-03,"PF","Geelong",11,17,83,"Carlton",11,11,77,"M.C.G.",6,1931,"Finals",20,"Home","Geelong","Carlton",6
2873,1931-10-10,"GF","Geelong",9,14,68,"Richmond",7,6,48,"M.C.G.",20,1931,"Finals",21,"Home","Geelong","Richmond",20
2874,1932-04-30,"R1","Fitzroy",12,19,91,"Carlton",10,15,75,"Brunswick St",16,1932,"Regular",1,"Home","Fitzroy","Carlton",16
2875,1932-04-30,"R1","Hawthorn",7,9,51,"Collingwood",11,10,76,"Glenferrie Oval",-25,1932,"Regular",1,"Away","Collingwood","Hawthorn",25
2876,1932-04-30,"R1","Essendon",15,15,105,"Footscray",7,12,54,"Windy Hill",51,1932,"Regular",1,"Home","Essendon","Footscray",51
2877,1932-04-30,"R1","Geelong",14,21,105,"North Melbourne",11,12,78,"Corio Oval",27,1932,"Regular",1,"Home","Geelong","North Melbourne",27
2878,1932-04-30,"R1","Sydney",11,19,85,"Melbourne",9,11,65,"Lake Oval",20,1932,"Regular",1,"Home","Sydney","Melbourne",20
2879,1932-04-30,"R1","Richmond",16,20,116,"St Kilda",6,14,50,"Punt Rd",66,1932,"Regular",1,"Home","Richmond","St Kilda",66
2880,1932-05-07,"R2","Carlton",10,15,75,"Sydney",17,11,113,"Princes Park",-38,1932,"Regular",2,"Away","Sydney","Carlton",38
2881,1932-05-07,"R2","Collingwood",12,11,83,"Geelong",13,16,94,"Victoria Park",-11,1932,"Regular",2,"Away","Geelong","Collingwood",11
2882,1932-05-07,"R2","North Melbourne",14,12,96,"Essendon",16,17,113,"Arden St",-17,1932,"Regular",2,"Away","Essendon","North Melbourne",17
2883,1932-05-07,"R2","Footscray",14,11,95,"Fitzroy",7,10,52,"Western Oval",43,1932,"Regular",2,"Home","Footscray","Fitzroy",43
2884,1932-05-07,"R2","St Kilda",16,19,115,"Hawthorn",11,16,82,"Junction Oval",33,1932,"Regular",2,"Home","St Kilda","Hawthorn",33
2885,1932-05-07,"R2","Melbourne",7,13,55,"Richmond",15,26,116,"Olympic Park",-61,1932,"Regular",2,"Away","Richmond","Melbourne",61
2886,1932-05-14,"R3","Richmond",10,23,83,"Carlton",12,12,84,"Punt Rd",-1,1932,"Regular",3,"Away","Carlton","Richmond",1
2887,1932-05-14,"R3","Essendon",15,20,110,"Collingwood",18,11,119,"Windy Hill",-9,1932,"Regular",3,"Away","Collingwood","Essendon",9
2888,1932-05-14,"R3","Fitzroy",13,16,94,"North Melbourne",17,11,113,"Brunswick St",-19,1932,"Regular",3,"Away","North Melbourne","Fitzroy",19
2889,1932-05-14,"R3","Sydney",10,11,71,"Footscray",8,12,60,"Lake Oval",11,1932,"Regular",3,"Home","Sydney","Footscray",11
2890,1932-05-14,"R3","Geelong",25,10,160,"St Kilda",6,9,45,"Corio Oval",115,1932,"Regular",3,"Home","Geelong","St Kilda",115
2891,1932-05-14,"R3","Hawthorn",8,11,59,"Melbourne",6,14,50,"Glenferrie Oval",9,1932,"Regular",3,"Home","Hawthorn","Melbourne",9
2892,1932-05-21,"R4","Carlton",16,16,112,"Hawthorn",7,7,49,"Princes Park",63,1932,"Regular",4,"Home","Carlton","Hawthorn",63
2893,1932-05-21,"R4","Collingwood",14,22,106,"Fitzroy",11,9,75,"Victoria Park",31,1932,"Regular",4,"Home","Collingwood","Fitzroy",31
2894,1932-05-21,"R4","St Kilda",7,15,57,"Essendon",12,15,87,"Junction Oval",-30,1932,"Regular",4,"Away","Essendon","St Kilda",30
2895,1932-05-21,"R4","Footscray",6,12,48,"Richmond",7,9,51,"Western Oval",-3,1932,"Regular",4,"Away","Richmond","Footscray",3
2896,1932-05-21,"R4","Melbourne",14,11,95,"Geelong",20,13,133,"Olympic Park",-38,1932,"Regular",4,"Away","Geelong","Melbourne",38
2897,1932-05-21,"R4","North Melbourne",9,16,70,"Sydney",11,7,73,"Arden St",-3,1932,"Regular",4,"Away","Sydney","North Melbourne",3
2898,1932-05-28,"R5","Carlton",13,15,93,"Collingwood",11,7,73,"Princes Park",20,1932,"Regular",5,"Home","Carlton","Collingwood",20
2899,1932-05-28,"R5","Sydney",14,15,99,"Essendon",9,11,65,"Lake Oval",34,1932,"Regular",5,"Home","Sydney","Essendon",34
2900,1932-05-28,"R5","Fitzroy",12,6,78,"Geelong",20,10,130,"Brunswick St",-52,1932,"Regular",5,"Away","Geelong","Fitzroy",52
2901,1932-05-28,"R5","Footscray",13,14,92,"St Kilda",8,10,58,"Western Oval",34,1932,"Regular",5,"Home","Footscray","St Kilda",34
2902,1932-05-28,"R5","Richmond",13,18,96,"Hawthorn",6,9,45,"Punt Rd",51,1932,"Regular",5,"Home","Richmond","Hawthorn",51
2903,1932-05-28,"R5","North Melbourne",18,10,118,"Melbourne",12,16,88,"Arden St",30,1932,"Regular",5,"Home","North Melbourne","Melbourne",30
2904,1932-06-04,"R6","Melbourne",9,9,63,"Carlton",12,15,87,"Olympic Park",-24,1932,"Regular",6,"Away","Carlton","Melbourne",24
2905,1932-06-04,"R6","Collingwood",12,19,91,"Footscray",9,21,75,"Victoria Park",16,1932,"Regular",6,"Home","Collingwood","Footscray",16
2906,1932-06-04,"R6","Essendon",22,10,142,"Fitzroy",13,12,90,"Windy Hill",52,1932,"Regular",6,"Home","Essendon","Fitzroy",52
2907,1932-06-04,"R6","Geelong",9,15,69,"Richmond",9,15,69,"Corio Oval",0,1932,"Regular",6,"Home","Geelong","Richmond",0
2908,1932-06-04,"R6","Hawthorn",11,14,80,"Sydney",16,13,109,"Glenferrie Oval",-29,1932,"Regular",6,"Away","Sydney","Hawthorn",29
2909,1932-06-04,"R6","St Kilda",16,9,105,"North Melbourne",16,14,110,"Junction Oval",-5,1932,"Regular",6,"Away","North Melbourne","St Kilda",5
2910,1932-06-18,"R7","Carlton",17,16,118,"St Kilda",7,12,54,"Princes Park",64,1932,"Regular",7,"Home","Carlton","St Kilda",64
2911,1932-06-18,"R7","Collingwood",16,5,101,"Melbourne",11,17,83,"Victoria Park",18,1932,"Regular",7,"Home","Collingwood","Melbourne",18
2912,1932-06-18,"R7","Hawthorn",7,9,51,"Essendon",8,17,65,"Glenferrie Oval",-14,1932,"Regular",7,"Away","Essendon","Hawthorn",14
2913,1932-06-18,"R7","Richmond",14,16,100,"Fitzroy",8,13,61,"Punt Rd",39,1932,"Regular",7,"Home","Richmond","Fitzroy",39
2914,1932-06-18,"R7","North Melbourne",9,8,62,"Footscray",13,13,91,"Arden St",-29,1932,"Regular",7,"Away","Footscray","North Melbourne",29
2915,1932-06-18,"R7","Sydney",14,21,105,"Geelong",14,12,96,"Lake Oval",9,1932,"Regular",7,"Home","Sydney","Geelong",9
2916,1932-06-25,"R8","North Melbourne",11,7,73,"Carlton",14,16,100,"Arden St",-27,1932,"Regular",8,"Away","Carlton","North Melbourne",27
2917,1932-06-25,"R8","St Kilda",12,16,88,"Collingwood",15,15,105,"Junction Oval",-17,1932,"Regular",8,"Away","Collingwood","St Kilda",17
2918,1932-06-25,"R8","Geelong",9,9,63,"Essendon",11,12,78,"Corio Oval",-15,1932,"Regular",8,"Away","Essendon","Geelong",15
2919,1932-06-25,"R8","Fitzroy",13,15,93,"Hawthorn",9,9,63,"Brunswick St",30,1932,"Regular",8,"Home","Fitzroy","Hawthorn",30
2920,1932-06-25,"R8","Footscray",10,7,67,"Melbourne",3,9,27,"Western Oval",40,1932,"Regular",8,"Home","Footscray","Melbourne",40
2921,1932-06-25,"R8","Richmond",8,7,55,"Sydney",8,9,57,"Punt Rd",-2,1932,"Regular",8,"Away","Sydney","Richmond",2
2922,1932-07-02,"R9","Carlton",9,21,75,"Footscray",7,9,51,"Princes Park",24,1932,"Regular",9,"Home","Carlton","Footscray",24
2923,1932-07-02,"R9","Collingwood",19,12,126,"North Melbourne",13,9,87,"Victoria Park",39,1932,"Regular",9,"Home","Collingwood","North Melbourne",39
2924,1932-07-02,"R9","Essendon",4,18,42,"Richmond",11,14,80,"Windy Hill",-38,1932,"Regular",9,"Away","Richmond","Essendon",38
2925,1932-07-02,"R9","Sydney",12,10,82,"Fitzroy",10,15,75,"Lake Oval",7,1932,"Regular",9,"Home","Sydney","Fitzroy",7
2926,1932-07-02,"R9","Hawthorn",7,12,54,"Geelong",14,11,95,"Glenferrie Oval",-41,1932,"Regular",9,"Away","Geelong","Hawthorn",41
2927,1932-07-02,"R9","Melbourne",12,13,85,"St Kilda",10,14,74,"M.C.G.",11,1932,"Regular",9,"Home","Melbourne","St Kilda",11
2928,1932-07-09,"R10","Carlton",21,16,142,"Essendon",11,11,77,"Princes Park",65,1932,"Regular",10,"Home","Carlton","Essendon",65
2929,1932-07-09,"R10","Collingwood",14,6,90,"Richmond",11,12,78,"Victoria Park",12,1932,"Regular",10,"Home","Collingwood","Richmond",12
2930,1932-07-09,"R10","Melbourne",15,12,102,"Fitzroy",13,12,90,"M.C.G.",12,1932,"Regular",10,"Home","Melbourne","Fitzroy",12
2931,1932-07-09,"R10","Footscray",7,15,57,"Geelong",8,8,56,"Western Oval",1,1932,"Regular",10,"Home","Footscray","Geelong",1
2932,1932-07-09,"R10","North Melbourne",14,22,106,"Hawthorn",8,11,59,"Arden St",47,1932,"Regular",10,"Home","North Melbourne","Hawthorn",47
2933,1932-07-09,"R10","St Kilda",10,9,69,"Sydney",9,16,70,"Junction Oval",-1,1932,"Regular",10,"Away","Sydney","St Kilda",1
2934,1932-07-16,"R11","Geelong",8,20,68,"Carlton",10,23,83,"Corio Oval",-15,1932,"Regular",11,"Away","Carlton","Geelong",15
2935,1932-07-16,"R11","Sydney",5,17,47,"Collingwood",7,8,50,"Lake Oval",-3,1932,"Regular",11,"Away","Collingwood","Sydney",3
2936,1932-07-16,"R11","Essendon",6,14,50,"Melbourne",7,11,53,"Windy Hill",-3,1932,"Regular",11,"Away","Melbourne","Essendon",3
2937,1932-07-16,"R11","Fitzroy",11,6,72,"St Kilda",10,13,73,"Brunswick St",-1,1932,"Regular",11,"Away","St Kilda","Fitzroy",1
2938,1932-07-16,"R11","Hawthorn",9,9,63,"Footscray",6,6,42,"Glenferrie Oval",21,1932,"Regular",11,"Home","Hawthorn","Footscray",21
2939,1932-07-16,"R11","Richmond",8,10,58,"North Melbourne",6,7,43,"Punt Rd",15,1932,"Regular",11,"Home","Richmond","North Melbourne",15
2940,1932-07-23,"R12","Carlton",18,21,129,"Fitzroy",13,6,84,"Princes Park",45,1932,"Regular",12,"Home","Carlton","Fitzroy",45
2941,1932-07-23,"R12","Collingwood",14,10,94,"Hawthorn",10,10,70,"Victoria Park",24,1932,"Regular",12,"Home","Collingwood","Hawthorn",24
2942,1932-07-23,"R12","Footscray",11,16,82,"Essendon",10,9,69,"Western Oval",13,1932,"Regular",12,"Home","Footscray","Essendon",13
2943,1932-07-23,"R12","North Melbourne",6,14,50,"Geelong",14,10,94,"Arden St",-44,1932,"Regular",12,"Away","Geelong","North Melbourne",44
2944,1932-07-23,"R12","Melbourne",12,12,84,"Sydney",13,15,93,"M.C.G.",-9,1932,"Regular",12,"Away","Sydney","Melbourne",9
2945,1932-07-23,"R12","St Kilda",7,12,54,"Richmond",12,13,85,"Junction Oval",-31,1932,"Regular",12,"Away","Richmond","St Kilda",31
2946,1932-07-30,"R13","Sydney",11,14,80,"Carlton",12,17,89,"Lake Oval",-9,1932,"Regular",13,"Away","Carlton","Sydney",9
2947,1932-07-30,"R13","Geelong",13,17,95,"Collingwood",10,10,70,"Corio Oval",25,1932,"Regular",13,"Home","Geelong","Collingwood",25
2948,1932-07-30,"R13","Essendon",14,14,98,"North Melbourne",15,2,92,"Windy Hill",6,1932,"Regular",13,"Home","Essendon","North Melbourne",6
2949,1932-07-30,"R13","Fitzroy",6,13,49,"Footscray",10,14,74,"Brunswick St",-25,1932,"Regular",13,"Away","Footscray","Fitzroy",25
2950,1932-07-30,"R13","Hawthorn",8,13,61,"St Kilda",7,8,50,"Glenferrie Oval",11,1932,"Regular",13,"Home","Hawthorn","St Kilda",11
2951,1932-07-30,"R13","Richmond",12,18,90,"Melbourne",10,6,66,"Punt Rd",24,1932,"Regular",13,"Home","Richmond","Melbourne",24
2952,1932-08-06,"R14","Carlton",12,14,86,"Richmond",13,13,91,"Princes Park",-5,1932,"Regular",14,"Away","Richmond","Carlton",5
2953,1932-08-06,"R14","Collingwood",14,15,99,"Essendon",9,13,67,"Victoria Park",32,1932,"Regular",14,"Home","Collingwood","Essendon",32
2954,1932-08-06,"R14","North Melbourne",12,17,89,"Fitzroy",10,8,68,"Arden St",21,1932,"Regular",14,"Home","North Melbourne","Fitzroy",21
2955,1932-08-06,"R14","Footscray",11,14,80,"Sydney",9,14,68,"Western Oval",12,1932,"Regular",14,"Home","Footscray","Sydney",12
2956,1932-08-06,"R14","St Kilda",15,19,109,"Geelong",13,18,96,"Junction Oval",13,1932,"Regular",14,"Home","St Kilda","Geelong",13
2957,1932-08-06,"R14","Melbourne",12,4,76,"Hawthorn",10,12,72,"M.C.G.",4,1932,"Regular",14,"Home","Melbourne","Hawthorn",4
2958,1932-08-13,"R15","Hawthorn",8,14,62,"Carlton",12,12,84,"Glenferrie Oval",-22,1932,"Regular",15,"Away","Carlton","Hawthorn",22
2959,1932-08-13,"R15","Fitzroy",11,13,79,"Collingwood",12,26,98,"Brunswick St",-19,1932,"Regular",15,"Away","Collingwood","Fitzroy",19
2960,1932-08-13,"R15","Essendon",14,13,97,"St Kilda",8,10,58,"Windy Hill",39,1932,"Regular",15,"Home","Essendon","St Kilda",39
2961,1932-08-13,"R15","Richmond",9,11,65,"Footscray",8,12,60,"Punt Rd",5,1932,"Regular",15,"Home","Richmond","Footscray",5
2962,1932-08-13,"R15","Geelong",15,14,104,"Melbourne",5,13,43,"Corio Oval",61,1932,"Regular",15,"Home","Geelong","Melbourne",61
2963,1932-08-13,"R15","Sydney",9,13,67,"North Melbourne",4,11,35,"Lake Oval",32,1932,"Regular",15,"Home","Sydney","North Melbourne",32
2964,1932-08-20,"R16","Collingwood",11,13,79,"Carlton",17,23,125,"Victoria Park",-46,1932,"Regular",16,"Away","Carlton","Collingwood",46
2965,1932-08-20,"R16","Essendon",13,12,90,"Sydney",11,20,86,"Windy Hill",4,1932,"Regular",16,"Home","Essendon","Sydney",4
2966,1932-08-20,"R16","Geelong",25,18,168,"Fitzroy",8,6,54,"Corio Oval",114,1932,"Regular",16,"Home","Geelong","Fitzroy",114
2967,1932-08-20,"R16","St Kilda",10,5,65,"Footscray",9,17,71,"Junction Oval",-6,1932,"Regular",16,"Away","Footscray","St Kilda",6
2968,1932-08-20,"R16","Hawthorn",6,9,45,"Richmond",16,16,112,"Glenferrie Oval",-67,1932,"Regular",16,"Away","Richmond","Hawthorn",67
2969,1932-08-20,"R16","Melbourne",14,9,93,"North Melbourne",16,22,118,"M.C.G.",-25,1932,"Regular",16,"Away","North Melbourne","Melbourne",25
2970,1932-08-27,"R17","Carlton",15,15,105,"Melbourne",9,9,63,"Princes Park",42,1932,"Regular",17,"Home","Carlton","Melbourne",42
2971,1932-08-27,"R17","Footscray",9,12,66,"Collingwood",11,5,71,"Western Oval",-5,1932,"Regular",17,"Away","Collingwood","Footscray",5
2972,1932-08-27,"R17","Fitzroy",12,17,89,"Essendon",7,10,52,"Brunswick St",37,1932,"Regular",17,"Home","Fitzroy","Essendon",37
2973,1932-08-27,"R17","Richmond",13,8,86,"Geelong",9,20,74,"Punt Rd",12,1932,"Regular",17,"Home","Richmond","Geelong",12
2974,1932-08-27,"R17","Sydney",24,13,157,"Hawthorn",4,10,34,"Lake Oval",123,1932,"Regular",17,"Home","Sydney","Hawthorn",123
2975,1932-08-27,"R17","North Melbourne",14,21,105,"St Kilda",13,7,85,"Arden St",20,1932,"Regular",17,"Home","North Melbourne","St Kilda",20
2976,1932-09-03,"R18","St Kilda",7,12,54,"Carlton",20,21,141,"Junction Oval",-87,1932,"Regular",18,"Away","Carlton","St Kilda",87
2977,1932-09-03,"R18","Melbourne",13,12,90,"Collingwood",16,17,113,"M.C.G.",-23,1932,"Regular",18,"Away","Collingwood","Melbourne",23
2978,1932-09-03,"R18","Essendon",11,15,81,"Hawthorn",4,10,34,"Windy Hill",47,1932,"Regular",18,"Home","Essendon","Hawthorn",47
2979,1932-09-03,"R18","Fitzroy",10,7,67,"Richmond",14,11,95,"Brunswick St",-28,1932,"Regular",18,"Away","Richmond","Fitzroy",28
2980,1932-09-03,"R18","Footscray",9,10,64,"North Melbourne",12,18,90,"Western Oval",-26,1932,"Regular",18,"Away","North Melbourne","Footscray",26
2981,1932-09-03,"R18","Geelong",17,23,125,"Sydney",9,15,69,"Corio Oval",56,1932,"Regular",18,"Home","Geelong","Sydney",56
2982,1932-09-10,"SF","Collingwood",17,12,114,"Sydney",12,16,88,"M.C.G.",26,1932,"Finals",19,"Home","Collingwood","Sydney",26
2983,1932-09-17,"SF","Carlton",14,15,99,"Richmond",18,16,124,"M.C.G.",-25,1932,"Finals",19,"Away","Richmond","Carlton",25
2984,1932-09-24,"PF","Carlton",23,19,157,"Collingwood",11,16,82,"M.C.G.",75,1932,"Finals",20,"Home","Carlton","Collingwood",75
2985,1932-10-01,"GF","Carlton",12,11,83,"Richmond",13,14,92,"M.C.G.",-9,1932,"Finals",21,"Away","Richmond","Carlton",9
2986,1933-04-29,"R1","Carlton",12,15,87,"Sydney",11,17,83,"Princes Park",4,1933,"Regular",1,"Home","Carlton","Sydney",4
2987,1933-04-29,"R1","Collingwood",14,15,99,"Geelong",12,17,89,"Victoria Park",10,1933,"Regular",1,"Home","Collingwood","Geelong",10
2988,1933-04-29,"R1","Footscray",11,11,77,"Essendon",10,11,71,"Western Oval",6,1933,"Regular",1,"Home","Footscray","Essendon",6
2989,1933-04-29,"R1","North Melbourne",11,13,79,"Fitzroy",11,13,79,"Arden St",0,1933,"Regular",1,"Home","North Melbourne","Fitzroy",0
2990,1933-04-29,"R1","St Kilda",10,17,77,"Hawthorn",11,13,79,"Junction Oval",-2,1933,"Regular",1,"Away","Hawthorn","St Kilda",2
2991,1933-04-29,"R1","Melbourne",9,10,64,"Richmond",14,12,96,"M.C.G.",-32,1933,"Regular",1,"Away","Richmond","Melbourne",32
2992,1933-05-06,"R2","Hawthorn",10,12,72,"Carlton",11,14,80,"Glenferrie Oval",-8,1933,"Regular",2,"Away","Carlton","Hawthorn",8
2993,1933-05-06,"R2","Fitzroy",16,10,106,"Collingwood",11,15,81,"Brunswick St",25,1933,"Regular",2,"Home","Fitzroy","Collingwood",25
2994,1933-05-06,"R2","Essendon",13,13,91,"St Kilda",12,6,78,"Windy Hill",13,1933,"Regular",2,"Home","Essendon","St Kilda",13
2995,1933-05-06,"R2","Sydney",18,17,125,"Footscray",14,15,99,"Lake Oval",26,1933,"Regular",2,"Home","Sydney","Footscray",26
2996,1933-05-06,"R2","Geelong",13,12,90,"Melbourne",11,6,72,"Corio Oval",18,1933,"Regular",2,"Home","Geelong","Melbourne",18
2997,1933-05-06,"R2","Richmond",24,16,160,"North Melbourne",9,12,66,"Punt Rd",94,1933,"Regular",2,"Home","Richmond","North Melbourne",94
2998,1933-05-13,"R3","Carlton",8,9,57,"Geelong",13,16,94,"Princes Park",-37,1933,"Regular",3,"Away","Geelong","Carlton",37
2999,1933-05-13,"R3","Collingwood",10,11,71,"Sydney",9,3,57,"Victoria Park",14,1933,"Regular",3,"Home","Collingwood","Sydney",14
3000,1933-05-13,"R3","Melbourne",15,9,99,"Essendon",10,10,70,"M.C.G.",29,1933,"Regular",3,"Home","Melbourne","Essendon",29
3001,1933-05-13,"R3","St Kilda",9,5,59,"Fitzroy",21,17,143,"Junction Oval",-84,1933,"Regular",3,"Away","Fitzroy","St Kilda",84
3002,1933-05-13,"R3","Footscray",6,14,50,"Richmond",4,10,34,"Western Oval",16,1933,"Regular",3,"Home","Footscray","Richmond",16
3003,1933-05-13,"R3","North Melbourne",10,15,75,"Hawthorn",10,7,67,"Arden St",8,1933,"Regular",3,"Home","North Melbourne","Hawthorn",8
3004,1933-05-20,"R4","Essendon",11,10,76,"Carlton",13,18,96,"Windy Hill",-20,1933,"Regular",4,"Away","Carlton","Essendon",20
3005,1933-05-20,"R4","Richmond",13,15,93,"Collingwood",11,8,74,"Punt Rd",19,1933,"Regular",4,"Home","Richmond","Collingwood",19
3006,1933-05-20,"R4","Fitzroy",11,16,82,"Melbourne",11,13,79,"Brunswick St",3,1933,"Regular",4,"Home","Fitzroy","Melbourne",3
3007,1933-05-20,"R4","Hawthorn",7,15,57,"Footscray",14,10,94,"Glenferrie Oval",-37,1933,"Regular",4,"Away","Footscray","Hawthorn",37
3008,1933-05-20,"R4","Geelong",17,20,122,"North Melbourne",11,12,78,"Corio Oval",44,1933,"Regular",4,"Home","Geelong","North Melbourne",44
3009,1933-05-20,"R4","Sydney",11,14,80,"St Kilda",10,16,76,"Lake Oval",4,1933,"Regular",4,"Home","Sydney","St Kilda",4
3010,1933-05-27,"R5","Collingwood",14,20,104,"Carlton",14,16,100,"Victoria Park",4,1933,"Regular",5,"Home","Collingwood","Carlton",4
3011,1933-05-27,"R5","Essendon",12,11,83,"Sydney",17,15,117,"Windy Hill",-34,1933,"Regular",5,"Away","Sydney","Essendon",34
3012,1933-05-27,"R5","Geelong",18,15,123,"Fitzroy",2,7,19,"Corio Oval",104,1933,"Regular",5,"Home","Geelong","Fitzroy",104
3013,1933-05-27,"R5","Melbourne",10,17,77,"Footscray",14,13,97,"M.C.G.",-20,1933,"Regular",5,"Away","Footscray","Melbourne",20
3014,1933-05-27,"R5","Hawthorn",7,14,56,"Richmond",9,9,63,"Glenferrie Oval",-7,1933,"Regular",5,"Away","Richmond","Hawthorn",7
3015,1933-05-27,"R5","St Kilda",13,19,97,"North Melbourne",11,17,83,"Junction Oval",14,1933,"Regular",5,"Home","St Kilda","North Melbourne",14
3016,1933-06-03,"R6","Fitzroy",19,11,125,"Essendon",14,9,93,"Brunswick St",32,1933,"Regular",6,"Home","Fitzroy","Essendon",32
3017,1933-06-03,"R6","Richmond",13,10,88,"Geelong",10,11,71,"Punt Rd",17,1933,"Regular",6,"Home","Richmond","Geelong",17
3018,1933-06-03,"R6","Sydney",10,13,73,"Hawthorn",9,6,60,"Lake Oval",13,1933,"Regular",6,"Home","Sydney","Hawthorn",13
3019,1933-06-05,"R6","Carlton",13,13,91,"Melbourne",12,15,87,"Princes Park",4,1933,"Regular",6,"Home","Carlton","Melbourne",4
3020,1933-06-05,"R6","North Melbourne",17,11,113,"Collingwood",14,13,97,"Arden St",16,1933,"Regular",6,"Home","North Melbourne","Collingwood",16
3021,1933-06-05,"R6","Footscray",12,11,83,"St Kilda",9,16,70,"Western Oval",13,1933,"Regular",6,"Home","Footscray","St Kilda",13
3022,1933-06-10,"R7","St Kilda",10,5,65,"Carlton",20,10,130,"Junction Oval",-65,1933,"Regular",7,"Away","Carlton","St Kilda",65
3023,1933-06-10,"R7","Melbourne",13,19,97,"Collingwood",18,18,126,"M.C.G.",-29,1933,"Regular",7,"Away","Collingwood","Melbourne",29
3024,1933-06-10,"R7","Essendon",15,6,96,"Hawthorn",16,9,105,"Windy Hill",-9,1933,"Regular",7,"Away","Hawthorn","Essendon",9
3025,1933-06-10,"R7","Fitzroy",8,17,65,"Richmond",10,13,73,"Brunswick St",-8,1933,"Regular",7,"Away","Richmond","Fitzroy",8
3026,1933-06-10,"R7","North Melbourne",11,12,78,"Footscray",8,14,62,"Arden St",16,1933,"Regular",7,"Home","North Melbourne","Footscray",16
3027,1933-06-10,"R7","Geelong",17,14,116,"Sydney",13,15,93,"Corio Oval",23,1933,"Regular",7,"Home","Geelong","Sydney",23
3028,1933-06-17,"R8","Carlton",21,13,139,"Footscray",17,14,116,"Princes Park",23,1933,"Regular",8,"Home","Carlton","Footscray",23
3029,1933-06-17,"R8","Collingwood",14,23,107,"St Kilda",8,15,63,"Victoria Park",44,1933,"Regular",8,"Home","Collingwood","St Kilda",44
3030,1933-06-17,"R8","Essendon",8,11,59,"Geelong",17,15,117,"Windy Hill",-58,1933,"Regular",8,"Away","Geelong","Essendon",58
3031,1933-06-17,"R8","Hawthorn",9,14,68,"Fitzroy",11,13,79,"Glenferrie Oval",-11,1933,"Regular",8,"Away","Fitzroy","Hawthorn",11
3032,1933-06-17,"R8","Melbourne",9,15,69,"North Melbourne",14,9,93,"M.C.G.",-24,1933,"Regular",8,"Away","North Melbourne","Melbourne",24
3033,1933-06-17,"R8","Sydney",15,13,103,"Richmond",16,12,108,"Lake Oval",-5,1933,"Regular",8,"Away","Richmond","Sydney",5
3034,1933-06-24,"R9","North Melbourne",6,17,53,"Carlton",11,14,80,"Arden St",-27,1933,"Regular",9,"Away","Carlton","North Melbourne",27
3035,1933-06-24,"R9","Footscray",9,11,65,"Collingwood",7,18,60,"Western Oval",5,1933,"Regular",9,"Home","Footscray","Collingwood",5
3036,1933-06-24,"R9","Richmond",16,14,110,"Essendon",8,11,59,"Punt Rd",51,1933,"Regular",9,"Home","Richmond","Essendon",51
3037,1933-06-24,"R9","Fitzroy",15,7,97,"Sydney",11,12,78,"Brunswick St",19,1933,"Regular",9,"Home","Fitzroy","Sydney",19
3038,1933-06-24,"R9","Geelong",18,25,133,"Hawthorn",3,6,24,"Corio Oval",109,1933,"Regular",9,"Home","Geelong","Hawthorn",109
3039,1933-06-24,"R9","St Kilda",13,12,90,"Melbourne",3,15,33,"Junction Oval",57,1933,"Regular",9,"Home","St Kilda","Melbourne",57
3040,1933-07-01,"R10","Fitzroy",5,19,49,"Carlton",13,14,92,"Brunswick St",-43,1933,"Regular",10,"Away","Carlton","Fitzroy",43
3041,1933-07-01,"R10","Hawthorn",5,14,44,"Collingwood",15,6,96,"Glenferrie Oval",-52,1933,"Regular",10,"Away","Collingwood","Hawthorn",52
3042,1933-07-01,"R10","Essendon",9,21,75,"North Melbourne",15,18,108,"Windy Hill",-33,1933,"Regular",10,"Away","North Melbourne","Essendon",33
3043,1933-07-01,"R10","Geelong",11,16,82,"Footscray",7,15,57,"Corio Oval",25,1933,"Regular",10,"Home","Geelong","Footscray",25
3044,1933-07-01,"R10","Sydney",13,10,88,"Melbourne",12,9,81,"Lake Oval",7,1933,"Regular",10,"Home","Sydney","Melbourne",7
3045,1933-07-01,"R10","Richmond",16,14,110,"St Kilda",8,8,56,"Punt Rd",54,1933,"Regular",10,"Home","Richmond","St Kilda",54
3046,1933-07-08,"R11","Carlton",10,10,70,"Richmond",9,13,67,"Princes Park",3,1933,"Regular",11,"Home","Carlton","Richmond",3
3047,1933-07-08,"R11","Collingwood",20,19,139,"Essendon",14,14,98,"Victoria Park",41,1933,"Regular",11,"Home","Collingwood","Essendon",41
3048,1933-07-08,"R11","Footscray",15,6,96,"Fitzroy",8,14,62,"Western Oval",34,1933,"Regular",11,"Home","Footscray","Fitzroy",34
3049,1933-07-08,"R11","St Kilda",11,14,80,"Geelong",7,13,55,"Junction Oval",25,1933,"Regular",11,"Home","St Kilda","Geelong",25
3050,1933-07-08,"R11","Melbourne",21,10,136,"Hawthorn",15,8,98,"M.C.G.",38,1933,"Regular",11,"Home","Melbourne","Hawthorn",38
3051,1933-07-08,"R11","North Melbourne",13,12,90,"Sydney",15,13,103,"Arden St",-13,1933,"Regular",11,"Away","Sydney","North Melbourne",13
3052,1933-07-15,"R12","Sydney",15,13,103,"Carlton",9,6,60,"Lake Oval",43,1933,"Regular",12,"Home","Sydney","Carlton",43
3053,1933-07-15,"R12","Geelong",13,18,96,"Collingwood",9,7,61,"Corio Oval",35,1933,"Regular",12,"Home","Geelong","Collingwood",35
3054,1933-07-15,"R12","Essendon",14,7,91,"Footscray",15,13,103,"Windy Hill",-12,1933,"Regular",12,"Away","Footscray","Essendon",12
3055,1933-07-15,"R12","Fitzroy",17,16,118,"North Melbourne",11,9,75,"Brunswick St",43,1933,"Regular",12,"Home","Fitzroy","North Melbourne",43
3056,1933-07-15,"R12","Hawthorn",7,9,51,"St Kilda",8,15,63,"Glenferrie Oval",-12,1933,"Regular",12,"Away","St Kilda","Hawthorn",12
3057,1933-07-15,"R12","Richmond",20,15,135,"Melbourne",12,13,85,"Punt Rd",50,1933,"Regular",12,"Home","Richmond","Melbourne",50
3058,1933-07-22,"R13","Carlton",13,20,98,"Hawthorn",10,14,74,"Princes Park",24,1933,"Regular",13,"Home","Carlton","Hawthorn",24
3059,1933-07-22,"R13","Collingwood",7,21,63,"Fitzroy",9,10,64,"Victoria Park",-1,1933,"Regular",13,"Away","Fitzroy","Collingwood",1
3060,1933-07-22,"R13","St Kilda",12,20,92,"Essendon",13,9,87,"Junction Oval",5,1933,"Regular",13,"Home","St Kilda","Essendon",5
3061,1933-07-22,"R13","Footscray",8,11,59,"Sydney",19,15,129,"Western Oval",-70,1933,"Regular",13,"Away","Sydney","Footscray",70
3062,1933-07-22,"R13","Melbourne",12,16,88,"Geelong",18,15,123,"M.C.G.",-35,1933,"Regular",13,"Away","Geelong","Melbourne",35
3063,1933-07-22,"R13","North Melbourne",8,8,56,"Richmond",20,11,131,"Arden St",-75,1933,"Regular",13,"Away","Richmond","North Melbourne",75
3064,1933-07-29,"R14","Geelong",17,15,117,"Carlton",5,14,44,"Corio Oval",73,1933,"Regular",14,"Home","Geelong","Carlton",73
3065,1933-07-29,"R14","Sydney",13,11,89,"Collingwood",12,11,83,"Lake Oval",6,1933,"Regular",14,"Home","Sydney","Collingwood",6
3066,1933-07-29,"R14","Essendon",14,7,91,"Melbourne",15,16,106,"Windy Hill",-15,1933,"Regular",14,"Away","Melbourne","Essendon",15
3067,1933-07-29,"R14","Fitzroy",19,10,124,"St Kilda",6,9,45,"Brunswick St",79,1933,"Regular",14,"Home","Fitzroy","St Kilda",79
3068,1933-07-29,"R14","Richmond",18,16,124,"Footscray",9,11,65,"Punt Rd",59,1933,"Regular",14,"Home","Richmond","Footscray",59
3069,1933-07-29,"R14","Hawthorn",9,8,62,"North Melbourne",10,14,74,"Glenferrie Oval",-12,1933,"Regular",14,"Away","North Melbourne","Hawthorn",12
3070,1933-08-05,"R15","Carlton",14,22,106,"Essendon",9,9,63,"Princes Park",43,1933,"Regular",15,"Home","Carlton","Essendon",43
3071,1933-08-05,"R15","Collingwood",15,16,106,"Richmond",10,8,68,"Victoria Park",38,1933,"Regular",15,"Home","Collingwood","Richmond",38
3072,1933-08-05,"R15","Melbourne",9,15,69,"Fitzroy",13,8,86,"M.C.G.",-17,1933,"Regular",15,"Away","Fitzroy","Melbourne",17
3073,1933-08-05,"R15","Footscray",16,14,110,"Hawthorn",9,18,72,"Western Oval",38,1933,"Regular",15,"Home","Footscray","Hawthorn",38
3074,1933-08-05,"R15","North Melbourne",9,7,61,"Geelong",15,10,100,"Arden St",-39,1933,"Regular",15,"Away","Geelong","North Melbourne",39
3075,1933-08-05,"R15","St Kilda",8,19,67,"Sydney",13,15,93,"Junction Oval",-26,1933,"Regular",15,"Away","Sydney","St Kilda",26
3076,1933-08-19,"R16","Carlton",14,8,92,"Collingwood",15,11,101,"Princes Park",-9,1933,"Regular",16,"Away","Collingwood","Carlton",9
3077,1933-08-19,"R16","Sydney",11,16,82,"Essendon",6,4,40,"Lake Oval",42,1933,"Regular",16,"Home","Sydney","Essendon",42
3078,1933-08-19,"R16","Fitzroy",15,8,98,"Geelong",11,20,86,"Brunswick St",12,1933,"Regular",16,"Home","Fitzroy","Geelong",12
3079,1933-08-19,"R16","Footscray",19,10,124,"Melbourne",14,10,94,"Western Oval",30,1933,"Regular",16,"Home","Footscray","Melbourne",30
3080,1933-08-19,"R16","Richmond",11,17,83,"Hawthorn",9,6,60,"Punt Rd",23,1933,"Regular",16,"Home","Richmond","Hawthorn",23
3081,1933-08-19,"R16","North Melbourne",15,17,107,"St Kilda",10,12,72,"Arden St",35,1933,"Regular",16,"Home","North Melbourne","St Kilda",35
3082,1933-08-26,"R17","Melbourne",10,11,71,"Carlton",19,21,135,"M.C.G.",-64,1933,"Regular",17,"Away","Carlton","Melbourne",64
3083,1933-08-26,"R17","Collingwood",25,15,165,"North Melbourne",17,19,121,"Victoria Park",44,1933,"Regular",17,"Home","Collingwood","North Melbourne",44
3084,1933-08-26,"R17","Essendon",12,13,85,"Fitzroy",10,17,77,"Windy Hill",8,1933,"Regular",17,"Home","Essendon","Fitzroy",8
3085,1933-08-26,"R17","St Kilda",21,11,137,"Footscray",14,21,105,"Junction Oval",32,1933,"Regular",17,"Home","St Kilda","Footscray",32
3086,1933-08-26,"R17","Geelong",10,10,70,"Richmond",14,10,94,"Corio Oval",-24,1933,"Regular",17,"Away","Richmond","Geelong",24
3087,1933-08-26,"R17","Hawthorn",8,12,60,"Sydney",17,11,113,"Glenferrie Oval",-53,1933,"Regular",17,"Away","Sydney","Hawthorn",53
3088,1933-09-02,"R18","Carlton",20,25,145,"St Kilda",14,9,93,"Princes Park",52,1933,"Regular",18,"Home","Carlton","St Kilda",52
3089,1933-09-02,"R18","Collingwood",19,13,127,"Melbourne",15,14,104,"Victoria Park",23,1933,"Regular",18,"Home","Collingwood","Melbourne",23
3090,1933-09-02,"R18","Hawthorn",10,9,69,"Essendon",8,16,64,"Glenferrie Oval",5,1933,"Regular",18,"Home","Hawthorn","Essendon",5
3091,1933-09-02,"R18","Richmond",16,13,109,"Fitzroy",9,7,61,"Punt Rd",48,1933,"Regular",18,"Home","Richmond","Fitzroy",48
3092,1933-09-02,"R18","Footscray",7,16,58,"North Melbourne",6,17,53,"Western Oval",5,1933,"Regular",18,"Home","Footscray","North Melbourne",5
3093,1933-09-02,"R18","Sydney",23,17,155,"Geelong",6,10,46,"Lake Oval",109,1933,"Regular",18,"Home","Sydney","Geelong",109
3094,1933-09-09,"SF","Carlton",10,11,71,"Geelong",12,12,84,"M.C.G.",-13,1933,"Finals",19,"Away","Geelong","Carlton",13
3095,1933-09-16,"SF","Richmond",11,11,77,"Sydney",14,11,95,"M.C.G.",-18,1933,"Finals",19,"Away","Sydney","Richmond",18
3096,1933-09-23,"PF","Richmond",13,5,83,"Geelong",10,14,74,"M.C.G.",9,1933,"Finals",20,"Home","Richmond","Geelong",9
3097,1933-09-30,"GF","Richmond",4,5,29,"Sydney",9,17,71,"M.C.G.",-42,1933,"Finals",21,"Away","Sydney","Richmond",42
3098,1934-05-05,"R1","Hawthorn",12,8,80,"Carlton",17,26,128,"Glenferrie Oval",-48,1934,"Regular",1,"Away","Carlton","Hawthorn",48
3099,1934-05-05,"R1","Sydney",19,13,127,"Collingwood",13,14,92,"Lake Oval",35,1934,"Regular",1,"Home","Sydney","Collingwood",35
3100,1934-05-05,"R1","Essendon",19,11,125,"Footscray",16,18,114,"Windy Hill",11,1934,"Regular",1,"Home","Essendon","Footscray",11
3101,1934-05-05,"R1","Fitzroy",11,16,82,"North Melbourne",10,11,71,"Brunswick St",11,1934,"Regular",1,"Home","Fitzroy","North Melbourne",11
3102,1934-05-05,"R1","Geelong",16,13,109,"St Kilda",11,7,73,"Corio Oval",36,1934,"Regular",1,"Home","Geelong","St Kilda",36
3103,1934-05-05,"R1","Richmond",18,14,122,"Melbourne",12,9,81,"Punt Rd",41,1934,"Regular",1,"Home","Richmond","Melbourne",41
3104,1934-05-12,"R2","Carlton",17,20,122,"Sydney",17,17,119,"Princes Park",3,1934,"Regular",2,"Home","Carlton","Sydney",3
3105,1934-05-12,"R2","Collingwood",17,12,114,"Essendon",13,8,86,"Victoria Park",28,1934,"Regular",2,"Home","Collingwood","Essendon",28
3106,1934-05-12,"R2","Footscray",14,12,96,"Fitzroy",9,18,72,"Western Oval",24,1934,"Regular",2,"Home","Footscray","Fitzroy",24
3107,1934-05-12,"R2","North Melbourne",10,10,70,"Geelong",10,17,77,"Arden St",-7,1934,"Regular",2,"Away","Geelong","North Melbourne",7
3108,1934-05-12,"R2","Melbourne",20,13,133,"Hawthorn",6,8,44,"M.C.G.",89,1934,"Regular",2,"Home","Melbourne","Hawthorn",89
3109,1934-05-12,"R2","St Kilda",12,11,83,"Richmond",13,9,87,"Junction Oval",-4,1934,"Regular",2,"Away","Richmond","St Kilda",4
3110,1934-05-19,"R3","Richmond",14,20,104,"Carlton",9,13,67,"Punt Rd",37,1934,"Regular",3,"Home","Richmond","Carlton",37
3111,1934-05-19,"R3","Hawthorn",9,8,62,"Collingwood",19,15,129,"Glenferrie Oval",-67,1934,"Regular",3,"Away","Collingwood","Hawthorn",67
3112,1934-05-19,"R3","Sydney",23,10,148,"Essendon",15,16,106,"Lake Oval",42,1934,"Regular",3,"Home","Sydney","Essendon",42
3113,1934-05-19,"R3","Fitzroy",11,14,80,"St Kilda",13,15,93,"Brunswick St",-13,1934,"Regular",3,"Away","St Kilda","Fitzroy",13
3114,1934-05-19,"R3","North Melbourne",8,14,62,"Footscray",10,17,77,"Arden St",-15,1934,"Regular",3,"Away","Footscray","North Melbourne",15
3115,1934-05-19,"R3","Geelong",12,14,86,"Melbourne",6,11,47,"Corio Oval",39,1934,"Regular",3,"Home","Geelong","Melbourne",39
3116,1934-05-26,"R4","Carlton",15,14,104,"Geelong",14,10,94,"Princes Park",10,1934,"Regular",4,"Home","Carlton","Geelong",10
3117,1934-05-26,"R4","Collingwood",13,13,91,"Richmond",9,9,63,"Victoria Park",28,1934,"Regular",4,"Home","Collingwood","Richmond",28
3118,1934-05-26,"R4","Essendon",15,13,103,"Hawthorn",13,11,89,"Windy Hill",14,1934,"Regular",4,"Home","Essendon","Hawthorn",14
3119,1934-05-26,"R4","Melbourne",9,11,65,"Fitzroy",8,11,59,"M.C.G.",6,1934,"Regular",4,"Home","Melbourne","Fitzroy",6
3120,1934-05-26,"R4","Footscray",12,12,84,"Sydney",17,18,120,"Western Oval",-36,1934,"Regular",4,"Away","Sydney","Footscray",36
3121,1934-05-26,"R4","St Kilda",14,18,102,"North Melbourne",10,20,80,"Junction Oval",22,1934,"Regular",4,"Home","St Kilda","North Melbourne",22
3122,1934-06-02,"R5","Fitzroy",15,12,102,"Carlton",12,15,87,"Brunswick St",15,1934,"Regular",5,"Home","Fitzroy","Carlton",15
3123,1934-06-02,"R5","St Kilda",22,23,155,"Footscray",11,18,84,"Junction Oval",71,1934,"Regular",5,"Home","St Kilda","Footscray",71
3124,1934-06-02,"R5","Hawthorn",13,14,92,"Sydney",22,12,144,"Glenferrie Oval",-52,1934,"Regular",5,"Away","Sydney","Hawthorn",52
3125,1934-06-04,"R5","Geelong",16,13,109,"Collingwood",16,13,109,"Corio Oval",0,1934,"Regular",5,"Home","Geelong","Collingwood",0
3126,1934-06-04,"R5","Richmond",15,12,102,"Essendon",12,8,80,"Punt Rd",22,1934,"Regular",5,"Home","Richmond","Essendon",22
3127,1934-06-04,"R5","North Melbourne",17,14,116,"Melbourne",15,28,118,"Arden St",-2,1934,"Regular",5,"Away","Melbourne","North Melbourne",2
3128,1934-06-09,"R6","Carlton",20,25,145,"North Melbourne",12,11,83,"Princes Park",62,1934,"Regular",6,"Home","Carlton","North Melbourne",62
3129,1934-06-09,"R6","Collingwood",16,15,111,"Fitzroy",13,18,96,"Victoria Park",15,1934,"Regular",6,"Home","Collingwood","Fitzroy",15
3130,1934-06-09,"R6","Essendon",14,11,95,"Geelong",11,16,82,"Windy Hill",13,1934,"Regular",6,"Home","Essendon","Geelong",13
3131,1934-06-09,"R6","Hawthorn",11,11,77,"Footscray",10,11,71,"Glenferrie Oval",6,1934,"Regular",6,"Home","Hawthorn","Footscray",6
3132,1934-06-09,"R6","Melbourne",14,17,101,"St Kilda",20,14,134,"M.C.G.",-33,1934,"Regular",6,"Away","St Kilda","Melbourne",33
3133,1934-06-09,"R6","Sydney",9,10,64,"Richmond",16,12,108,"Lake Oval",-44,1934,"Regular",6,"Away","Richmond","Sydney",44
3134,1934-06-23,"R7","St Kilda",16,12,108,"Carlton",24,22,166,"Junction Oval",-58,1934,"Regular",7,"Away","Carlton","St Kilda",58
3135,1934-06-23,"R7","North Melbourne",12,14,86,"Collingwood",16,16,112,"Arden St",-26,1934,"Regular",7,"Away","Collingwood","North Melbourne",26
3136,1934-06-23,"R7","Fitzroy",15,12,102,"Essendon",14,13,97,"Brunswick St",5,1934,"Regular",7,"Home","Fitzroy","Essendon",5
3137,1934-06-23,"R7","Footscray",6,8,44,"Melbourne",13,13,91,"Western Oval",-47,1934,"Regular",7,"Away","Melbourne","Footscray",47
3138,1934-06-23,"R7","Geelong",15,16,106,"Sydney",11,11,77,"Corio Oval",29,1934,"Regular",7,"Home","Geelong","Sydney",29
3139,1934-06-23,"R7","Richmond",16,14,110,"Hawthorn",11,15,81,"Punt Rd",29,1934,"Regular",7,"Home","Richmond","Hawthorn",29
3140,1934-06-30,"R8","Carlton",19,20,134,"Melbourne",11,19,85,"Princes Park",49,1934,"Regular",8,"Home","Carlton","Melbourne",49
3141,1934-06-30,"R8","Collingwood",12,12,84,"St Kilda",10,15,75,"Victoria Park",9,1934,"Regular",8,"Home","Collingwood","St Kilda",9
3142,1934-06-30,"R8","Essendon",29,16,190,"North Melbourne",15,13,103,"Windy Hill",87,1934,"Regular",8,"Home","Essendon","North Melbourne",87
3143,1934-06-30,"R8","Sydney",13,19,97,"Fitzroy",13,10,88,"Lake Oval",9,1934,"Regular",8,"Home","Sydney","Fitzroy",9
3144,1934-06-30,"R8","Richmond",9,10,64,"Footscray",6,12,48,"Punt Rd",16,1934,"Regular",8,"Home","Richmond","Footscray",16
3145,1934-06-30,"R8","Hawthorn",11,12,78,"Geelong",17,17,119,"Glenferrie Oval",-41,1934,"Regular",8,"Away","Geelong","Hawthorn",41
3146,1934-07-07,"R9","Footscray",12,11,83,"Carlton",15,17,107,"Western Oval",-24,1934,"Regular",9,"Away","Carlton","Footscray",24
3147,1934-07-07,"R9","Melbourne",8,15,63,"Collingwood",8,17,65,"M.C.G.",-2,1934,"Regular",9,"Away","Collingwood","Melbourne",2
3148,1934-07-07,"R9","St Kilda",11,8,74,"Essendon",7,16,58,"Junction Oval",16,1934,"Regular",9,"Home","St Kilda","Essendon",16
3149,1934-07-07,"R9","Fitzroy",13,21,99,"Hawthorn",11,13,79,"Brunswick St",20,1934,"Regular",9,"Home","Fitzroy","Hawthorn",20
3150,1934-07-07,"R9","Geelong",7,13,55,"Richmond",4,9,33,"Corio Oval",22,1934,"Regular",9,"Home","Geelong","Richmond",22
3151,1934-07-07,"R9","North Melbourne",7,4,46,"Sydney",20,18,138,"Arden St",-92,1934,"Regular",9,"Away","Sydney","North Melbourne",92
3152,1934-07-14,"R10","Collingwood",13,17,95,"Carlton",10,5,65,"Victoria Park",30,1934,"Regular",10,"Home","Collingwood","Carlton",30
3153,1934-07-14,"R10","Essendon",6,15,51,"Melbourne",8,12,60,"Windy Hill",-9,1934,"Regular",10,"Away","Melbourne","Essendon",9
3154,1934-07-14,"R10","Richmond",10,16,76,"Fitzroy",9,9,63,"Punt Rd",13,1934,"Regular",10,"Home","Richmond","Fitzroy",13
3155,1934-07-14,"R10","Geelong",13,15,93,"Footscray",9,10,64,"Corio Oval",29,1934,"Regular",10,"Home","Geelong","Footscray",29
3156,1934-07-14,"R10","Hawthorn",6,17,53,"North Melbourne",6,12,48,"Glenferrie Oval",5,1934,"Regular",10,"Home","Hawthorn","North Melbourne",5
3157,1934-07-14,"R10","Sydney",15,20,110,"St Kilda",7,4,46,"Lake Oval",64,1934,"Regular",10,"Home","Sydney","St Kilda",64
3158,1934-07-21,"R11","Carlton",22,16,148,"Essendon",16,13,109,"Princes Park",39,1934,"Regular",11,"Home","Carlton","Essendon",39
3159,1934-07-21,"R11","Footscray",14,11,95,"Collingwood",16,9,105,"Western Oval",-10,1934,"Regular",11,"Away","Collingwood","Footscray",10
3160,1934-07-21,"R11","Fitzroy",10,11,71,"Geelong",14,18,102,"Brunswick St",-31,1934,"Regular",11,"Away","Geelong","Fitzroy",31
3161,1934-07-21,"R11","St Kilda",13,10,88,"Hawthorn",10,12,72,"Junction Oval",16,1934,"Regular",11,"Home","St Kilda","Hawthorn",16
3162,1934-07-21,"R11","Melbourne",14,15,99,"Sydney",22,23,155,"M.C.G.",-56,1934,"Regular",11,"Away","Sydney","Melbourne",56
3163,1934-07-21,"R11","North Melbourne",11,12,78,"Richmond",15,9,99,"Arden St",-21,1934,"Regular",11,"Away","Richmond","North Melbourne",21
3164,1934-07-28,"R12","Carlton",22,13,145,"Hawthorn",10,6,66,"Princes Park",79,1934,"Regular",12,"Home","Carlton","Hawthorn",79
3165,1934-07-28,"R12","Collingwood",13,19,97,"Sydney",21,19,145,"Victoria Park",-48,1934,"Regular",12,"Away","Sydney","Collingwood",48
3166,1934-07-28,"R12","Footscray",15,9,99,"Essendon",8,9,57,"Western Oval",42,1934,"Regular",12,"Home","Footscray","Essendon",42
3167,1934-07-28,"R12","North Melbourne",15,8,98,"Fitzroy",21,16,142,"Arden St",-44,1934,"Regular",12,"Away","Fitzroy","North Melbourne",44
3168,1934-07-28,"R12","St Kilda",13,6,84,"Geelong",16,18,114,"Junction Oval",-30,1934,"Regular",12,"Away","Geelong","St Kilda",30
3169,1934-07-28,"R12","Melbourne",13,23,101,"Richmond",14,11,95,"M.C.G.",6,1934,"Regular",12,"Home","Melbourne","Richmond",6
3170,1934-08-04,"R13","Sydney",23,13,151,"Carlton",17,8,110,"Lake Oval",41,1934,"Regular",13,"Home","Sydney","Carlton",41
3171,1934-08-04,"R13","Essendon",15,12,102,"Collingwood",22,18,150,"Windy Hill",-48,1934,"Regular",13,"Away","Collingwood","Essendon",48
3172,1934-08-04,"R13","Fitzroy",10,18,78,"Footscray",10,12,72,"Brunswick St",6,1934,"Regular",13,"Home","Fitzroy","Footscray",6
3173,1934-08-04,"R13","Geelong",18,15,123,"North Melbourne",5,12,42,"Corio Oval",81,1934,"Regular",13,"Home","Geelong","North Melbourne",81
3174,1934-08-04,"R13","Hawthorn",11,7,73,"Melbourne",10,16,76,"Glenferrie Oval",-3,1934,"Regular",13,"Away","Melbourne","Hawthorn",3
3175,1934-08-04,"R13","Richmond",7,25,67,"St Kilda",5,8,38,"Punt Rd",29,1934,"Regular",13,"Home","Richmond","St Kilda",29
3176,1934-08-18,"R14","Carlton",14,12,96,"Richmond",16,13,109,"Princes Park",-13,1934,"Regular",14,"Away","Richmond","Carlton",13
3177,1934-08-18,"R14","Collingwood",23,22,160,"Hawthorn",10,13,73,"Victoria Park",87,1934,"Regular",14,"Home","Collingwood","Hawthorn",87
3178,1934-08-18,"R14","Essendon",9,17,71,"Sydney",22,14,146,"Windy Hill",-75,1934,"Regular",14,"Away","Sydney","Essendon",75
3179,1934-08-18,"R14","St Kilda",13,11,89,"Fitzroy",10,10,70,"Junction Oval",19,1934,"Regular",14,"Home","St Kilda","Fitzroy",19
3180,1934-08-18,"R14","Footscray",10,18,78,"North Melbourne",6,14,50,"Western Oval",28,1934,"Regular",14,"Home","Footscray","North Melbourne",28
3181,1934-08-18,"R14","Melbourne",13,10,88,"Geelong",21,15,141,"M.C.G.",-53,1934,"Regular",14,"Away","Geelong","Melbourne",53
3182,1934-08-25,"R15","Geelong",13,17,95,"Carlton",10,10,70,"Corio Oval",25,1934,"Regular",15,"Home","Geelong","Carlton",25
3183,1934-08-25,"R15","Richmond",12,14,86,"Collingwood",11,9,75,"Punt Rd",11,1934,"Regular",15,"Home","Richmond","Collingwood",11
3184,1934-08-25,"R15","Hawthorn",11,15,81,"Essendon",11,13,79,"Glenferrie Oval",2,1934,"Regular",15,"Home","Hawthorn","Essendon",2
3185,1934-08-25,"R15","Fitzroy",20,19,139,"Melbourne",16,10,106,"Brunswick St",33,1934,"Regular",15,"Home","Fitzroy","Melbourne",33
3186,1934-08-25,"R15","Sydney",23,18,156,"Footscray",9,16,70,"Lake Oval",86,1934,"Regular",15,"Home","Sydney","Footscray",86
3187,1934-08-25,"R15","North Melbourne",11,13,79,"St Kilda",12,12,84,"Arden St",-5,1934,"Regular",15,"Away","St Kilda","North Melbourne",5
3188,1934-09-01,"R16","Carlton",18,12,120,"Fitzroy",9,15,69,"Princes Park",51,1934,"Regular",16,"Home","Carlton","Fitzroy",51
3189,1934-09-01,"R16","Collingwood",16,16,112,"Geelong",16,21,117,"Victoria Park",-5,1934,"Regular",16,"Away","Geelong","Collingwood",5
3190,1934-09-01,"R16","Essendon",13,12,90,"Richmond",15,23,113,"Windy Hill",-23,1934,"Regular",16,"Away","Richmond","Essendon",23
3191,1934-09-01,"R16","Footscray",13,20,98,"St Kilda",10,17,77,"Western Oval",21,1934,"Regular",16,"Home","Footscray","St Kilda",21
3192,1934-09-01,"R16","Sydney",15,11,101,"Hawthorn",10,10,70,"Lake Oval",31,1934,"Regular",16,"Home","Sydney","Hawthorn",31
3193,1934-09-01,"R16","Melbourne",11,24,90,"North Melbourne",7,15,57,"M.C.G.",33,1934,"Regular",16,"Home","Melbourne","North Melbourne",33
3194,1934-09-08,"R17","North Melbourne",8,8,56,"Carlton",7,16,58,"Arden St",-2,1934,"Regular",17,"Away","Carlton","North Melbourne",2
3195,1934-09-08,"R17","Fitzroy",14,17,101,"Collingwood",16,10,106,"Brunswick St",-5,1934,"Regular",17,"Away","Collingwood","Fitzroy",5
3196,1934-09-08,"R17","Geelong",21,31,157,"Essendon",6,5,41,"Corio Oval",116,1934,"Regular",17,"Home","Geelong","Essendon",116
3197,1934-09-08,"R17","Footscray",14,18,102,"Hawthorn",12,7,79,"Western Oval",23,1934,"Regular",17,"Home","Footscray","Hawthorn",23
3198,1934-09-08,"R17","St Kilda",13,12,90,"Melbourne",12,16,88,"Junction Oval",2,1934,"Regular",17,"Home","St Kilda","Melbourne",2
3199,1934-09-08,"R17","Richmond",14,14,98,"Sydney",13,14,92,"Punt Rd",6,1934,"Regular",17,"Home","Richmond","Sydney",6
3200,1934-09-15,"R18","Carlton",16,18,114,"St Kilda",15,9,99,"Princes Park",15,1934,"Regular",18,"Home","Carlton","St Kilda",15
3201,1934-09-15,"R18","Collingwood",15,18,108,"North Melbourne",2,8,20,"Victoria Park",88,1934,"Regular",18,"Home","Collingwood","North Melbourne",88
3202,1934-09-15,"R18","Essendon",14,11,95,"Fitzroy",12,4,76,"Windy Hill",19,1934,"Regular",18,"Home","Essendon","Fitzroy",19
3203,1934-09-15,"R18","Melbourne",19,17,131,"Footscray",9,11,65,"M.C.G.",66,1934,"Regular",18,"Home","Melbourne","Footscray",66
3204,1934-09-15,"R18","Sydney",13,19,97,"Geelong",8,7,55,"Lake Oval",42,1934,"Regular",18,"Home","Sydney","Geelong",42
3205,1934-09-15,"R18","Hawthorn",7,9,51,"Richmond",11,16,82,"Glenferrie Oval",-31,1934,"Regular",18,"Away","Richmond","Hawthorn",31
3206,1934-09-22,"SF","Sydney",11,12,78,"Collingwood",9,21,75,"M.C.G.",3,1934,"Finals",19,"Home","Sydney","Collingwood",3
3207,1934-09-29,"SF","Richmond",19,20,134,"Geelong",7,8,50,"M.C.G.",84,1934,"Finals",19,"Home","Richmond","Geelong",84
3208,1934-10-06,"PF","Geelong",7,6,48,"Sydney",15,18,108,"M.C.G.",-60,1934,"Finals",20,"Away","Sydney","Geelong",60
3209,1934-10-13,"GF","Richmond",19,14,128,"Sydney",12,17,89,"M.C.G.",39,1934,"Finals",21,"Home","Richmond","Sydney",39
3210,1935-04-27,"R1","Carlton",14,18,102,"Geelong",15,18,108,"Princes Park",-6,1935,"Regular",1,"Away","Geelong","Carlton",6
3211,1935-04-27,"R1","Collingwood",15,18,108,"Sydney",15,16,106,"Victoria Park",2,1935,"Regular",1,"Home","Collingwood","Sydney",2
3212,1935-04-27,"R1","Melbourne",15,9,99,"Essendon",24,15,159,"M.C.G.",-60,1935,"Regular",1,"Away","Essendon","Melbourne",60
3213,1935-04-27,"R1","St Kilda",11,14,80,"Fitzroy",14,8,92,"Junction Oval",-12,1935,"Regular",1,"Away","Fitzroy","St Kilda",12
3214,1935-04-27,"R1","Footscray",7,19,61,"Richmond",14,12,96,"Western Oval",-35,1935,"Regular",1,"Away","Richmond","Footscray",35
3215,1935-04-27,"R1","North Melbourne",12,11,83,"Hawthorn",14,3,87,"Arden St",-4,1935,"Regular",1,"Away","Hawthorn","North Melbourne",4
3216,1935-05-04,"R2","Essendon",13,17,95,"St Kilda",13,14,92,"Windy Hill",3,1935,"Regular",2,"Home","Essendon","St Kilda",3
3217,1935-05-04,"R2","Sydney",17,11,113,"Footscray",15,9,99,"Lake Oval",14,1935,"Regular",2,"Home","Sydney","Footscray",14
3218,1935-05-04,"R2","Geelong",14,20,104,"Melbourne",16,6,102,"Corio Oval",2,1935,"Regular",2,"Home","Geelong","Melbourne",2
3219,1935-05-04,"R2","Richmond",14,11,95,"North Melbourne",10,12,72,"Punt Rd",23,1935,"Regular",2,"Home","Richmond","North Melbourne",23
3220,1935-05-06,"R2","Hawthorn",9,6,60,"Carlton",14,27,111,"Glenferrie Oval",-51,1935,"Regular",2,"Away","Carlton","Hawthorn",51
3221,1935-05-06,"R2","Fitzroy",14,9,93,"Collingwood",14,9,93,"Brunswick St",0,1935,"Regular",2,"Home","Fitzroy","Collingwood",0
3222,1935-05-11,"R3","Carlton",11,11,77,"Richmond",10,8,68,"Princes Park",9,1935,"Regular",3,"Home","Carlton","Richmond",9
3223,1935-05-11,"R3","Collingwood",21,17,143,"Essendon",12,11,83,"Victoria Park",60,1935,"Regular",3,"Home","Collingwood","Essendon",60
3224,1935-05-11,"R3","Footscray",7,13,55,"Fitzroy",9,12,66,"Western Oval",-11,1935,"Regular",3,"Away","Fitzroy","Footscray",11
3225,1935-05-11,"R3","St Kilda",18,20,128,"Geelong",18,15,123,"Junction Oval",5,1935,"Regular",3,"Home","St Kilda","Geelong",5
3226,1935-05-11,"R3","Melbourne",15,19,109,"Hawthorn",11,13,79,"M.C.G.",30,1935,"Regular",3,"Home","Melbourne","Hawthorn",30
3227,1935-05-11,"R3","North Melbourne",5,14,44,"Sydney",13,11,89,"Arden St",-45,1935,"Regular",3,"Away","Sydney","North Melbourne",45
3228,1935-05-18,"R4","Sydney",13,19,97,"Carlton",14,6,90,"Lake Oval",7,1935,"Regular",4,"Home","Sydney","Carlton",7
3229,1935-05-18,"R4","Geelong",14,17,101,"Collingwood",17,13,115,"Corio Oval",-14,1935,"Regular",4,"Away","Collingwood","Geelong",14
3230,1935-05-18,"R4","Footscray",7,8,50,"Essendon",16,5,101,"Western Oval",-51,1935,"Regular",4,"Away","Essendon","Footscray",51
3231,1935-05-18,"R4","Fitzroy",18,16,124,"North Melbourne",10,14,74,"Brunswick St",50,1935,"Regular",4,"Home","Fitzroy","North Melbourne",50
3232,1935-05-18,"R4","Hawthorn",6,17,53,"St Kilda",16,8,104,"Glenferrie Oval",-51,1935,"Regular",4,"Away","St Kilda","Hawthorn",51
3233,1935-05-18,"R4","Richmond",18,20,128,"Melbourne",14,8,92,"Punt Rd",36,1935,"Regular",4,"Home","Richmond","Melbourne",36
3234,1935-05-25,"R5","St Kilda",16,14,110,"Carlton",20,9,129,"Junction Oval",-19,1935,"Regular",5,"Away","Carlton","St Kilda",19
3235,1935-05-25,"R5","Melbourne",9,15,69,"Collingwood",13,20,98,"M.C.G.",-29,1935,"Regular",5,"Away","Collingwood","Melbourne",29
3236,1935-05-25,"R5","Essendon",13,20,98,"Hawthorn",12,14,86,"Windy Hill",12,1935,"Regular",5,"Home","Essendon","Hawthorn",12
3237,1935-05-25,"R5","Fitzroy",8,9,57,"Richmond",14,14,98,"Brunswick St",-41,1935,"Regular",5,"Away","Richmond","Fitzroy",41
3238,1935-05-25,"R5","North Melbourne",12,16,88,"Footscray",13,12,90,"Arden St",-2,1935,"Regular",5,"Away","Footscray","North Melbourne",2
3239,1935-05-25,"R5","Geelong",15,10,100,"Sydney",17,12,114,"Corio Oval",-14,1935,"Regular",5,"Away","Sydney","Geelong",14
3240,1935-06-01,"R6","Collingwood",23,11,149,"Footscray",14,14,98,"Victoria Park",51,1935,"Regular",6,"Home","Collingwood","Footscray",51
3241,1935-06-01,"R6","Sydney",23,14,152,"Fitzroy",10,11,71,"Lake Oval",81,1935,"Regular",6,"Home","Sydney","Fitzroy",81
3242,1935-06-01,"R6","Hawthorn",14,9,93,"Geelong",22,19,151,"Glenferrie Oval",-58,1935,"Regular",6,"Away","Geelong","Hawthorn",58
3243,1935-06-03,"R6","Carlton",20,16,136,"North Melbourne",9,14,68,"Princes Park",68,1935,"Regular",6,"Home","Carlton","North Melbourne",68
3244,1935-06-03,"R6","Essendon",12,13,85,"Richmond",13,9,87,"Windy Hill",-2,1935,"Regular",6,"Away","Richmond","Essendon",2
3245,1935-06-03,"R6","Melbourne",15,13,103,"St Kilda",15,20,110,"M.C.G.",-7,1935,"Regular",6,"Away","St Kilda","Melbourne",7
3246,1935-06-08,"R7","Footscray",12,7,79,"Carlton",9,25,79,"Western Oval",0,1935,"Regular",7,"Home","Footscray","Carlton",0
3247,1935-06-08,"R7","St Kilda",16,15,111,"Collingwood",19,16,130,"Junction Oval",-19,1935,"Regular",7,"Away","Collingwood","St Kilda",19
3248,1935-06-08,"R7","Geelong",16,14,110,"Essendon",4,12,36,"Corio Oval",74,1935,"Regular",7,"Home","Geelong","Essendon",74
3249,1935-06-08,"R7","Fitzroy",14,12,96,"Hawthorn",13,8,86,"Brunswick St",10,1935,"Regular",7,"Home","Fitzroy","Hawthorn",10
3250,1935-06-08,"R7","North Melbourne",8,11,59,"Melbourne",18,11,119,"Arden St",-60,1935,"Regular",7,"Away","Melbourne","North Melbourne",60
3251,1935-06-08,"R7","Richmond",7,17,59,"Sydney",15,15,105,"Punt Rd",-46,1935,"Regular",7,"Away","Sydney","Richmond",46
3252,1935-06-15,"R8","Melbourne",7,12,54,"Carlton",9,12,66,"M.C.G.",-12,1935,"Regular",8,"Away","Carlton","Melbourne",12
3253,1935-06-15,"R8","Collingwood",16,30,126,"North Melbourne",6,10,46,"Victoria Park",80,1935,"Regular",8,"Home","Collingwood","North Melbourne",80
3254,1935-06-15,"R8","Essendon",9,7,61,"Fitzroy",14,19,103,"Windy Hill",-42,1935,"Regular",8,"Away","Fitzroy","Essendon",42
3255,1935-06-15,"R8","St Kilda",14,10,94,"Footscray",7,13,55,"Junction Oval",39,1935,"Regular",8,"Home","St Kilda","Footscray",39
3256,1935-06-15,"R8","Geelong",13,12,90,"Richmond",10,16,76,"Corio Oval",14,1935,"Regular",8,"Home","Geelong","Richmond",14
3257,1935-06-15,"R8","Hawthorn",9,23,77,"Sydney",17,14,116,"Glenferrie Oval",-39,1935,"Regular",8,"Away","Sydney","Hawthorn",39
3258,1935-06-22,"R9","Carlton",13,9,87,"Collingwood",8,10,58,"Princes Park",29,1935,"Regular",9,"Home","Carlton","Collingwood",29
3259,1935-06-22,"R9","Sydney",13,22,100,"Essendon",9,7,61,"Lake Oval",39,1935,"Regular",9,"Home","Sydney","Essendon",39
3260,1935-06-22,"R9","Fitzroy",10,5,65,"Geelong",6,14,50,"Brunswick St",15,1935,"Regular",9,"Home","Fitzroy","Geelong",15
3261,1935-06-22,"R9","Footscray",5,4,34,"Melbourne",4,15,39,"Western Oval",-5,1935,"Regular",9,"Away","Melbourne","Footscray",5
3262,1935-06-22,"R9","Richmond",14,7,91,"Hawthorn",10,13,73,"Punt Rd",18,1935,"Regular",9,"Home","Richmond","Hawthorn",18
3263,1935-06-22,"R9","North Melbourne",6,9,45,"St Kilda",8,14,62,"Arden St",-17,1935,"Regular",9,"Away","St Kilda","North Melbourne",17
3264,1935-06-29,"R10","Essendon",11,12,78,"Carlton",22,8,140,"Windy Hill",-62,1935,"Regular",10,"Away","Carlton","Essendon",62
3265,1935-06-29,"R10","Richmond",11,14,80,"Collingwood",13,4,82,"Punt Rd",-2,1935,"Regular",10,"Away","Collingwood","Richmond",2
3266,1935-06-29,"R10","Fitzroy",13,10,88,"Melbourne",15,17,107,"Brunswick St",-19,1935,"Regular",10,"Away","Melbourne","Fitzroy",19
3267,1935-06-29,"R10","Hawthorn",12,13,85,"Footscray",14,6,90,"Glenferrie Oval",-5,1935,"Regular",10,"Away","Footscray","Hawthorn",5
3268,1935-06-29,"R10","Geelong",26,16,172,"North Melbourne",15,7,97,"Corio Oval",75,1935,"Regular",10,"Home","Geelong","North Melbourne",75
3269,1935-06-29,"R10","Sydney",13,16,94,"St Kilda",9,15,69,"Lake Oval",25,1935,"Regular",10,"Home","Sydney","St Kilda",25
3270,1935-07-06,"R11","Carlton",19,21,135,"Fitzroy",8,6,54,"Princes Park",81,1935,"Regular",11,"Home","Carlton","Fitzroy",81
3271,1935-07-06,"R11","Collingwood",17,20,122,"Hawthorn",12,3,75,"Victoria Park",47,1935,"Regular",11,"Home","Collingwood","Hawthorn",47
3272,1935-07-06,"R11","North Melbourne",10,13,73,"Essendon",10,14,74,"Arden St",-1,1935,"Regular",11,"Away","Essendon","North Melbourne",1
3273,1935-07-06,"R11","Footscray",15,13,103,"Geelong",16,7,103,"Western Oval",0,1935,"Regular",11,"Home","Footscray","Geelong",0
3274,1935-07-06,"R11","Melbourne",11,12,78,"Sydney",18,14,122,"M.C.G.",-44,1935,"Regular",11,"Away","Sydney","Melbourne",44
3275,1935-07-06,"R11","St Kilda",10,14,74,"Richmond",7,8,50,"Junction Oval",24,1935,"Regular",11,"Home","St Kilda","Richmond",24
3276,1935-07-13,"R12","Geelong",6,7,43,"Carlton",11,10,76,"Corio Oval",-33,1935,"Regular",12,"Away","Carlton","Geelong",33
3277,1935-07-13,"R12","Sydney",18,16,124,"Collingwood",10,11,71,"Lake Oval",53,1935,"Regular",12,"Home","Sydney","Collingwood",53
3278,1935-07-13,"R12","Essendon",10,14,74,"Melbourne",12,21,93,"Windy Hill",-19,1935,"Regular",12,"Away","Melbourne","Essendon",19
3279,1935-07-13,"R12","Fitzroy",9,10,64,"St Kilda",12,12,84,"Brunswick St",-20,1935,"Regular",12,"Away","St Kilda","Fitzroy",20
3280,1935-07-13,"R12","Richmond",16,10,106,"Footscray",3,11,29,"Punt Rd",77,1935,"Regular",12,"Home","Richmond","Footscray",77
3281,1935-07-13,"R12","Hawthorn",16,18,114,"North Melbourne",6,10,46,"Glenferrie Oval",68,1935,"Regular",12,"Home","Hawthorn","North Melbourne",68
3282,1935-07-20,"R13","Carlton",21,16,142,"Hawthorn",11,10,76,"Princes Park",66,1935,"Regular",13,"Home","Carlton","Hawthorn",66
3283,1935-07-20,"R13","Collingwood",14,21,105,"Fitzroy",12,10,82,"Victoria Park",23,1935,"Regular",13,"Home","Collingwood","Fitzroy",23
3284,1935-07-20,"R13","St Kilda",13,15,93,"Essendon",11,3,69,"Junction Oval",24,1935,"Regular",13,"Home","St Kilda","Essendon",24
3285,1935-07-20,"R13","Footscray",9,8,62,"Sydney",15,8,98,"Western Oval",-36,1935,"Regular",13,"Away","Sydney","Footscray",36
3286,1935-07-20,"R13","Melbourne",11,11,77,"Geelong",6,13,49,"M.C.G.",28,1935,"Regular",13,"Home","Melbourne","Geelong",28
3287,1935-07-20,"R13","North Melbourne",7,6,48,"Richmond",15,11,101,"Arden St",-53,1935,"Regular",13,"Away","Richmond","North Melbourne",53
3288,1935-07-27,"R14","Richmond",14,11,95,"Carlton",11,14,80,"Punt Rd",15,1935,"Regular",14,"Home","Richmond","Carlton",15
3289,1935-07-27,"R14","Fitzroy",14,16,100,"Footscray",13,15,93,"Brunswick St",7,1935,"Regular",14,"Home","Fitzroy","Footscray",7
3290,1935-07-27,"R14","Hawthorn",12,10,82,"Melbourne",14,17,101,"Glenferrie Oval",-19,1935,"Regular",14,"Away","Melbourne","Hawthorn",19
3291,1935-08-10,"R15","Carlton",16,26,122,"Sydney",12,9,81,"Princes Park",41,1935,"Regular",15,"Home","Carlton","Sydney",41
3292,1935-08-10,"R15","Collingwood",22,13,145,"Geelong",16,15,111,"Victoria Park",34,1935,"Regular",15,"Home","Collingwood","Geelong",34
3293,1935-08-10,"R15","Essendon",15,25,115,"Footscray",12,10,82,"Windy Hill",33,1935,"Regular",15,"Home","Essendon","Footscray",33
3294,1935-08-10,"R15","North Melbourne",10,13,73,"Fitzroy",12,10,82,"Arden St",-9,1935,"Regular",15,"Away","Fitzroy","North Melbourne",9
3295,1935-08-10,"R15","St Kilda",17,22,124,"Hawthorn",9,9,63,"Junction Oval",61,1935,"Regular",15,"Home","St Kilda","Hawthorn",61
3296,1935-08-17,"R14","Essendon",16,10,106,"Collingwood",16,17,113,"Windy Hill",-7,1935,"Regular",14,"Away","Collingwood","Essendon",7
3297,1935-08-17,"R14","Geelong",9,14,68,"St Kilda",13,8,86,"Corio Oval",-18,1935,"Regular",14,"Away","St Kilda","Geelong",18
3298,1935-08-17,"R15","Melbourne",10,8,68,"Richmond",10,15,75,"M.C.G.",-7,1935,"Regular",15,"Away","Richmond","Melbourne",7
3299,1935-08-17,"R14","Sydney",16,13,109,"North Melbourne",15,10,100,"Lake Oval",9,1935,"Regular",14,"Home","Sydney","North Melbourne",9
3300,1935-08-24,"R16","Carlton",18,22,130,"St Kilda",16,12,108,"Princes Park",22,1935,"Regular",16,"Home","Carlton","St Kilda",22
3301,1935-08-24,"R16","Collingwood",11,13,79,"Melbourne",10,19,79,"Victoria Park",0,1935,"Regular",16,"Home","Collingwood","Melbourne",0
3302,1935-08-24,"R16","Hawthorn",8,26,74,"Essendon",9,12,66,"Glenferrie Oval",8,1935,"Regular",16,"Home","Hawthorn","Essendon",8
3303,1935-08-24,"R16","Richmond",17,16,118,"Fitzroy",12,9,81,"Punt Rd",37,1935,"Regular",16,"Home","Richmond","Fitzroy",37
3304,1935-08-24,"R16","Footscray",8,14,62,"North Melbourne",10,9,69,"Western Oval",-7,1935,"Regular",16,"Away","North Melbourne","Footscray",7
3305,1935-08-24,"R16","Sydney",21,12,138,"Geelong",8,14,62,"Lake Oval",76,1935,"Regular",16,"Home","Sydney","Geelong",76
3306,1935-08-31,"R17","North Melbourne",10,9,69,"Carlton",16,16,112,"Arden St",-43,1935,"Regular",17,"Away","Carlton","North Melbourne",43
3307,1935-08-31,"R17","Footscray",6,17,53,"Collingwood",12,14,86,"Western Oval",-33,1935,"Regular",17,"Away","Collingwood","Footscray",33
3308,1935-08-31,"R17","Richmond",12,14,86,"Essendon",7,16,58,"Punt Rd",28,1935,"Regular",17,"Home","Richmond","Essendon",28
3309,1935-08-31,"R17","Fitzroy",11,8,74,"Sydney",10,15,75,"Brunswick St",-1,1935,"Regular",17,"Away","Sydney","Fitzroy",1
3310,1935-08-31,"R17","Geelong",7,17,59,"Hawthorn",13,9,87,"Corio Oval",-28,1935,"Regular",17,"Away","Hawthorn","Geelong",28
3311,1935-08-31,"R17","St Kilda",19,8,122,"Melbourne",16,14,110,"Junction Oval",12,1935,"Regular",17,"Home","St Kilda","Melbourne",12
3312,1935-09-07,"R18","Carlton",20,24,144,"Footscray",10,17,77,"Princes Park",67,1935,"Regular",18,"Home","Carlton","Footscray",67
3313,1935-09-07,"R18","Collingwood",9,18,72,"St Kilda",7,15,57,"Victoria Park",15,1935,"Regular",18,"Home","Collingwood","St Kilda",15
3314,1935-09-07,"R18","Essendon",14,23,107,"Geelong",11,13,79,"Windy Hill",28,1935,"Regular",18,"Home","Essendon","Geelong",28
3315,1935-09-07,"R18","Hawthorn",14,26,110,"Fitzroy",15,6,96,"Glenferrie Oval",14,1935,"Regular",18,"Home","Hawthorn","Fitzroy",14
3316,1935-09-07,"R18","Melbourne",15,12,102,"North Melbourne",7,12,54,"M.C.G.",48,1935,"Regular",18,"Home","Melbourne","North Melbourne",48
3317,1935-09-07,"R18","Sydney",14,23,107,"Richmond",9,9,63,"Lake Oval",44,1935,"Regular",18,"Home","Sydney","Richmond",44
3318,1935-09-14,"SF","Carlton",14,20,104,"Richmond",19,11,125,"M.C.G.",-21,1935,"Finals",19,"Away","Richmond","Carlton",21
3319,1935-09-21,"SF","Sydney",15,14,104,"Collingwood",11,17,83,"M.C.G.",21,1935,"Finals",19,"Home","Sydney","Collingwood",21
3320,1935-09-28,"PF","Collingwood",14,10,94,"Richmond",9,12,66,"M.C.G.",28,1935,"Finals",20,"Home","Collingwood","Richmond",28
3321,1935-10-05,"GF","Sydney",7,16,58,"Collingwood",11,12,78,"M.C.G.",-20,1935,"Finals",21,"Away","Collingwood","Sydney",20
3322,1936-05-02,"R1","Fitzroy",13,9,87,"Carlton",24,19,163,"Brunswick St",-76,1936,"Regular",1,"Away","Carlton","Fitzroy",76
3323,1936-05-02,"R1","Hawthorn",12,11,83,"Collingwood",15,14,104,"Glenferrie Oval",-21,1936,"Regular",1,"Away","Collingwood","Hawthorn",21
3324,1936-05-02,"R1","Essendon",17,15,117,"North Melbourne",11,4,70,"Windy Hill",47,1936,"Regular",1,"Home","Essendon","North Melbourne",47
3325,1936-05-02,"R1","Geelong",20,24,144,"Footscray",10,9,69,"Corio Oval",75,1936,"Regular",1,"Home","Geelong","Footscray",75
3326,1936-05-02,"R1","Sydney",14,24,108,"Melbourne",13,9,87,"Lake Oval",21,1936,"Regular",1,"Home","Sydney","Melbourne",21
3327,1936-05-02,"R1","Richmond",15,17,107,"St Kilda",17,4,106,"Punt Rd",1,1936,"Regular",1,"Home","Richmond","St Kilda",1
3328,1936-05-09,"R2","Carlton",21,19,145,"Essendon",5,13,43,"Princes Park",102,1936,"Regular",2,"Home","Carlton","Essendon",102
3329,1936-05-09,"R2","Collingwood",16,12,108,"Richmond",10,12,72,"Victoria Park",36,1936,"Regular",2,"Home","Collingwood","Richmond",36
3330,1936-05-09,"R2","Melbourne",15,17,107,"Fitzroy",8,11,59,"M.C.G.",48,1936,"Regular",2,"Home","Melbourne","Fitzroy",48
3331,1936-05-09,"R2","Footscray",8,20,68,"Hawthorn",11,7,73,"Western Oval",-5,1936,"Regular",2,"Away","Hawthorn","Footscray",5
3332,1936-05-09,"R2","North Melbourne",9,14,68,"Geelong",11,8,74,"Arden St",-6,1936,"Regular",2,"Away","Geelong","North Melbourne",6
3333,1936-05-09,"R2","St Kilda",10,11,71,"Sydney",12,17,89,"Junction Oval",-18,1936,"Regular",2,"Away","Sydney","St Kilda",18
3334,1936-05-16,"R3","Hawthorn",14,13,97,"Carlton",16,11,107,"Glenferrie Oval",-10,1936,"Regular",3,"Away","Carlton","Hawthorn",10
3335,1936-05-16,"R3","Fitzroy",12,12,84,"Collingwood",25,14,164,"Brunswick St",-80,1936,"Regular",3,"Away","Collingwood","Fitzroy",80
3336,1936-05-16,"R3","Essendon",16,19,115,"St Kilda",18,11,119,"Windy Hill",-4,1936,"Regular",3,"Away","St Kilda","Essendon",4
3337,1936-05-16,"R3","Sydney",15,17,107,"Footscray",9,13,67,"Lake Oval",40,1936,"Regular",3,"Home","Sydney","Footscray",40
3338,1936-05-16,"R3","Geelong",14,18,102,"Melbourne",4,8,32,"Corio Oval",70,1936,"Regular",3,"Home","Geelong","Melbourne",70
3339,1936-05-16,"R3","Richmond",13,14,92,"North Melbourne",6,17,53,"Punt Rd",39,1936,"Regular",3,"Home","Richmond","North Melbourne",39
3340,1936-05-23,"R4","Carlton",16,19,115,"Richmond",18,17,125,"Princes Park",-10,1936,"Regular",4,"Away","Richmond","Carlton",10
3341,1936-05-23,"R4","Collingwood",20,17,137,"Essendon",13,10,88,"Victoria Park",49,1936,"Regular",4,"Home","Collingwood","Essendon",49
3342,1936-05-23,"R4","Footscray",13,11,89,"Fitzroy",10,14,74,"Western Oval",15,1936,"Regular",4,"Home","Footscray","Fitzroy",15
3343,1936-05-23,"R4","St Kilda",19,11,125,"Geelong",12,10,82,"Junction Oval",43,1936,"Regular",4,"Home","St Kilda","Geelong",43
3344,1936-05-23,"R4","Melbourne",16,20,116,"Hawthorn",11,11,77,"M.C.G.",39,1936,"Regular",4,"Home","Melbourne","Hawthorn",39
3345,1936-05-23,"R4","North Melbourne",7,18,60,"Sydney",18,21,129,"Arden St",-69,1936,"Regular",4,"Away","Sydney","North Melbourne",69
3346,1936-05-30,"R5","Footscray",7,17,59,"Carlton",13,16,94,"Western Oval",-35,1936,"Regular",5,"Away","Carlton","Footscray",35
3347,1936-05-30,"R5","Collingwood",16,17,113,"St Kilda",9,14,68,"Victoria Park",45,1936,"Regular",5,"Home","Collingwood","St Kilda",45
3348,1936-05-30,"R5","Sydney",15,21,111,"Essendon",11,13,79,"Lake Oval",32,1936,"Regular",5,"Home","Sydney","Essendon",32
3349,1936-05-30,"R5","Fitzroy",17,19,121,"Geelong",17,13,115,"Brunswick St",6,1936,"Regular",5,"Home","Fitzroy","Geelong",6
3350,1936-05-30,"R5","Richmond",16,21,117,"Hawthorn",10,12,72,"Punt Rd",45,1936,"Regular",5,"Home","Richmond","Hawthorn",45
3351,1936-05-30,"R5","North Melbourne",11,9,75,"Melbourne",17,20,122,"Arden St",-47,1936,"Regular",5,"Away","Melbourne","North Melbourne",47
3352,1936-06-06,"R6","Carlton",11,16,82,"Collingwood",12,16,88,"Princes Park",-6,1936,"Regular",6,"Away","Collingwood","Carlton",6
3353,1936-06-06,"R6","Essendon",18,19,127,"Fitzroy",12,14,86,"Windy Hill",41,1936,"Regular",6,"Home","Essendon","Fitzroy",41
3354,1936-06-06,"R6","Melbourne",13,18,96,"Footscray",11,14,80,"M.C.G.",16,1936,"Regular",6,"Home","Melbourne","Footscray",16
3355,1936-06-06,"R6","Geelong",6,14,50,"Richmond",13,12,90,"Corio Oval",-40,1936,"Regular",6,"Away","Richmond","Geelong",40
3356,1936-06-06,"R6","Hawthorn",9,11,65,"Sydney",18,20,128,"Glenferrie Oval",-63,1936,"Regular",6,"Away","Sydney","Hawthorn",63
3357,1936-06-06,"R6","St Kilda",22,15,147,"North Melbourne",14,24,108,"Junction Oval",39,1936,"Regular",6,"Home","St Kilda","North Melbourne",39
3358,1936-06-13,"R7","Carlton",19,14,128,"St Kilda",11,9,75,"Princes Park",53,1936,"Regular",7,"Home","Carlton","St Kilda",53
3359,1936-06-13,"R7","Collingwood",14,5,89,"Melbourne",9,13,67,"Victoria Park",22,1936,"Regular",7,"Home","Collingwood","Melbourne",22
3360,1936-06-13,"R7","Richmond",10,18,78,"Essendon",10,11,71,"Punt Rd",7,1936,"Regular",7,"Home","Richmond","Essendon",7
3361,1936-06-13,"R7","Sydney",13,15,93,"Fitzroy",7,11,53,"Lake Oval",40,1936,"Regular",7,"Home","Sydney","Fitzroy",40
3362,1936-06-13,"R7","North Melbourne",12,19,91,"Footscray",13,7,85,"Arden St",6,1936,"Regular",7,"Home","North Melbourne","Footscray",6
3363,1936-06-13,"R7","Hawthorn",12,19,91,"Geelong",7,6,48,"Glenferrie Oval",43,1936,"Regular",7,"Home","Hawthorn","Geelong",43
3364,1936-06-20,"R8","North Melbourne",13,8,86,"Carlton",9,13,67,"Arden St",19,1936,"Regular",8,"Home","North Melbourne","Carlton",19
3365,1936-06-20,"R8","Footscray",11,13,79,"Collingwood",16,10,106,"Western Oval",-27,1936,"Regular",8,"Away","Collingwood","Footscray",27
3366,1936-06-20,"R8","Essendon",12,19,91,"Hawthorn",8,18,66,"Windy Hill",25,1936,"Regular",8,"Home","Essendon","Hawthorn",25
3367,1936-06-20,"R8","Fitzroy",12,16,88,"Richmond",20,12,132,"Brunswick St",-44,1936,"Regular",8,"Away","Richmond","Fitzroy",44
3368,1936-06-20,"R8","Sydney",16,21,117,"Geelong",15,14,104,"Lake Oval",13,1936,"Regular",8,"Home","Sydney","Geelong",13
3369,1936-06-20,"R8","Melbourne",20,11,131,"St Kilda",15,11,101,"M.C.G.",30,1936,"Regular",8,"Home","Melbourne","St Kilda",30
3370,1936-06-27,"R9","Carlton",9,14,68,"Melbourne",11,17,83,"Princes Park",-15,1936,"Regular",9,"Away","Melbourne","Carlton",15
3371,1936-06-27,"R9","Collingwood",17,19,121,"North Melbourne",8,7,55,"Victoria Park",66,1936,"Regular",9,"Home","Collingwood","North Melbourne",66
3372,1936-06-27,"R9","Geelong",26,18,174,"Essendon",14,13,97,"Corio Oval",77,1936,"Regular",9,"Home","Geelong","Essendon",77
3373,1936-06-27,"R9","Hawthorn",11,9,75,"Fitzroy",9,9,63,"Glenferrie Oval",12,1936,"Regular",9,"Home","Hawthorn","Fitzroy",12
3374,1936-06-27,"R9","St Kilda",20,17,137,"Footscray",16,13,109,"Junction Oval",28,1936,"Regular",9,"Home","St Kilda","Footscray",28
3375,1936-06-27,"R9","Richmond",14,14,98,"Sydney",11,11,77,"Punt Rd",21,1936,"Regular",9,"Home","Richmond","Sydney",21
3376,1936-07-11,"R10","Carlton",14,21,105,"Geelong",12,17,89,"Princes Park",16,1936,"Regular",10,"Home","Carlton","Geelong",16
3377,1936-07-11,"R10","Collingwood",12,19,91,"Sydney",14,18,102,"Victoria Park",-11,1936,"Regular",10,"Away","Sydney","Collingwood",11
3378,1936-07-11,"R10","Melbourne",16,15,111,"Essendon",9,13,67,"M.C.G.",44,1936,"Regular",10,"Home","Melbourne","Essendon",44
3379,1936-07-11,"R10","North Melbourne",9,11,65,"Fitzroy",3,12,30,"Arden St",35,1936,"Regular",10,"Home","North Melbourne","Fitzroy",35
3380,1936-07-11,"R10","Footscray",10,8,68,"Richmond",15,13,103,"Western Oval",-35,1936,"Regular",10,"Away","Richmond","Footscray",35
3381,1936-07-11,"R10","St Kilda",16,9,105,"Hawthorn",12,16,88,"Junction Oval",17,1936,"Regular",10,"Home","St Kilda","Hawthorn",17
3382,1936-07-18,"R11","Sydney",16,11,107,"Carlton",14,16,100,"Lake Oval",7,1936,"Regular",11,"Home","Sydney","Carlton",7
3383,1936-07-18,"R11","Geelong",13,15,93,"Collingwood",11,9,75,"Corio Oval",18,1936,"Regular",11,"Home","Geelong","Collingwood",18
3384,1936-07-18,"R11","Essendon",12,15,87,"Footscray",16,18,114,"Windy Hill",-27,1936,"Regular",11,"Away","Footscray","Essendon",27
3385,1936-07-18,"R11","Fitzroy",16,9,105,"St Kilda",19,15,129,"Brunswick St",-24,1936,"Regular",11,"Away","St Kilda","Fitzroy",24
3386,1936-07-18,"R11","Hawthorn",8,19,67,"North Melbourne",7,11,53,"Glenferrie Oval",14,1936,"Regular",11,"Home","Hawthorn","North Melbourne",14
3387,1936-07-18,"R11","Richmond",15,13,103,"Melbourne",17,10,112,"Punt Rd",-9,1936,"Regular",11,"Away","Melbourne","Richmond",9
3388,1936-07-25,"R12","Carlton",18,15,123,"Fitzroy",14,11,95,"Princes Park",28,1936,"Regular",12,"Home","Carlton","Fitzroy",28
3389,1936-07-25,"R12","Collingwood",14,18,102,"Hawthorn",6,12,48,"Victoria Park",54,1936,"Regular",12,"Home","Collingwood","Hawthorn",54
3390,1936-07-25,"R12","North Melbourne",6,14,50,"Essendon",10,10,70,"Arden St",-20,1936,"Regular",12,"Away","Essendon","North Melbourne",20
3391,1936-07-25,"R12","Footscray",14,9,93,"Geelong",10,22,82,"Western Oval",11,1936,"Regular",12,"Home","Footscray","Geelong",11
3392,1936-07-25,"R12","Melbourne",22,16,148,"Sydney",14,12,96,"M.C.G.",52,1936,"Regular",12,"Home","Melbourne","Sydney",52
3393,1936-07-25,"R12","St Kilda",14,12,96,"Richmond",18,6,114,"Junction Oval",-18,1936,"Regular",12,"Away","Richmond","St Kilda",18
3394,1936-08-01,"R13","Essendon",8,11,59,"Carlton",17,16,118,"Windy Hill",-59,1936,"Regular",13,"Away","Carlton","Essendon",59
3395,1936-08-01,"R13","Richmond",11,14,80,"Collingwood",14,12,96,"Punt Rd",-16,1936,"Regular",13,"Away","Collingwood","Richmond",16
3396,1936-08-01,"R13","Fitzroy",13,13,91,"Melbourne",12,13,85,"Brunswick St",6,1936,"Regular",13,"Home","Fitzroy","Melbourne",6
3397,1936-08-01,"R13","Hawthorn",13,13,91,"Footscray",8,21,69,"Glenferrie Oval",22,1936,"Regular",13,"Home","Hawthorn","Footscray",22
3398,1936-08-01,"R13","Geelong",17,20,122,"North Melbourne",12,8,80,"Corio Oval",42,1936,"Regular",13,"Home","Geelong","North Melbourne",42
3399,1936-08-01,"R13","Sydney",14,19,103,"St Kilda",13,11,89,"Lake Oval",14,1936,"Regular",13,"Home","Sydney","St Kilda",14
3400,1936-08-08,"R14","Carlton",11,17,83,"Hawthorn",8,16,64,"Princes Park",19,1936,"Regular",14,"Home","Carlton","Hawthorn",19
3401,1936-08-08,"R14","Collingwood",13,12,90,"Fitzroy",11,8,74,"Victoria Park",16,1936,"Regular",14,"Home","Collingwood","Fitzroy",16
3402,1936-08-08,"R14","St Kilda",16,23,119,"Essendon",14,14,98,"Junction Oval",21,1936,"Regular",14,"Home","St Kilda","Essendon",21
3403,1936-08-08,"R14","Footscray",11,15,81,"Sydney",12,21,93,"Western Oval",-12,1936,"Regular",14,"Away","Sydney","Footscray",12
3404,1936-08-08,"R14","Melbourne",14,16,100,"Geelong",15,15,105,"M.C.G.",-5,1936,"Regular",14,"Away","Geelong","Melbourne",5
3405,1936-08-08,"R14","North Melbourne",11,7,73,"Richmond",9,11,65,"Arden St",8,1936,"Regular",14,"Home","North Melbourne","Richmond",8
3406,1936-08-15,"R15","Richmond",9,12,66,"Carlton",14,6,90,"Punt Rd",-24,1936,"Regular",15,"Away","Carlton","Richmond",24
3407,1936-08-15,"R15","Essendon",8,10,58,"Collingwood",14,16,100,"Windy Hill",-42,1936,"Regular",15,"Away","Collingwood","Essendon",42
3408,1936-08-15,"R15","Fitzroy",9,10,64,"Footscray",12,17,89,"Brunswick St",-25,1936,"Regular",15,"Away","Footscray","Fitzroy",25
3409,1936-08-15,"R15","Geelong",18,22,130,"St Kilda",10,7,67,"Corio Oval",63,1936,"Regular",15,"Home","Geelong","St Kilda",63
3410,1936-08-15,"R15","Hawthorn",9,8,62,"Melbourne",17,10,112,"Glenferrie Oval",-50,1936,"Regular",15,"Away","Melbourne","Hawthorn",50
3411,1936-08-15,"R15","Sydney",8,16,64,"North Melbourne",9,9,63,"Lake Oval",1,1936,"Regular",15,"Home","Sydney","North Melbourne",1
3412,1936-08-22,"R16","Carlton",12,22,94,"Footscray",12,14,86,"Princes Park",8,1936,"Regular",16,"Home","Carlton","Footscray",8
3413,1936-08-22,"R16","St Kilda",11,11,77,"Collingwood",14,13,97,"Junction Oval",-20,1936,"Regular",16,"Away","Collingwood","St Kilda",20
3414,1936-08-22,"R16","Essendon",12,16,88,"Sydney",11,30,96,"Windy Hill",-8,1936,"Regular",16,"Away","Sydney","Essendon",8
3415,1936-08-22,"R16","Geelong",20,21,141,"Fitzroy",6,8,44,"Corio Oval",97,1936,"Regular",16,"Home","Geelong","Fitzroy",97
3416,1936-08-22,"R16","Hawthorn",15,12,102,"Richmond",14,16,100,"Glenferrie Oval",2,1936,"Regular",16,"Home","Hawthorn","Richmond",2
3417,1936-08-22,"R16","Melbourne",14,23,107,"North Melbourne",5,15,45,"M.C.G.",62,1936,"Regular",16,"Home","Melbourne","North Melbourne",62
3418,1936-08-29,"R17","Collingwood",13,11,89,"Carlton",13,12,90,"Victoria Park",-1,1936,"Regular",17,"Away","Carlton","Collingwood",1
3419,1936-08-29,"R17","Fitzroy",9,16,70,"Essendon",17,16,118,"Brunswick St",-48,1936,"Regular",17,"Away","Essendon","Fitzroy",48
3420,1936-08-29,"R17","Footscray",8,17,65,"Melbourne",9,18,72,"Western Oval",-7,1936,"Regular",17,"Away","Melbourne","Footscray",7
3421,1936-08-29,"R17","Richmond",8,7,55,"Geelong",12,9,81,"Punt Rd",-26,1936,"Regular",17,"Away","Geelong","Richmond",26
3422,1936-08-29,"R17","Sydney",16,10,106,"Hawthorn",15,11,101,"Lake Oval",5,1936,"Regular",17,"Home","Sydney","Hawthorn",5
3423,1936-08-29,"R17","North Melbourne",15,7,97,"St Kilda",15,18,108,"Arden St",-11,1936,"Regular",17,"Away","St Kilda","North Melbourne",11
3424,1936-09-05,"R18","St Kilda",16,10,106,"Carlton",15,15,105,"Junction Oval",1,1936,"Regular",18,"Home","St Kilda","Carlton",1
3425,1936-09-05,"R18","Melbourne",9,13,67,"Collingwood",11,18,84,"M.C.G.",-17,1936,"Regular",18,"Away","Collingwood","Melbourne",17
3426,1936-09-05,"R18","Essendon",14,8,92,"Richmond",11,10,76,"Windy Hill",16,1936,"Regular",18,"Home","Essendon","Richmond",16
3427,1936-09-05,"R18","Fitzroy",11,13,79,"Sydney",11,14,80,"Brunswick St",-1,1936,"Regular",18,"Away","Sydney","Fitzroy",1
3428,1936-09-05,"R18","Footscray",14,8,92,"North Melbourne",12,10,82,"Western Oval",10,1936,"Regular",18,"Home","Footscray","North Melbourne",10
3429,1936-09-05,"R18","Geelong",21,22,148,"Hawthorn",9,15,69,"Corio Oval",79,1936,"Regular",18,"Home","Geelong","Hawthorn",79
3430,1936-09-12,"SF","Carlton",11,22,88,"Melbourne",14,13,97,"M.C.G.",-9,1936,"Finals",19,"Away","Melbourne","Carlton",9
3431,1936-09-19,"SF","Sydney",10,17,77,"Collingwood",12,18,90,"M.C.G.",-13,1936,"Finals",19,"Away","Collingwood","Sydney",13
3432,1936-09-26,"PF","Sydney",13,11,89,"Melbourne",8,15,63,"M.C.G.",26,1936,"Finals",20,"Home","Sydney","Melbourne",26
3433,1936-10-03,"GF","Sydney",10,18,78,"Collingwood",11,23,89,"M.C.G.",-11,1936,"Finals",21,"Away","Collingwood","Sydney",11
3434,1937-04-24,"R1","Carlton",18,21,129,"Sydney",7,17,59,"Princes Park",70,1937,"Regular",1,"Home","Carlton","Sydney",70
3435,1937-04-24,"R1","Collingwood",15,16,106,"Geelong",13,12,90,"Victoria Park",16,1937,"Regular",1,"Home","Collingwood","Geelong",16
3436,1937-04-24,"R1","Footscray",9,17,71,"Essendon",9,13,67,"Western Oval",4,1937,"Regular",1,"Home","Footscray","Essendon",4
3437,1937-04-24,"R1","St Kilda",12,16,88,"Fitzroy",10,21,81,"Junction Oval",7,1937,"Regular",1,"Home","St Kilda","Fitzroy",7
3438,1937-04-24,"R1","North Melbourne",9,22,76,"Hawthorn",11,12,78,"Arden St",-2,1937,"Regular",1,"Away","Hawthorn","North Melbourne",2
3439,1937-04-24,"R1","Melbourne",14,8,92,"Richmond",9,12,66,"M.C.G.",26,1937,"Regular",1,"Home","Melbourne","Richmond",26
3440,1937-05-01,"R2","Geelong",8,12,60,"Carlton",6,13,49,"Corio Oval",11,1937,"Regular",2,"Home","Geelong","Carlton",11
3441,1937-05-01,"R2","Sydney",11,19,85,"Collingwood",20,20,140,"Lake Oval",-55,1937,"Regular",2,"Away","Collingwood","Sydney",55
3442,1937-05-01,"R2","Essendon",13,7,85,"Melbourne",25,20,170,"Windy Hill",-85,1937,"Regular",2,"Away","Melbourne","Essendon",85
3443,1937-05-01,"R2","Fitzroy",9,11,65,"North Melbourne",10,7,67,"Brunswick St",-2,1937,"Regular",2,"Away","North Melbourne","Fitzroy",2
3444,1937-05-01,"R2","Richmond",17,15,117,"Footscray",12,11,83,"Punt Rd",34,1937,"Regular",2,"Home","Richmond","Footscray",34
3445,1937-05-01,"R2","Hawthorn",14,15,99,"St Kilda",15,22,112,"Glenferrie Oval",-13,1937,"Regular",2,"Away","St Kilda","Hawthorn",13
3446,1937-05-08,"R3","Melbourne",15,17,107,"Carlton",10,11,71,"M.C.G.",36,1937,"Regular",3,"Home","Melbourne","Carlton",36
3447,1937-05-08,"R3","North Melbourne",3,16,34,"Collingwood",9,14,68,"Arden St",-34,1937,"Regular",3,"Away","Collingwood","North Melbourne",34
3448,1937-05-08,"R3","Essendon",18,13,121,"Geelong",14,20,104,"Windy Hill",17,1937,"Regular",3,"Home","Essendon","Geelong",17
3449,1937-05-08,"R3","Fitzroy",15,15,105,"Hawthorn",9,15,69,"Brunswick St",36,1937,"Regular",3,"Home","Fitzroy","Hawthorn",36
3450,1937-05-08,"R3","Footscray",6,10,46,"St Kilda",7,9,51,"Western Oval",-5,1937,"Regular",3,"Away","St Kilda","Footscray",5
3451,1937-05-08,"R3","Sydney",11,15,81,"Richmond",11,15,81,"Lake Oval",0,1937,"Regular",3,"Home","Sydney","Richmond",0
3452,1937-05-15,"R4","Carlton",10,12,72,"North Melbourne",10,14,74,"Princes Park",-2,1937,"Regular",4,"Away","North Melbourne","Carlton",2
3453,1937-05-15,"R4","Collingwood",16,14,110,"Footscray",11,11,77,"Victoria Park",33,1937,"Regular",4,"Home","Collingwood","Footscray",33
3454,1937-05-15,"R4","Hawthorn",11,15,81,"Essendon",16,13,109,"Glenferrie Oval",-28,1937,"Regular",4,"Away","Essendon","Hawthorn",28
3455,1937-05-15,"R4","Richmond",17,10,112,"Fitzroy",12,12,84,"Punt Rd",28,1937,"Regular",4,"Home","Richmond","Fitzroy",28
3456,1937-05-15,"R4","Geelong",12,20,92,"Sydney",7,11,53,"Corio Oval",39,1937,"Regular",4,"Home","Geelong","Sydney",39
3457,1937-05-15,"R4","St Kilda",12,18,90,"Melbourne",12,23,95,"Junction Oval",-5,1937,"Regular",4,"Away","Melbourne","St Kilda",5
3458,1937-05-22,"R5","St Kilda",12,19,91,"Carlton",13,16,94,"Junction Oval",-3,1937,"Regular",5,"Away","Carlton","St Kilda",3
3459,1937-05-22,"R5","Melbourne",13,23,101,"Collingwood",11,10,76,"M.C.G.",25,1937,"Regular",5,"Home","Melbourne","Collingwood",25
3460,1937-05-22,"R5","Essendon",8,15,63,"Richmond",17,13,115,"Windy Hill",-52,1937,"Regular",5,"Away","Richmond","Essendon",52
3461,1937-05-22,"R5","Fitzroy",11,16,82,"Sydney",7,18,60,"Brunswick St",22,1937,"Regular",5,"Home","Fitzroy","Sydney",22
3462,1937-05-22,"R5","Footscray",18,23,131,"North Melbourne",14,4,88,"Western Oval",43,1937,"Regular",5,"Home","Footscray","North Melbourne",43
3463,1937-05-22,"R5","Geelong",21,23,149,"Hawthorn",7,11,53,"Corio Oval",96,1937,"Regular",5,"Home","Geelong","Hawthorn",96
3464,1937-05-29,"R6","Collingwood",11,16,82,"Carlton",8,7,55,"Victoria Park",27,1937,"Regular",6,"Home","Collingwood","Carlton",27
3465,1937-05-29,"R6","Fitzroy",11,9,75,"Essendon",8,18,66,"Brunswick St",9,1937,"Regular",6,"Home","Fitzroy","Essendon",9
3466,1937-05-29,"R6","Footscray",8,8,56,"Melbourne",11,12,78,"Western Oval",-22,1937,"Regular",6,"Away","Melbourne","Footscray",22
3467,1937-05-29,"R6","Richmond",15,19,109,"Geelong",12,6,78,"Punt Rd",31,1937,"Regular",6,"Home","Richmond","Geelong",31
3468,1937-05-29,"R6","Sydney",15,11,101,"Hawthorn",13,20,98,"Lake Oval",3,1937,"Regular",6,"Home","Sydney","Hawthorn",3
3469,1937-05-29,"R6","North Melbourne",13,8,86,"St Kilda",15,13,103,"Arden St",-17,1937,"Regular",6,"Away","St Kilda","North Melbourne",17
3470,1937-06-05,"R7","Carlton",19,12,126,"Footscray",9,10,64,"Princes Park",62,1937,"Regular",7,"Home","Carlton","Footscray",62
3471,1937-06-05,"R7","St Kilda",12,15,87,"Collingwood",9,15,69,"Junction Oval",18,1937,"Regular",7,"Home","St Kilda","Collingwood",18
3472,1937-06-05,"R7","Essendon",16,12,108,"Sydney",11,10,76,"Windy Hill",32,1937,"Regular",7,"Home","Essendon","Sydney",32
3473,1937-06-05,"R7","Geelong",16,19,115,"Fitzroy",10,10,70,"Corio Oval",45,1937,"Regular",7,"Home","Geelong","Fitzroy",45
3474,1937-06-05,"R7","Hawthorn",9,6,60,"Richmond",8,10,58,"Glenferrie Oval",2,1937,"Regular",7,"Home","Hawthorn","Richmond",2
3475,1937-06-05,"R7","Melbourne",25,16,166,"North Melbourne",5,14,44,"M.C.G.",122,1937,"Regular",7,"Home","Melbourne","North Melbourne",122
3476,1937-06-12,"R8","Richmond",14,24,108,"Carlton",13,19,97,"Punt Rd",11,1937,"Regular",8,"Home","Richmond","Carlton",11
3477,1937-06-12,"R8","Essendon",13,11,89,"Collingwood",19,14,128,"Windy Hill",-39,1937,"Regular",8,"Away","Collingwood","Essendon",39
3478,1937-06-12,"R8","Geelong",16,13,109,"St Kilda",11,15,81,"Corio Oval",28,1937,"Regular",8,"Home","Geelong","St Kilda",28
3479,1937-06-14,"R8","Fitzroy",14,15,99,"Footscray",8,14,62,"Brunswick St",37,1937,"Regular",8,"Home","Fitzroy","Footscray",37
3480,1937-06-14,"R8","Hawthorn",12,10,82,"Melbourne",15,15,105,"Glenferrie Oval",-23,1937,"Regular",8,"Away","Melbourne","Hawthorn",23
3481,1937-06-14,"R8","Sydney",16,18,114,"North Melbourne",10,10,70,"Lake Oval",44,1937,"Regular",8,"Home","Sydney","North Melbourne",44
3482,1937-06-19,"R9","Carlton",15,24,114,"Hawthorn",8,11,59,"Princes Park",55,1937,"Regular",9,"Home","Carlton","Hawthorn",55
3483,1937-06-19,"R9","Collingwood",16,9,105,"Fitzroy",12,12,84,"Victoria Park",21,1937,"Regular",9,"Home","Collingwood","Fitzroy",21
3484,1937-06-19,"R9","St Kilda",13,19,97,"Essendon",11,14,80,"Junction Oval",17,1937,"Regular",9,"Home","St Kilda","Essendon",17
3485,1937-06-19,"R9","Footscray",10,8,68,"Sydney",18,11,119,"Western Oval",-51,1937,"Regular",9,"Away","Sydney","Footscray",51
3486,1937-06-19,"R9","Melbourne",9,17,71,"Geelong",15,14,104,"M.C.G.",-33,1937,"Regular",9,"Away","Geelong","Melbourne",33
3487,1937-06-19,"R9","North Melbourne",12,16,88,"Richmond",11,11,77,"Arden St",11,1937,"Regular",9,"Home","North Melbourne","Richmond",11
3488,1937-06-26,"R10","Essendon",13,18,96,"Carlton",15,18,108,"Windy Hill",-12,1937,"Regular",10,"Away","Carlton","Essendon",12
3489,1937-06-26,"R10","Richmond",12,8,80,"Collingwood",14,9,93,"Punt Rd",-13,1937,"Regular",10,"Away","Collingwood","Richmond",13
3490,1937-06-26,"R10","Fitzroy",7,8,50,"Melbourne",11,23,89,"Brunswick St",-39,1937,"Regular",10,"Away","Melbourne","Fitzroy",39
3491,1937-06-26,"R10","Hawthorn",15,16,106,"Footscray",14,15,99,"Glenferrie Oval",7,1937,"Regular",10,"Home","Hawthorn","Footscray",7
3492,1937-06-26,"R10","Geelong",18,16,124,"North Melbourne",4,14,38,"Corio Oval",86,1937,"Regular",10,"Home","Geelong","North Melbourne",86
3493,1937-06-26,"R10","Sydney",14,18,102,"St Kilda",8,12,60,"Lake Oval",42,1937,"Regular",10,"Home","Sydney","St Kilda",42
3494,1937-07-03,"R11","Carlton",13,11,89,"Fitzroy",8,19,67,"Princes Park",22,1937,"Regular",11,"Home","Carlton","Fitzroy",22
3495,1937-07-03,"R11","Collingwood",13,23,101,"Hawthorn",6,13,49,"Victoria Park",52,1937,"Regular",11,"Home","Collingwood","Hawthorn",52
3496,1937-07-03,"R11","North Melbourne",11,11,77,"Essendon",11,22,88,"Arden St",-11,1937,"Regular",11,"Away","Essendon","North Melbourne",11
3497,1937-07-03,"R11","Footscray",11,8,74,"Geelong",13,15,93,"Western Oval",-19,1937,"Regular",11,"Away","Geelong","Footscray",19
3498,1937-07-03,"R11","Melbourne",13,10,88,"Sydney",11,16,82,"M.C.G.",6,1937,"Regular",11,"Home","Melbourne","Sydney",6
3499,1937-07-03,"R11","St Kilda",16,6,102,"Richmond",10,13,73,"Junction Oval",29,1937,"Regular",11,"Home","St Kilda","Richmond",29
3500,1937-07-10,"R12","Sydney",13,9,87,"Carlton",7,14,56,"Lake Oval",31,1937,"Regular",12,"Home","Sydney","Carlton",31
3501,1937-07-10,"R12","Geelong",13,16,94,"Collingwood",10,11,71,"Corio Oval",23,1937,"Regular",12,"Home","Geelong","Collingwood",23
3502,1937-07-10,"R12","Essendon",9,13,67,"Footscray",11,11,77,"Windy Hill",-10,1937,"Regular",12,"Away","Footscray","Essendon",10
3503,1937-07-10,"R12","Fitzroy",10,19,79,"St Kilda",5,11,41,"Brunswick St",38,1937,"Regular",12,"Home","Fitzroy","St Kilda",38
3504,1937-07-10,"R12","Hawthorn",9,15,69,"North Melbourne",6,15,51,"Glenferrie Oval",18,1937,"Regular",12,"Home","Hawthorn","North Melbourne",18
3505,1937-07-10,"R12","Richmond",15,12,102,"Melbourne",13,10,88,"Punt Rd",14,1937,"Regular",12,"Home","Richmond","Melbourne",14
3506,1937-07-17,"R13","Carlton",9,13,67,"Geelong",13,14,92,"Princes Park",-25,1937,"Regular",13,"Away","Geelong","Carlton",25
3507,1937-07-17,"R13","Collingwood",18,19,127,"Sydney",15,14,104,"Victoria Park",23,1937,"Regular",13,"Home","Collingwood","Sydney",23
3508,1937-07-17,"R13","Melbourne",11,13,79,"Essendon",8,15,63,"M.C.G.",16,1937,"Regular",13,"Home","Melbourne","Essendon",16
3509,1937-07-17,"R13","North Melbourne",5,17,47,"Fitzroy",9,14,68,"Arden St",-21,1937,"Regular",13,"Away","Fitzroy","North Melbourne",21
3510,1937-07-17,"R13","Footscray",11,9,75,"Richmond",12,6,78,"Western Oval",-3,1937,"Regular",13,"Away","Richmond","Footscray",3
3511,1937-07-17,"R13","St Kilda",11,15,81,"Hawthorn",9,8,62,"Junction Oval",19,1937,"Regular",13,"Home","St Kilda","Hawthorn",19
3512,1937-07-24,"R14","Carlton",16,24,120,"Melbourne",16,8,104,"Princes Park",16,1937,"Regular",14,"Home","Carlton","Melbourne",16
3513,1937-07-24,"R14","Collingwood",24,20,164,"North Melbourne",7,9,51,"Victoria Park",113,1937,"Regular",14,"Home","Collingwood","North Melbourne",113
3514,1937-07-24,"R14","Geelong",13,22,100,"Essendon",9,12,66,"Corio Oval",34,1937,"Regular",14,"Home","Geelong","Essendon",34
3515,1937-07-24,"R14","Hawthorn",10,11,71,"Fitzroy",6,13,49,"Glenferrie Oval",22,1937,"Regular",14,"Home","Hawthorn","Fitzroy",22
3516,1937-07-24,"R14","St Kilda",17,10,112,"Footscray",13,15,93,"Junction Oval",19,1937,"Regular",14,"Home","St Kilda","Footscray",19
3517,1937-07-24,"R14","Richmond",16,23,119,"Sydney",13,11,89,"Punt Rd",30,1937,"Regular",14,"Home","Richmond","Sydney",30
3518,1937-07-31,"R15","North Melbourne",10,11,71,"Carlton",14,8,92,"Arden St",-21,1937,"Regular",15,"Away","Carlton","North Melbourne",21
3519,1937-07-31,"R15","Footscray",10,14,74,"Collingwood",19,12,126,"Western Oval",-52,1937,"Regular",15,"Away","Collingwood","Footscray",52
3520,1937-07-31,"R15","Essendon",11,13,79,"Hawthorn",13,14,92,"Windy Hill",-13,1937,"Regular",15,"Away","Hawthorn","Essendon",13
3521,1937-07-31,"R15","Fitzroy",11,13,79,"Richmond",15,13,103,"Brunswick St",-24,1937,"Regular",15,"Away","Richmond","Fitzroy",24
3522,1937-07-31,"R15","Sydney",13,10,88,"Geelong",16,11,107,"Lake Oval",-19,1937,"Regular",15,"Away","Geelong","Sydney",19
3523,1937-07-31,"R15","Melbourne",18,16,124,"St Kilda",11,18,84,"M.C.G.",40,1937,"Regular",15,"Home","Melbourne","St Kilda",40
3524,1937-08-07,"R16","Richmond",13,15,93,"Essendon",12,19,91,"Punt Rd",2,1937,"Regular",16,"Home","Richmond","Essendon",2
3525,1937-08-07,"R16","Sydney",10,16,76,"Fitzroy",15,8,98,"Lake Oval",-22,1937,"Regular",16,"Away","Fitzroy","Sydney",22
3526,1937-08-07,"R16","North Melbourne",8,16,64,"Footscray",13,13,91,"Arden St",-27,1937,"Regular",16,"Away","Footscray","North Melbourne",27
3527,1937-08-14,"R16","Carlton",12,16,88,"St Kilda",11,12,78,"Princes Park",10,1937,"Regular",16,"Home","Carlton","St Kilda",10
3528,1937-08-14,"R16","Collingwood",21,16,142,"Melbourne",22,21,153,"Victoria Park",-11,1937,"Regular",16,"Away","Melbourne","Collingwood",11
3529,1937-08-14,"R16","Hawthorn",13,13,91,"Geelong",17,12,114,"Glenferrie Oval",-23,1937,"Regular",16,"Away","Geelong","Hawthorn",23
3530,1937-08-21,"R17","Carlton",11,15,81,"Collingwood",9,17,71,"Princes Park",10,1937,"Regular",17,"Home","Carlton","Collingwood",10
3531,1937-08-21,"R17","Essendon",17,17,119,"Fitzroy",10,10,70,"Windy Hill",49,1937,"Regular",17,"Home","Essendon","Fitzroy",49
3532,1937-08-21,"R17","Melbourne",15,15,105,"Footscray",10,14,74,"M.C.G.",31,1937,"Regular",17,"Home","Melbourne","Footscray",31
3533,1937-08-21,"R17","Geelong",14,6,90,"Richmond",8,11,59,"Corio Oval",31,1937,"Regular",17,"Home","Geelong","Richmond",31
3534,1937-08-21,"R17","Hawthorn",15,12,102,"Sydney",10,15,75,"Glenferrie Oval",27,1937,"Regular",17,"Home","Hawthorn","Sydney",27
3535,1937-08-21,"R17","St Kilda",22,19,151,"North Melbourne",11,5,71,"Junction Oval",80,1937,"Regular",17,"Home","St Kilda","North Melbourne",80
3536,1937-08-28,"R18","Footscray",13,16,94,"Carlton",17,14,116,"Western Oval",-22,1937,"Regular",18,"Away","Carlton","Footscray",22
3537,1937-08-28,"R18","Collingwood",19,15,129,"St Kilda",13,13,91,"Victoria Park",38,1937,"Regular",18,"Home","Collingwood","St Kilda",38
3538,1937-08-28,"R18","Sydney",10,16,76,"Essendon",11,7,73,"Lake Oval",3,1937,"Regular",18,"Home","Sydney","Essendon",3
3539,1937-08-28,"R18","Fitzroy",12,9,81,"Geelong",16,13,109,"Brunswick St",-28,1937,"Regular",18,"Away","Geelong","Fitzroy",28
3540,1937-08-28,"R18","Richmond",14,13,97,"Hawthorn",13,14,92,"Punt Rd",5,1937,"Regular",18,"Home","Richmond","Hawthorn",5
3541,1937-08-28,"R18","North Melbourne",13,13,91,"Melbourne",19,16,130,"Arden St",-39,1937,"Regular",18,"Away","Melbourne","North Melbourne",39
3542,1937-09-04,"SF","Collingwood",18,12,120,"Richmond",10,9,69,"M.C.G.",51,1937,"Finals",19,"Home","Collingwood","Richmond",51
3543,1937-09-11,"SF","Geelong",19,11,125,"Melbourne",16,17,113,"M.C.G.",12,1937,"Finals",19,"Home","Geelong","Melbourne",12
3544,1937-09-18,"PF","Melbourne",7,10,52,"Collingwood",16,11,107,"M.C.G.",-55,1937,"Finals",20,"Away","Collingwood","Melbourne",55
3545,1937-09-25,"GF","Geelong",18,14,122,"Collingwood",12,18,90,"M.C.G.",32,1937,"Finals",21,"Home","Geelong","Collingwood",32
3546,1938-04-23,"R1","Hawthorn",11,10,76,"Carlton",14,8,92,"Glenferrie Oval",-16,1938,"Regular",1,"Away","Carlton","Hawthorn",16
3547,1938-04-23,"R1","Fitzroy",12,15,87,"Collingwood",14,21,105,"Brunswick St",-18,1938,"Regular",1,"Away","Collingwood","Fitzroy",18
3548,1938-04-23,"R1","Essendon",17,17,119,"St Kilda",12,13,85,"Windy Hill",34,1938,"Regular",1,"Home","Essendon","St Kilda",34
3549,1938-04-23,"R1","Sydney",14,13,97,"Footscray",9,14,68,"Lake Oval",29,1938,"Regular",1,"Home","Sydney","Footscray",29
3550,1938-04-23,"R1","Geelong",17,13,115,"Melbourne",20,12,132,"Corio Oval",-17,1938,"Regular",1,"Away","Melbourne","Geelong",17
3551,1938-04-23,"R1","Richmond",19,26,140,"North Melbourne",9,9,63,"Punt Rd",77,1938,"Regular",1,"Home","Richmond","North Melbourne",77
3552,1938-04-30,"R2","Carlton",12,23,95,"Richmond",14,10,94,"Princes Park",1,1938,"Regular",2,"Home","Carlton","Richmond",1
3553,1938-04-30,"R2","Collingwood",18,19,127,"Essendon",9,20,74,"Victoria Park",53,1938,"Regular",2,"Home","Collingwood","Essendon",53
3554,1938-04-30,"R2","Footscray",13,17,95,"Fitzroy",10,5,65,"Western Oval",30,1938,"Regular",2,"Home","Footscray","Fitzroy",30
3555,1938-04-30,"R2","St Kilda",13,16,94,"Geelong",8,17,65,"Junction Oval",29,1938,"Regular",2,"Home","St Kilda","Geelong",29
3556,1938-04-30,"R2","Melbourne",14,8,92,"Hawthorn",16,15,111,"M.C.G.",-19,1938,"Regular",2,"Away","Hawthorn","Melbourne",19
3557,1938-04-30,"R2","North Melbourne",9,10,64,"Sydney",6,8,44,"Arden St",20,1938,"Regular",2,"Home","North Melbourne","Sydney",20
3558,1938-05-07,"R3","Essendon",14,17,101,"Carlton",15,12,102,"Windy Hill",-1,1938,"Regular",3,"Away","Carlton","Essendon",1
3559,1938-05-07,"R3","Richmond",15,12,102,"Collingwood",11,26,92,"Punt Rd",10,1938,"Regular",3,"Home","Richmond","Collingwood",10
3560,1938-05-07,"R3","Fitzroy",12,11,83,"Melbourne",17,14,116,"Brunswick St",-33,1938,"Regular",3,"Away","Melbourne","Fitzroy",33
3561,1938-05-07,"R3","Hawthorn",8,14,62,"Footscray",9,16,70,"Glenferrie Oval",-8,1938,"Regular",3,"Away","Footscray","Hawthorn",8
3562,1938-05-07,"R3","Geelong",20,16,136,"North Melbourne",6,11,47,"Corio Oval",89,1938,"Regular",3,"Home","Geelong","North Melbourne",89
3563,1938-05-07,"R3","Sydney",8,12,60,"St Kilda",11,17,83,"Lake Oval",-23,1938,"Regular",3,"Away","St Kilda","Sydney",23
3564,1938-05-14,"R4","Carlton",17,19,121,"Fitzroy",10,10,70,"Princes Park",51,1938,"Regular",4,"Home","Carlton","Fitzroy",51
3565,1938-05-14,"R4","Collingwood",21,15,141,"Hawthorn",14,16,100,"Victoria Park",41,1938,"Regular",4,"Home","Collingwood","Hawthorn",41
3566,1938-05-14,"R4","North Melbourne",14,17,101,"Essendon",19,11,125,"Arden St",-24,1938,"Regular",4,"Away","Essendon","North Melbourne",24
3567,1938-05-14,"R4","Footscray",8,17,65,"Geelong",10,12,72,"Western Oval",-7,1938,"Regular",4,"Away","Geelong","Footscray",7
3568,1938-05-14,"R4","Melbourne",23,15,153,"Sydney",15,11,101,"M.C.G.",52,1938,"Regular",4,"Home","Melbourne","Sydney",52
3569,1938-05-14,"R4","St Kilda",15,9,99,"Richmond",13,11,89,"Junction Oval",10,1938,"Regular",4,"Home","St Kilda","Richmond",10
3570,1938-05-21,"R5","Collingwood",17,12,114,"Carlton",19,16,130,"Victoria Park",-16,1938,"Regular",5,"Away","Carlton","Collingwood",16
3571,1938-05-21,"R5","Essendon",15,15,105,"Sydney",11,19,85,"Windy Hill",20,1938,"Regular",5,"Home","Essendon","Sydney",20
3572,1938-05-21,"R5","Geelong",21,21,147,"Fitzroy",11,9,75,"Corio Oval",72,1938,"Regular",5,"Home","Geelong","Fitzroy",72
3573,1938-05-21,"R5","Melbourne",10,12,72,"Footscray",10,16,76,"M.C.G.",-4,1938,"Regular",5,"Away","Footscray","Melbourne",4
3574,1938-05-21,"R5","Hawthorn",13,9,87,"Richmond",12,12,84,"Glenferrie Oval",3,1938,"Regular",5,"Home","Hawthorn","Richmond",3
3575,1938-05-21,"R5","St Kilda",11,16,82,"North Melbourne",10,12,72,"Junction Oval",10,1938,"Regular",5,"Home","St Kilda","North Melbourne",10
3576,1938-05-28,"R6","Carlton",14,18,102,"Melbourne",16,11,107,"Princes Park",-5,1938,"Regular",6,"Away","Melbourne","Carlton",5
3577,1938-05-28,"R6","North Melbourne",10,7,67,"Collingwood",23,11,149,"Arden St",-82,1938,"Regular",6,"Away","Collingwood","North Melbourne",82
3578,1938-05-28,"R6","Fitzroy",14,9,93,"Essendon",11,13,79,"Brunswick St",14,1938,"Regular",6,"Home","Fitzroy","Essendon",14
3579,1938-05-28,"R6","Footscray",17,19,121,"St Kilda",7,13,55,"Western Oval",66,1938,"Regular",6,"Home","Footscray","St Kilda",66
3580,1938-05-28,"R6","Richmond",18,9,117,"Geelong",12,16,88,"Punt Rd",29,1938,"Regular",6,"Home","Richmond","Geelong",29
3581,1938-05-28,"R6","Sydney",13,16,94,"Hawthorn",18,12,120,"Lake Oval",-26,1938,"Regular",6,"Away","Hawthorn","Sydney",26
3582,1938-06-04,"R7","St Kilda",6,15,51,"Carlton",12,18,90,"Junction Oval",-39,1938,"Regular",7,"Away","Carlton","St Kilda",39
3583,1938-06-04,"R7","Melbourne",17,13,115,"Collingwood",15,11,101,"M.C.G.",14,1938,"Regular",7,"Home","Melbourne","Collingwood",14
3584,1938-06-04,"R7","Essendon",16,20,116,"Hawthorn",16,7,103,"Windy Hill",13,1938,"Regular",7,"Home","Essendon","Hawthorn",13
3585,1938-06-04,"R7","Fitzroy",12,15,87,"Richmond",14,10,94,"Brunswick St",-7,1938,"Regular",7,"Away","Richmond","Fitzroy",7
3586,1938-06-04,"R7","North Melbourne",9,14,68,"Footscray",9,16,70,"Arden St",-2,1938,"Regular",7,"Away","Footscray","North Melbourne",2
3587,1938-06-04,"R7","Geelong",19,32,146,"Sydney",10,10,70,"Corio Oval",76,1938,"Regular",7,"Home","Geelong","Sydney",76
3588,1938-06-11,"R8","Collingwood",16,23,119,"St Kilda",14,9,93,"Victoria Park",26,1938,"Regular",8,"Home","Collingwood","St Kilda",26
3589,1938-06-11,"R8","Essendon",12,12,84,"Geelong",14,23,107,"Windy Hill",-23,1938,"Regular",8,"Away","Geelong","Essendon",23
3590,1938-06-11,"R8","Melbourne",18,14,122,"North Melbourne",14,8,92,"M.C.G.",30,1938,"Regular",8,"Home","Melbourne","North Melbourne",30
3591,1938-06-13,"R12","St Kilda",15,13,103,"Essendon",22,17,149,"Junction Oval",-46,1938,"Regular",12,"Away","Essendon","St Kilda",46
3592,1938-06-13,"R8","Carlton",15,20,110,"Footscray",12,11,83,"Princes Park",27,1938,"Regular",8,"Home","Carlton","Footscray",27
3593,1938-06-13,"R8","Hawthorn",7,11,53,"Fitzroy",12,22,94,"Glenferrie Oval",-41,1938,"Regular",8,"Away","Fitzroy","Hawthorn",41
3594,1938-06-13,"R8","Sydney",8,14,62,"Richmond",20,15,135,"Lake Oval",-73,1938,"Regular",8,"Away","Richmond","Sydney",73
3595,1938-06-18,"R9","North Melbourne",11,5,71,"Carlton",16,25,121,"Arden St",-50,1938,"Regular",9,"Away","Carlton","North Melbourne",50
3596,1938-06-18,"R9","Footscray",13,9,87,"Collingwood",10,5,65,"Western Oval",22,1938,"Regular",9,"Home","Footscray","Collingwood",22
3597,1938-06-18,"R9","Richmond",15,14,104,"Essendon",15,9,99,"Punt Rd",5,1938,"Regular",9,"Home","Richmond","Essendon",5
3598,1938-06-18,"R9","Fitzroy",16,12,108,"Sydney",8,8,56,"Brunswick St",52,1938,"Regular",9,"Home","Fitzroy","Sydney",52
3599,1938-06-18,"R9","Geelong",11,23,89,"Hawthorn",6,13,49,"Corio Oval",40,1938,"Regular",9,"Home","Geelong","Hawthorn",40
3600,1938-06-18,"R9","St Kilda",14,12,96,"Melbourne",16,16,112,"Junction Oval",-16,1938,"Regular",9,"Away","Melbourne","St Kilda",16
3601,1938-06-25,"R10","Sydney",11,7,73,"Carlton",16,13,109,"Lake Oval",-36,1938,"Regular",10,"Away","Carlton","Sydney",36
3602,1938-06-25,"R10","Geelong",13,12,90,"Collingwood",13,17,95,"Corio Oval",-5,1938,"Regular",10,"Away","Collingwood","Geelong",5
3603,1938-06-25,"R10","Essendon",14,16,100,"Footscray",17,9,111,"Windy Hill",-11,1938,"Regular",10,"Away","Footscray","Essendon",11
3604,1938-06-25,"R10","Fitzroy",12,16,88,"North Melbourne",6,10,46,"Brunswick St",42,1938,"Regular",10,"Home","Fitzroy","North Melbourne",42
3605,1938-06-25,"R10","Hawthorn",8,12,60,"St Kilda",9,10,64,"Glenferrie Oval",-4,1938,"Regular",10,"Away","St Kilda","Hawthorn",4
3606,1938-06-25,"R10","Richmond",12,17,89,"Melbourne",10,8,68,"Punt Rd",21,1938,"Regular",10,"Home","Richmond","Melbourne",21
3607,1938-07-02,"R11","Carlton",12,16,88,"Geelong",12,10,82,"Princes Park",6,1938,"Regular",11,"Home","Carlton","Geelong",6
3608,1938-07-02,"R11","Collingwood",12,17,89,"Sydney",12,5,77,"Victoria Park",12,1938,"Regular",11,"Home","Collingwood","Sydney",12
3609,1938-07-02,"R11","Melbourne",11,13,79,"Essendon",13,7,85,"M.C.G.",-6,1938,"Regular",11,"Away","Essendon","Melbourne",6
3610,1938-07-02,"R11","St Kilda",11,8,74,"Fitzroy",10,11,71,"Junction Oval",3,1938,"Regular",11,"Home","St Kilda","Fitzroy",3
3611,1938-07-02,"R11","Footscray",13,20,98,"Richmond",7,4,46,"Western Oval",52,1938,"Regular",11,"Home","Footscray","Richmond",52
3612,1938-07-02,"R11","North Melbourne",13,14,92,"Hawthorn",12,6,78,"Arden St",14,1938,"Regular",11,"Home","North Melbourne","Hawthorn",14
3613,1938-07-09,"R12","Carlton",12,12,84,"Hawthorn",8,15,63,"Princes Park",21,1938,"Regular",12,"Home","Carlton","Hawthorn",21
3614,1938-07-09,"R12","Collingwood",10,19,79,"Fitzroy",10,13,73,"Victoria Park",6,1938,"Regular",12,"Home","Collingwood","Fitzroy",6
3615,1938-07-09,"R12","Footscray",19,19,133,"Sydney",10,10,70,"Western Oval",63,1938,"Regular",12,"Home","Footscray","Sydney",63
3616,1938-07-09,"R12","Melbourne",11,8,74,"Geelong",13,14,92,"M.C.G.",-18,1938,"Regular",12,"Away","Geelong","Melbourne",18
3617,1938-07-09,"R12","North Melbourne",14,3,87,"Richmond",12,11,83,"Arden St",4,1938,"Regular",12,"Home","North Melbourne","Richmond",4
3618,1938-07-23,"R13","Richmond",20,12,132,"Carlton",12,19,91,"Punt Rd",41,1938,"Regular",13,"Home","Richmond","Carlton",41
3619,1938-07-23,"R13","Essendon",17,17,119,"Collingwood",17,16,118,"Windy Hill",1,1938,"Regular",13,"Home","Essendon","Collingwood",1
3620,1938-07-23,"R13","Fitzroy",13,8,86,"Footscray",18,21,129,"Brunswick St",-43,1938,"Regular",13,"Away","Footscray","Fitzroy",43
3621,1938-07-23,"R13","Geelong",14,20,104,"St Kilda",15,13,103,"Corio Oval",1,1938,"Regular",13,"Home","Geelong","St Kilda",1
3622,1938-07-23,"R13","Hawthorn",10,9,69,"Melbourne",9,16,70,"Glenferrie Oval",-1,1938,"Regular",13,"Away","Melbourne","Hawthorn",1
3623,1938-07-23,"R13","Sydney",14,11,95,"North Melbourne",13,18,96,"Lake Oval",-1,1938,"Regular",13,"Away","North Melbourne","Sydney",1
3624,1938-07-30,"R14","Carlton",11,16,82,"Essendon",10,16,76,"Princes Park",6,1938,"Regular",14,"Home","Carlton","Essendon",6
3625,1938-07-30,"R14","Collingwood",9,9,63,"Richmond",11,10,76,"Victoria Park",-13,1938,"Regular",14,"Away","Richmond","Collingwood",13
3626,1938-07-30,"R14","Melbourne",14,12,96,"Fitzroy",14,9,93,"M.C.G.",3,1938,"Regular",14,"Home","Melbourne","Fitzroy",3
3627,1938-07-30,"R14","Footscray",17,14,116,"Hawthorn",4,7,31,"Western Oval",85,1938,"Regular",14,"Home","Footscray","Hawthorn",85
3628,1938-07-30,"R14","North Melbourne",7,9,51,"Geelong",15,16,106,"Arden St",-55,1938,"Regular",14,"Away","Geelong","North Melbourne",55
3629,1938-07-30,"R14","St Kilda",10,12,72,"Sydney",7,12,54,"Junction Oval",18,1938,"Regular",14,"Home","St Kilda","Sydney",18
3630,1938-08-06,"R15","Fitzroy",11,10,76,"Carlton",19,12,126,"Brunswick St",-50,1938,"Regular",15,"Away","Carlton","Fitzroy",50
3631,1938-08-06,"R15","Hawthorn",12,11,83,"Collingwood",18,15,123,"Glenferrie Oval",-40,1938,"Regular",15,"Away","Collingwood","Hawthorn",40
3632,1938-08-06,"R15","Essendon",13,9,87,"North Melbourne",16,8,104,"Windy Hill",-17,1938,"Regular",15,"Away","North Melbourne","Essendon",17
3633,1938-08-06,"R15","Geelong",13,15,93,"Footscray",10,10,70,"Corio Oval",23,1938,"Regular",15,"Home","Geelong","Footscray",23
3634,1938-08-06,"R15","Sydney",9,16,70,"Melbourne",14,15,99,"Lake Oval",-29,1938,"Regular",15,"Away","Melbourne","Sydney",29
3635,1938-08-06,"R15","Richmond",7,11,53,"St Kilda",7,14,56,"Punt Rd",-3,1938,"Regular",15,"Away","St Kilda","Richmond",3
3636,1938-08-13,"R16","Carlton",14,17,101,"Collingwood",19,7,121,"Princes Park",-20,1938,"Regular",16,"Away","Collingwood","Carlton",20
3637,1938-08-13,"R16","Sydney",13,13,91,"Essendon",12,14,86,"Lake Oval",5,1938,"Regular",16,"Home","Sydney","Essendon",5
3638,1938-08-13,"R16","Fitzroy",13,12,90,"Geelong",19,12,126,"Brunswick St",-36,1938,"Regular",16,"Away","Geelong","Fitzroy",36
3639,1938-08-13,"R16","Footscray",19,17,131,"Melbourne",13,13,91,"Western Oval",40,1938,"Regular",16,"Home","Footscray","Melbourne",40
3640,1938-08-13,"R16","Richmond",19,18,132,"Hawthorn",12,11,83,"Punt Rd",49,1938,"Regular",16,"Home","Richmond","Hawthorn",49
3641,1938-08-13,"R16","North Melbourne",12,11,83,"St Kilda",7,15,57,"Arden St",26,1938,"Regular",16,"Home","North Melbourne","St Kilda",26
3642,1938-08-20,"R17","Melbourne",14,12,96,"Carlton",11,13,79,"M.C.G.",17,1938,"Regular",17,"Home","Melbourne","Carlton",17
3643,1938-08-20,"R17","Collingwood",22,18,150,"North Melbourne",14,12,96,"Victoria Park",54,1938,"Regular",17,"Home","Collingwood","North Melbourne",54
3644,1938-08-20,"R17","Essendon",15,17,107,"Fitzroy",15,6,96,"Windy Hill",11,1938,"Regular",17,"Home","Essendon","Fitzroy",11
3645,1938-08-20,"R17","St Kilda",17,17,119,"Footscray",12,9,81,"Junction Oval",38,1938,"Regular",17,"Home","St Kilda","Footscray",38
3646,1938-08-20,"R17","Geelong",20,17,137,"Richmond",12,12,84,"Corio Oval",53,1938,"Regular",17,"Home","Geelong","Richmond",53
3647,1938-08-20,"R17","Hawthorn",17,15,117,"Sydney",9,20,74,"Glenferrie Oval",43,1938,"Regular",17,"Home","Hawthorn","Sydney",43
3648,1938-08-27,"R18","Carlton",15,14,104,"St Kilda",13,10,88,"Princes Park",16,1938,"Regular",18,"Home","Carlton","St Kilda",16
3649,1938-08-27,"R18","Collingwood",12,19,91,"Melbourne",11,16,82,"Victoria Park",9,1938,"Regular",18,"Home","Collingwood","Melbourne",9
3650,1938-08-27,"R18","Hawthorn",9,15,69,"Essendon",12,18,90,"Glenferrie Oval",-21,1938,"Regular",18,"Away","Essendon","Hawthorn",21
3651,1938-08-27,"R18","Richmond",13,15,93,"Fitzroy",15,18,108,"Punt Rd",-15,1938,"Regular",18,"Away","Fitzroy","Richmond",15
3652,1938-08-27,"R18","Footscray",18,11,119,"North Melbourne",11,18,84,"Western Oval",35,1938,"Regular",18,"Home","Footscray","North Melbourne",35
3653,1938-08-27,"R18","Sydney",12,8,80,"Geelong",15,12,102,"Lake Oval",-22,1938,"Regular",18,"Away","Geelong","Sydney",22
3654,1938-09-03,"SF","Footscray",10,16,76,"Collingwood",18,9,117,"M.C.G.",-41,1938,"Finals",19,"Away","Collingwood","Footscray",41
3655,1938-09-10,"SF","Carlton",16,17,113,"Geelong",10,21,81,"M.C.G.",32,1938,"Finals",19,"Home","Carlton","Geelong",32
3656,1938-09-17,"PF","Geelong",14,14,98,"Collingwood",21,9,135,"M.C.G.",-37,1938,"Finals",20,"Away","Collingwood","Geelong",37
3657,1938-09-24,"GF","Carlton",15,10,100,"Collingwood",13,7,85,"M.C.G.",15,1938,"Finals",21,"Home","Carlton","Collingwood",15
3658,1939-04-22,"R1","Carlton",20,22,142,"Sydney",13,10,88,"Princes Park",54,1939,"Regular",1,"Home","Carlton","Sydney",54
3659,1939-04-22,"R1","Collingwood",18,14,122,"Geelong",14,7,91,"Victoria Park",31,1939,"Regular",1,"Home","Collingwood","Geelong",31
3660,1939-04-22,"R1","Footscray",14,18,102,"Essendon",15,17,107,"Western Oval",-5,1939,"Regular",1,"Away","Essendon","Footscray",5
3661,1939-04-22,"R1","North Melbourne",11,9,75,"Fitzroy",9,12,66,"Arden St",9,1939,"Regular",1,"Home","North Melbourne","Fitzroy",9
3662,1939-04-22,"R1","St Kilda",18,20,128,"Hawthorn",9,13,67,"Junction Oval",61,1939,"Regular",1,"Home","St Kilda","Hawthorn",61
3663,1939-04-22,"R1","Melbourne",11,18,84,"Richmond",17,19,121,"M.C.G.",-37,1939,"Regular",1,"Away","Richmond","Melbourne",37
3664,1939-04-29,"R2","Geelong",14,8,92,"Carlton",11,13,79,"Corio Oval",13,1939,"Regular",2,"Home","Geelong","Carlton",13
3665,1939-04-29,"R2","Sydney",15,17,107,"Collingwood",21,20,146,"Lake Oval",-39,1939,"Regular",2,"Away","Collingwood","Sydney",39
3666,1939-04-29,"R2","Essendon",19,21,135,"Melbourne",21,15,141,"Windy Hill",-6,1939,"Regular",2,"Away","Melbourne","Essendon",6
3667,1939-04-29,"R2","Fitzroy",14,18,102,"St Kilda",20,14,134,"Brunswick St",-32,1939,"Regular",2,"Away","St Kilda","Fitzroy",32
3668,1939-04-29,"R2","Richmond",20,19,139,"Footscray",17,8,110,"Punt Rd",29,1939,"Regular",2,"Home","Richmond","Footscray",29
3669,1939-04-29,"R2","Hawthorn",17,13,115,"North Melbourne",11,11,77,"Glenferrie Oval",38,1939,"Regular",2,"Home","Hawthorn","North Melbourne",38
3670,1939-05-06,"R3","Carlton",17,21,123,"North Melbourne",16,10,106,"Princes Park",17,1939,"Regular",3,"Home","Carlton","North Melbourne",17
3671,1939-05-06,"R3","Collingwood",17,11,113,"Footscray",14,14,98,"Victoria Park",15,1939,"Regular",3,"Home","Collingwood","Footscray",15
3672,1939-05-06,"R3","Essendon",16,8,104,"Richmond",15,16,106,"Windy Hill",-2,1939,"Regular",3,"Away","Richmond","Essendon",2
3673,1939-05-06,"R3","Sydney",9,14,68,"Fitzroy",10,17,77,"Lake Oval",-9,1939,"Regular",3,"Away","Fitzroy","Sydney",9
3674,1939-05-06,"R3","Hawthorn",17,14,116,"Geelong",8,18,66,"Glenferrie Oval",50,1939,"Regular",3,"Home","Hawthorn","Geelong",50
3675,1939-05-06,"R3","Melbourne",16,16,112,"St Kilda",10,21,81,"M.C.G.",31,1939,"Regular",3,"Home","Melbourne","St Kilda",31
3676,1939-05-13,"R4","Footscray",5,12,42,"Carlton",14,16,100,"Western Oval",-58,1939,"Regular",4,"Away","Carlton","Footscray",58
3677,1939-05-13,"R4","St Kilda",20,11,131,"Collingwood",13,16,94,"Junction Oval",37,1939,"Regular",4,"Home","St Kilda","Collingwood",37
3678,1939-05-13,"R4","Geelong",19,15,129,"Essendon",11,15,81,"Corio Oval",48,1939,"Regular",4,"Home","Geelong","Essendon",48
3679,1939-05-13,"R4","Fitzroy",10,17,77,"Hawthorn",11,11,77,"Brunswick St",0,1939,"Regular",4,"Home","Fitzroy","Hawthorn",0
3680,1939-05-13,"R4","North Melbourne",11,8,74,"Melbourne",15,20,110,"Arden St",-36,1939,"Regular",4,"Away","Melbourne","North Melbourne",36
3681,1939-05-13,"R4","Richmond",14,24,108,"Sydney",13,7,85,"Punt Rd",23,1939,"Regular",4,"Home","Richmond","Sydney",23
3682,1939-05-20,"R5","Hawthorn",13,8,86,"Carlton",11,17,83,"Glenferrie Oval",3,1939,"Regular",5,"Home","Hawthorn","Carlton",3
3683,1939-05-20,"R5","Fitzroy",11,13,79,"Collingwood",17,14,116,"Brunswick St",-37,1939,"Regular",5,"Away","Collingwood","Fitzroy",37
3684,1939-05-20,"R5","Essendon",14,21,105,"St Kilda",8,18,66,"Windy Hill",39,1939,"Regular",5,"Home","Essendon","St Kilda",39
3685,1939-05-20,"R5","Sydney",18,12,120,"Footscray",16,6,102,"Lake Oval",18,1939,"Regular",5,"Home","Sydney","Footscray",18
3686,1939-05-20,"R5","Geelong",12,18,90,"Melbourne",15,16,106,"Corio Oval",-16,1939,"Regular",5,"Away","Melbourne","Geelong",16
3687,1939-05-20,"R5","Richmond",16,22,118,"North Melbourne",13,11,89,"Punt Rd",29,1939,"Regular",5,"Home","Richmond","North Melbourne",29
3688,1939-05-27,"R6","Carlton",8,13,61,"Richmond",9,14,68,"Princes Park",-7,1939,"Regular",6,"Away","Richmond","Carlton",7
3689,1939-05-27,"R6","Collingwood",14,14,98,"Hawthorn",12,7,79,"Victoria Park",19,1939,"Regular",6,"Home","Collingwood","Hawthorn",19
3690,1939-05-27,"R6","North Melbourne",15,11,101,"Essendon",13,10,88,"Arden St",13,1939,"Regular",6,"Home","North Melbourne","Essendon",13
3691,1939-05-27,"R6","Footscray",11,13,79,"Fitzroy",15,10,100,"Western Oval",-21,1939,"Regular",6,"Away","Fitzroy","Footscray",21
3692,1939-05-27,"R6","St Kilda",16,18,114,"Geelong",10,16,76,"Junction Oval",38,1939,"Regular",6,"Home","St Kilda","Geelong",38
3693,1939-05-27,"R6","Melbourne",19,23,137,"Sydney",3,12,30,"M.C.G.",107,1939,"Regular",6,"Home","Melbourne","Sydney",107
3694,1939-06-03,"R7","Essendon",10,12,72,"Carlton",10,18,78,"Windy Hill",-6,1939,"Regular",7,"Away","Carlton","Essendon",6
3695,1939-06-03,"R7","Richmond",6,17,53,"Collingwood",12,17,89,"Punt Rd",-36,1939,"Regular",7,"Away","Collingwood","Richmond",36
3696,1939-06-03,"R7","Fitzroy",14,15,99,"Melbourne",18,14,122,"Brunswick St",-23,1939,"Regular",7,"Away","Melbourne","Fitzroy",23
3697,1939-06-03,"R7","Hawthorn",12,15,87,"Footscray",7,23,65,"Glenferrie Oval",22,1939,"Regular",7,"Home","Hawthorn","Footscray",22
3698,1939-06-03,"R7","Geelong",17,13,115,"North Melbourne",14,13,97,"Corio Oval",18,1939,"Regular",7,"Home","Geelong","North Melbourne",18
3699,1939-06-03,"R7","Sydney",8,14,62,"St Kilda",13,17,95,"Lake Oval",-33,1939,"Regular",7,"Away","St Kilda","Sydney",33
3700,1939-06-10,"R8","Collingwood",18,15,123,"Carlton",12,12,84,"Victoria Park",39,1939,"Regular",8,"Home","Collingwood","Carlton",39
3701,1939-06-10,"R8","Hawthorn",7,13,55,"Richmond",12,21,93,"Glenferrie Oval",-38,1939,"Regular",8,"Away","Richmond","Hawthorn",38
3702,1939-06-10,"R8","St Kilda",18,12,120,"North Melbourne",16,10,106,"Junction Oval",14,1939,"Regular",8,"Home","St Kilda","North Melbourne",14
3703,1939-06-12,"R8","Essendon",9,16,70,"Sydney",13,13,91,"Windy Hill",-21,1939,"Regular",8,"Away","Sydney","Essendon",21
3704,1939-06-12,"R8","Geelong",21,17,143,"Fitzroy",14,12,96,"Corio Oval",47,1939,"Regular",8,"Home","Geelong","Fitzroy",47
3705,1939-06-12,"R8","Melbourne",18,14,122,"Footscray",15,13,103,"M.C.G.",19,1939,"Regular",8,"Home","Melbourne","Footscray",19
3706,1939-06-17,"R9","Carlton",19,19,133,"Melbourne",15,13,103,"Princes Park",30,1939,"Regular",9,"Home","Carlton","Melbourne",30
3707,1939-06-17,"R9","North Melbourne",10,18,78,"Collingwood",14,21,105,"Arden St",-27,1939,"Regular",9,"Away","Collingwood","North Melbourne",27
3708,1939-06-17,"R9","Fitzroy",11,15,81,"Essendon",13,12,90,"Brunswick St",-9,1939,"Regular",9,"Away","Essendon","Fitzroy",9
3709,1939-06-17,"R9","Footscray",12,14,86,"St Kilda",19,16,130,"Western Oval",-44,1939,"Regular",9,"Away","St Kilda","Footscray",44
3710,1939-06-17,"R9","Richmond",12,22,94,"Geelong",9,15,69,"Punt Rd",25,1939,"Regular",9,"Home","Richmond","Geelong",25
3711,1939-06-17,"R9","Sydney",15,18,108,"Hawthorn",12,14,86,"Lake Oval",22,1939,"Regular",9,"Home","Sydney","Hawthorn",22
3712,1939-06-24,"R10","St Kilda",14,14,98,"Carlton",9,16,70,"Junction Oval",28,1939,"Regular",10,"Home","St Kilda","Carlton",28
3713,1939-06-24,"R10","Melbourne",22,22,154,"Collingwood",8,12,60,"M.C.G.",94,1939,"Regular",10,"Home","Melbourne","Collingwood",94
3714,1939-06-24,"R10","Essendon",19,11,125,"Hawthorn",16,19,115,"Windy Hill",10,1939,"Regular",10,"Home","Essendon","Hawthorn",10
3715,1939-06-24,"R10","Fitzroy",17,13,115,"Richmond",10,13,73,"Brunswick St",42,1939,"Regular",10,"Home","Fitzroy","Richmond",42
3716,1939-06-24,"R10","North Melbourne",15,12,102,"Footscray",11,10,76,"Arden St",26,1939,"Regular",10,"Home","North Melbourne","Footscray",26
3717,1939-06-24,"R10","Geelong",16,15,111,"Sydney",7,14,56,"Corio Oval",55,1939,"Regular",10,"Home","Geelong","Sydney",55
3718,1939-07-01,"R11","Carlton",15,13,103,"Fitzroy",7,18,60,"Princes Park",43,1939,"Regular",11,"Home","Carlton","Fitzroy",43
3719,1939-07-01,"R11","Collingwood",18,9,117,"Essendon",7,18,60,"Victoria Park",57,1939,"Regular",11,"Home","Collingwood","Essendon",57
3720,1939-07-01,"R11","Footscray",5,10,40,"Geelong",3,7,25,"Western Oval",15,1939,"Regular",11,"Home","Footscray","Geelong",15
3721,1939-07-01,"R11","Hawthorn",8,4,52,"Melbourne",7,12,54,"Glenferrie Oval",-2,1939,"Regular",11,"Away","Melbourne","Hawthorn",2
3722,1939-07-01,"R11","Sydney",7,6,48,"North Melbourne",14,12,96,"Lake Oval",-48,1939,"Regular",11,"Away","North Melbourne","Sydney",48
3723,1939-07-01,"R11","Richmond",7,9,51,"St Kilda",9,12,66,"Punt Rd",-15,1939,"Regular",11,"Away","St Kilda","Richmond",15
3724,1939-07-08,"R12","Sydney",12,16,88,"Carlton",16,17,113,"Lake Oval",-25,1939,"Regular",12,"Away","Carlton","Sydney",25
3725,1939-07-08,"R12","Geelong",18,12,120,"Collingwood",16,13,109,"Corio Oval",11,1939,"Regular",12,"Home","Geelong","Collingwood",11
3726,1939-07-08,"R12","Essendon",17,20,122,"Footscray",18,15,123,"Windy Hill",-1,1939,"Regular",12,"Away","Footscray","Essendon",1
3727,1939-07-08,"R12","Fitzroy",10,20,80,"North Melbourne",9,16,70,"Brunswick St",10,1939,"Regular",12,"Home","Fitzroy","North Melbourne",10
3728,1939-07-08,"R12","Hawthorn",11,18,84,"St Kilda",15,17,107,"Glenferrie Oval",-23,1939,"Regular",12,"Away","St Kilda","Hawthorn",23
3729,1939-07-08,"R12","Richmond",13,21,99,"Melbourne",15,16,106,"Punt Rd",-7,1939,"Regular",12,"Away","Melbourne","Richmond",7
3730,1939-07-15,"R13","Carlton",14,14,98,"Geelong",12,5,77,"Princes Park",21,1939,"Regular",13,"Home","Carlton","Geelong",21
3731,1939-07-15,"R13","Collingwood",19,11,125,"Sydney",8,13,61,"Victoria Park",64,1939,"Regular",13,"Home","Collingwood","Sydney",64
3732,1939-07-15,"R13","Melbourne",7,18,60,"Essendon",10,17,77,"M.C.G.",-17,1939,"Regular",13,"Away","Essendon","Melbourne",17
3733,1939-07-15,"R13","St Kilda",16,19,115,"Fitzroy",13,6,84,"Junction Oval",31,1939,"Regular",13,"Home","St Kilda","Fitzroy",31
3734,1939-07-15,"R13","Footscray",7,7,49,"Richmond",13,25,103,"Western Oval",-54,1939,"Regular",13,"Away","Richmond","Footscray",54
3735,1939-07-15,"R13","North Melbourne",18,11,119,"Hawthorn",11,16,82,"Arden St",37,1939,"Regular",13,"Home","North Melbourne","Hawthorn",37
3736,1939-07-22,"R14","North Melbourne",10,13,73,"Carlton",11,13,79,"Arden St",-6,1939,"Regular",14,"Away","Carlton","North Melbourne",6
3737,1939-07-22,"R14","Footscray",9,14,68,"Collingwood",13,7,85,"Western Oval",-17,1939,"Regular",14,"Away","Collingwood","Footscray",17
3738,1939-07-22,"R14","Richmond",18,14,122,"Essendon",10,8,68,"Punt Rd",54,1939,"Regular",14,"Home","Richmond","Essendon",54
3739,1939-07-22,"R14","Fitzroy",15,19,109,"Sydney",9,9,63,"Brunswick St",46,1939,"Regular",14,"Home","Fitzroy","Sydney",46
3740,1939-07-22,"R14","Geelong",15,22,112,"Hawthorn",13,12,90,"Corio Oval",22,1939,"Regular",14,"Home","Geelong","Hawthorn",22
3741,1939-07-22,"R14","St Kilda",10,18,78,"Melbourne",15,12,102,"Junction Oval",-24,1939,"Regular",14,"Away","Melbourne","St Kilda",24
3742,1939-08-05,"R15","Carlton",24,15,159,"Footscray",9,17,71,"Princes Park",88,1939,"Regular",15,"Home","Carlton","Footscray",88
3743,1939-08-05,"R15","Collingwood",18,8,116,"St Kilda",13,11,89,"Victoria Park",27,1939,"Regular",15,"Home","Collingwood","St Kilda",27
3744,1939-08-05,"R15","Essendon",15,17,107,"Geelong",6,11,47,"Windy Hill",60,1939,"Regular",15,"Home","Essendon","Geelong",60
3745,1939-08-05,"R15","Hawthorn",10,20,80,"Fitzroy",12,7,79,"Glenferrie Oval",1,1939,"Regular",15,"Home","Hawthorn","Fitzroy",1
3746,1939-08-05,"R15","Melbourne",14,18,102,"North Melbourne",9,6,60,"M.C.G.",42,1939,"Regular",15,"Home","Melbourne","North Melbourne",42
3747,1939-08-05,"R15","Sydney",12,6,78,"Richmond",18,15,123,"Lake Oval",-45,1939,"Regular",15,"Away","Richmond","Sydney",45
3748,1939-08-12,"R16","Carlton",18,16,124,"Hawthorn",7,20,62,"Princes Park",62,1939,"Regular",16,"Home","Carlton","Hawthorn",62
3749,1939-08-12,"R16","Collingwood",16,8,104,"Fitzroy",10,13,73,"Victoria Park",31,1939,"Regular",16,"Home","Collingwood","Fitzroy",31
3750,1939-08-12,"R16","St Kilda",13,13,91,"Essendon",18,14,122,"Junction Oval",-31,1939,"Regular",16,"Away","Essendon","St Kilda",31
3751,1939-08-12,"R16","Footscray",19,15,129,"Sydney",12,10,82,"Western Oval",47,1939,"Regular",16,"Home","Footscray","Sydney",47
3752,1939-08-12,"R16","Melbourne",22,16,148,"Geelong",13,17,95,"M.C.G.",53,1939,"Regular",16,"Home","Melbourne","Geelong",53
3753,1939-08-12,"R16","North Melbourne",15,11,101,"Richmond",18,8,116,"Arden St",-15,1939,"Regular",16,"Away","Richmond","North Melbourne",15
3754,1939-08-19,"R17","Richmond",13,10,88,"Carlton",6,13,49,"Punt Rd",39,1939,"Regular",17,"Home","Richmond","Carlton",39
3755,1939-08-19,"R17","Hawthorn",6,15,51,"Collingwood",7,17,59,"Glenferrie Oval",-8,1939,"Regular",17,"Away","Collingwood","Hawthorn",8
3756,1939-08-19,"R17","Essendon",14,17,101,"North Melbourne",9,7,61,"Windy Hill",40,1939,"Regular",17,"Home","Essendon","North Melbourne",40
3757,1939-08-19,"R17","Fitzroy",10,10,70,"Footscray",10,8,68,"Brunswick St",2,1939,"Regular",17,"Home","Fitzroy","Footscray",2
3758,1939-08-19,"R17","Geelong",7,17,59,"St Kilda",12,12,84,"Corio Oval",-25,1939,"Regular",17,"Away","St Kilda","Geelong",25
3759,1939-08-19,"R17","Sydney",11,14,80,"Melbourne",12,12,84,"Lake Oval",-4,1939,"Regular",17,"Away","Melbourne","Sydney",4
3760,1939-09-02,"R18","Carlton",16,22,118,"Essendon",8,14,62,"Princes Park",56,1939,"Regular",18,"Home","Carlton","Essendon",56
3761,1939-09-02,"R18","Collingwood",13,13,91,"Richmond",8,11,59,"Victoria Park",32,1939,"Regular",18,"Home","Collingwood","Richmond",32
3762,1939-09-02,"R18","Melbourne",11,15,81,"Fitzroy",4,11,35,"M.C.G.",46,1939,"Regular",18,"Home","Melbourne","Fitzroy",46
3763,1939-09-02,"R18","Footscray",11,17,83,"Hawthorn",6,7,43,"Western Oval",40,1939,"Regular",18,"Home","Footscray","Hawthorn",40
3764,1939-09-02,"R18","North Melbourne",11,10,76,"Geelong",9,11,65,"Arden St",11,1939,"Regular",18,"Home","North Melbourne","Geelong",11
3765,1939-09-02,"R18","St Kilda",11,13,79,"Sydney",6,16,52,"Junction Oval",27,1939,"Regular",18,"Home","St Kilda","Sydney",27
3766,1939-09-09,"SF","Richmond",6,6,42,"St Kilda",10,12,72,"M.C.G.",-30,1939,"Finals",19,"Away","St Kilda","Richmond",30
3767,1939-09-16,"SF","Melbourne",15,14,104,"Collingwood",12,18,90,"M.C.G.",14,1939,"Finals",19,"Home","Melbourne","Collingwood",14
3768,1939-09-23,"PF","Collingwood",20,14,134,"St Kilda",15,15,105,"M.C.G.",29,1939,"Finals",20,"Home","Collingwood","St Kilda",29
3769,1939-09-30,"GF","Melbourne",21,22,148,"Collingwood",14,11,95,"M.C.G.",53,1939,"Finals",21,"Home","Melbourne","Collingwood",53
3770,1940-04-27,"R1","Geelong",9,18,72,"Carlton",12,27,99,"Corio Oval",-27,1940,"Regular",1,"Away","Carlton","Geelong",27
3771,1940-04-27,"R1","Sydney",11,14,80,"Collingwood",13,14,92,"Lake Oval",-12,1940,"Regular",1,"Away","Collingwood","Sydney",12
3772,1940-04-27,"R1","Essendon",18,17,125,"Melbourne",16,12,108,"Windy Hill",17,1940,"Regular",1,"Home","Essendon","Melbourne",17
3773,1940-04-27,"R1","Fitzroy",13,13,91,"St Kilda",10,20,80,"Brunswick St",11,1940,"Regular",1,"Home","Fitzroy","St Kilda",11
3774,1940-04-27,"R1","Richmond",14,19,103,"Footscray",17,13,115,"Punt Rd",-12,1940,"Regular",1,"Away","Footscray","Richmond",12
3775,1940-04-27,"R1","Hawthorn",25,11,161,"North Melbourne",13,11,89,"Glenferrie Oval",72,1940,"Regular",1,"Home","Hawthorn","North Melbourne",72
3776,1940-05-04,"R2","Carlton",15,19,109,"Sydney",12,5,77,"Princes Park",32,1940,"Regular",2,"Home","Carlton","Sydney",32
3777,1940-05-04,"R2","Collingwood",11,13,79,"Geelong",14,10,94,"Victoria Park",-15,1940,"Regular",2,"Away","Geelong","Collingwood",15
3778,1940-05-04,"R2","Footscray",17,9,111,"Essendon",9,12,66,"Western Oval",45,1940,"Regular",2,"Home","Footscray","Essendon",45
3779,1940-05-04,"R2","North Melbourne",15,16,106,"Fitzroy",7,9,51,"Arden St",55,1940,"Regular",2,"Home","North Melbourne","Fitzroy",55
3780,1940-05-04,"R2","St Kilda",12,25,97,"Hawthorn",7,13,55,"Junction Oval",42,1940,"Regular",2,"Home","St Kilda","Hawthorn",42
3781,1940-05-04,"R2","Melbourne",18,14,122,"Richmond",14,15,99,"M.C.G.",23,1940,"Regular",2,"Home","Melbourne","Richmond",23
3782,1940-05-11,"R3","Collingwood",18,19,127,"Carlton",12,18,90,"Victoria Park",37,1940,"Regular",3,"Home","Collingwood","Carlton",37
3783,1940-05-11,"R3","Essendon",12,14,86,"Sydney",10,15,75,"Windy Hill",11,1940,"Regular",3,"Home","Essendon","Sydney",11
3784,1940-05-11,"R3","Geelong",16,19,115,"Fitzroy",13,8,86,"Corio Oval",29,1940,"Regular",3,"Home","Geelong","Fitzroy",29
3785,1940-05-11,"R3","Melbourne",20,21,141,"Footscray",15,12,102,"M.C.G.",39,1940,"Regular",3,"Home","Melbourne","Footscray",39
3786,1940-05-11,"R3","Hawthorn",15,12,102,"Richmond",19,15,129,"Glenferrie Oval",-27,1940,"Regular",3,"Away","Richmond","Hawthorn",27
3787,1940-05-11,"R3","St Kilda",12,12,84,"North Melbourne",9,11,65,"Junction Oval",19,1940,"Regular",3,"Home","St Kilda","North Melbourne",19
3788,1940-05-18,"R4","Carlton",13,12,90,"Melbourne",16,20,116,"Princes Park",-26,1940,"Regular",4,"Away","Melbourne","Carlton",26
3789,1940-05-18,"R4","North Melbourne",14,15,99,"Collingwood",10,15,75,"Arden St",24,1940,"Regular",4,"Home","North Melbourne","Collingwood",24
3790,1940-05-18,"R4","Fitzroy",12,15,87,"Essendon",10,16,76,"Brunswick St",11,1940,"Regular",4,"Home","Fitzroy","Essendon",11
3791,1940-05-18,"R4","Footscray",9,16,70,"St Kilda",13,14,92,"Western Oval",-22,1940,"Regular",4,"Away","St Kilda","Footscray",22
3792,1940-05-18,"R4","Richmond",17,15,117,"Geelong",11,6,72,"Punt Rd",45,1940,"Regular",4,"Home","Richmond","Geelong",45
3793,1940-05-18,"R4","Sydney",22,13,145,"Hawthorn",16,10,106,"Lake Oval",39,1940,"Regular",4,"Home","Sydney","Hawthorn",39
3794,1940-05-25,"R5","St Kilda",6,18,54,"Carlton",11,19,85,"Junction Oval",-31,1940,"Regular",5,"Away","Carlton","St Kilda",31
3795,1940-05-25,"R5","Melbourne",17,12,114,"Collingwood",13,20,98,"M.C.G.",16,1940,"Regular",5,"Home","Melbourne","Collingwood",16
3796,1940-05-25,"R5","Essendon",12,18,90,"Hawthorn",9,19,73,"Windy Hill",17,1940,"Regular",5,"Home","Essendon","Hawthorn",17
3797,1940-05-25,"R5","Fitzroy",8,14,62,"Richmond",12,11,83,"Brunswick St",-21,1940,"Regular",5,"Away","Richmond","Fitzroy",21
3798,1940-05-25,"R5","North Melbourne",7,11,53,"Footscray",9,12,66,"Arden St",-13,1940,"Regular",5,"Away","Footscray","North Melbourne",13
3799,1940-05-25,"R5","Geelong",12,21,93,"Sydney",10,12,72,"Corio Oval",21,1940,"Regular",5,"Home","Geelong","Sydney",21
3800,1940-06-01,"R6","Carlton",10,16,76,"Fitzroy",8,14,62,"Princes Park",14,1940,"Regular",6,"Home","Carlton","Fitzroy",14
3801,1940-06-01,"R6","Collingwood",12,13,85,"Essendon",11,17,83,"Victoria Park",2,1940,"Regular",6,"Home","Collingwood","Essendon",2
3802,1940-06-01,"R6","Footscray",10,6,66,"Geelong",10,14,74,"Western Oval",-8,1940,"Regular",6,"Away","Geelong","Footscray",8
3803,1940-06-01,"R6","Hawthorn",12,15,87,"Melbourne",11,15,81,"Glenferrie Oval",6,1940,"Regular",6,"Home","Hawthorn","Melbourne",6
3804,1940-06-01,"R6","Sydney",16,9,105,"North Melbourne",16,8,104,"Lake Oval",1,1940,"Regular",6,"Home","Sydney","North Melbourne",1
3805,1940-06-01,"R6","Richmond",17,10,112,"St Kilda",11,10,76,"Punt Rd",36,1940,"Regular",6,"Home","Richmond","St Kilda",36
3806,1940-06-08,"R7","Footscray",12,18,90,"Carlton",12,8,80,"Western Oval",10,1940,"Regular",7,"Home","Footscray","Carlton",10
3807,1940-06-08,"R7","St Kilda",10,12,72,"Collingwood",13,14,92,"Junction Oval",-20,1940,"Regular",7,"Away","Collingwood","St Kilda",20
3808,1940-06-08,"R7","Geelong",9,13,67,"Essendon",10,22,82,"Corio Oval",-15,1940,"Regular",7,"Away","Essendon","Geelong",15
3809,1940-06-08,"R7","Fitzroy",17,11,113,"Hawthorn",12,14,86,"Brunswick St",27,1940,"Regular",7,"Home","Fitzroy","Hawthorn",27
3810,1940-06-08,"R7","North Melbourne",8,1,49,"Melbourne",12,34,106,"Arden St",-57,1940,"Regular",7,"Away","Melbourne","North Melbourne",57
3811,1940-06-08,"R7","Richmond",13,16,94,"Sydney",12,13,85,"Punt Rd",9,1940,"Regular",7,"Home","Richmond","Sydney",9
3812,1940-06-15,"R8","Essendon",12,14,86,"Carlton",8,15,63,"Windy Hill",23,1940,"Regular",8,"Home","Essendon","Carlton",23
3813,1940-06-15,"R8","Collingwood",6,13,49,"Richmond",10,15,75,"Victoria Park",-26,1940,"Regular",8,"Away","Richmond","Collingwood",26
3814,1940-06-15,"R8","Hawthorn",8,17,65,"Footscray",15,20,110,"Glenferrie Oval",-45,1940,"Regular",8,"Away","Footscray","Hawthorn",45
3815,1940-06-15,"R8","North Melbourne",8,15,63,"Geelong",13,20,98,"Arden St",-35,1940,"Regular",8,"Away","Geelong","North Melbourne",35
3816,1940-06-15,"R8","Sydney",12,9,81,"St Kilda",10,16,76,"Lake Oval",5,1940,"Regular",8,"Home","Sydney","St Kilda",5
3817,1940-06-17,"R8","Melbourne",12,15,87,"Fitzroy",12,13,85,"M.C.G.",2,1940,"Regular",8,"Home","Melbourne","Fitzroy",2
3818,1940-06-22,"R9","Carlton",16,20,116,"North Melbourne",18,12,120,"Princes Park",-4,1940,"Regular",9,"Away","North Melbourne","Carlton",4
3819,1940-06-22,"R9","Footscray",15,10,100,"Collingwood",12,12,84,"Western Oval",16,1940,"Regular",9,"Home","Footscray","Collingwood",16
3820,1940-06-22,"R9","Richmond",12,5,77,"Essendon",12,10,82,"Punt Rd",-5,1940,"Regular",9,"Away","Essendon","Richmond",5
3821,1940-06-22,"R9","Fitzroy",10,30,90,"Sydney",10,17,77,"Brunswick St",13,1940,"Regular",9,"Home","Fitzroy","Sydney",13
3822,1940-06-22,"R9","Geelong",12,18,90,"Hawthorn",6,10,46,"Corio Oval",44,1940,"Regular",9,"Home","Geelong","Hawthorn",44
3823,1940-06-22,"R9","St Kilda",16,16,112,"Melbourne",17,21,123,"Junction Oval",-11,1940,"Regular",9,"Away","Melbourne","St Kilda",11
3824,1940-06-29,"R10","Carlton",13,11,89,"Hawthorn",13,18,96,"Princes Park",-7,1940,"Regular",10,"Away","Hawthorn","Carlton",7
3825,1940-06-29,"R10","Collingwood",12,17,89,"Fitzroy",15,13,103,"Victoria Park",-14,1940,"Regular",10,"Away","Fitzroy","Collingwood",14
3826,1940-06-29,"R10","St Kilda",14,18,102,"Essendon",15,14,104,"Junction Oval",-2,1940,"Regular",10,"Away","Essendon","St Kilda",2
3827,1940-06-29,"R10","Footscray",15,15,105,"Sydney",6,10,46,"Western Oval",59,1940,"Regular",10,"Home","Footscray","Sydney",59
3828,1940-06-29,"R10","Melbourne",22,19,151,"Geelong",24,10,154,"M.C.G.",-3,1940,"Regular",10,"Away","Geelong","Melbourne",3
3829,1940-06-29,"R10","North Melbourne",13,11,89,"Richmond",17,16,118,"Arden St",-29,1940,"Regular",10,"Away","Richmond","North Melbourne",29
3830,1940-07-06,"R11","Richmond",9,11,65,"Carlton",9,22,76,"Punt Rd",-11,1940,"Regular",11,"Away","Carlton","Richmond",11
3831,1940-07-06,"R11","Hawthorn",10,17,77,"Collingwood",14,17,101,"Glenferrie Oval",-24,1940,"Regular",11,"Away","Collingwood","Hawthorn",24
3832,1940-07-06,"R11","Essendon",19,14,128,"North Melbourne",16,9,105,"Windy Hill",23,1940,"Regular",11,"Home","Essendon","North Melbourne",23
3833,1940-07-06,"R11","Fitzroy",17,8,110,"Footscray",14,13,97,"Brunswick St",13,1940,"Regular",11,"Home","Fitzroy","Footscray",13
3834,1940-07-06,"R11","Geelong",12,22,94,"St Kilda",11,10,76,"Corio Oval",18,1940,"Regular",11,"Home","Geelong","St Kilda",18
3835,1940-07-06,"R11","Sydney",10,18,78,"Melbourne",19,16,130,"Lake Oval",-52,1940,"Regular",11,"Away","Melbourne","Sydney",52
3836,1940-07-13,"R12","Carlton",11,24,90,"Geelong",12,19,91,"Princes Park",-1,1940,"Regular",12,"Away","Geelong","Carlton",1
3837,1940-07-13,"R12","Collingwood",19,14,128,"Sydney",4,18,42,"Victoria Park",86,1940,"Regular",12,"Home","Collingwood","Sydney",86
3838,1940-07-13,"R12","Melbourne",17,20,122,"Essendon",7,12,54,"M.C.G.",68,1940,"Regular",12,"Home","Melbourne","Essendon",68
3839,1940-07-13,"R12","St Kilda",8,11,59,"Fitzroy",6,12,48,"Junction Oval",11,1940,"Regular",12,"Home","St Kilda","Fitzroy",11
3840,1940-07-13,"R12","Footscray",12,10,82,"Richmond",15,10,100,"Western Oval",-18,1940,"Regular",12,"Away","Richmond","Footscray",18
3841,1940-07-13,"R12","North Melbourne",11,11,77,"Hawthorn",9,16,70,"Arden St",7,1940,"Regular",12,"Home","North Melbourne","Hawthorn",7
3842,1940-07-20,"R13","Sydney",17,11,113,"Carlton",14,14,98,"Lake Oval",15,1940,"Regular",13,"Home","Sydney","Carlton",15
3843,1940-07-20,"R13","Geelong",23,18,156,"Collingwood",12,19,91,"Corio Oval",65,1940,"Regular",13,"Home","Geelong","Collingwood",65
3844,1940-07-20,"R13","Essendon",13,17,95,"Footscray",13,13,91,"Windy Hill",4,1940,"Regular",13,"Home","Essendon","Footscray",4
3845,1940-07-20,"R13","Fitzroy",16,17,113,"North Melbourne",9,13,67,"Brunswick St",46,1940,"Regular",13,"Home","Fitzroy","North Melbourne",46
3846,1940-07-20,"R13","Hawthorn",17,17,119,"St Kilda",8,15,63,"Glenferrie Oval",56,1940,"Regular",13,"Home","Hawthorn","St Kilda",56
3847,1940-07-20,"R13","Richmond",13,9,87,"Melbourne",13,16,94,"Punt Rd",-7,1940,"Regular",13,"Away","Melbourne","Richmond",7
3848,1940-07-27,"R14","Carlton",14,18,102,"Collingwood",13,9,87,"Princes Park",15,1940,"Regular",14,"Home","Carlton","Collingwood",15
3849,1940-07-27,"R14","Sydney",9,6,60,"Essendon",7,16,58,"Lake Oval",2,1940,"Regular",14,"Home","Sydney","Essendon",2
3850,1940-07-27,"R14","Fitzroy",10,27,87,"Geelong",8,12,60,"Brunswick St",27,1940,"Regular",14,"Home","Fitzroy","Geelong",27
3851,1940-07-27,"R14","Footscray",12,19,91,"Melbourne",15,20,110,"Western Oval",-19,1940,"Regular",14,"Away","Melbourne","Footscray",19
3852,1940-07-27,"R14","Richmond",11,13,79,"Hawthorn",12,15,87,"Punt Rd",-8,1940,"Regular",14,"Away","Hawthorn","Richmond",8
3853,1940-07-27,"R14","North Melbourne",6,11,47,"St Kilda",13,6,84,"Arden St",-37,1940,"Regular",14,"Away","St Kilda","North Melbourne",37
3854,1940-08-10,"R15","Melbourne",14,12,96,"Carlton",20,13,133,"M.C.G.",-37,1940,"Regular",15,"Away","Carlton","Melbourne",37
3855,1940-08-10,"R15","Collingwood",12,21,93,"North Melbourne",6,17,53,"Victoria Park",40,1940,"Regular",15,"Home","Collingwood","North Melbourne",40
3856,1940-08-10,"R15","Essendon",10,12,72,"Fitzroy",10,15,75,"Windy Hill",-3,1940,"Regular",15,"Away","Fitzroy","Essendon",3
3857,1940-08-10,"R15","St Kilda",13,9,87,"Footscray",15,22,112,"Junction Oval",-25,1940,"Regular",15,"Away","Footscray","St Kilda",25
3858,1940-08-10,"R15","Geelong",12,15,87,"Richmond",16,11,107,"Corio Oval",-20,1940,"Regular",15,"Away","Richmond","Geelong",20
3859,1940-08-10,"R15","Hawthorn",10,19,79,"Sydney",10,13,73,"Glenferrie Oval",6,1940,"Regular",15,"Home","Hawthorn","Sydney",6
3860,1940-08-17,"R16","Carlton",13,14,92,"St Kilda",6,16,52,"Princes Park",40,1940,"Regular",16,"Home","Carlton","St Kilda",40
3861,1940-08-17,"R16","Collingwood",12,18,90,"Melbourne",16,8,104,"Victoria Park",-14,1940,"Regular",16,"Away","Melbourne","Collingwood",14
3862,1940-08-17,"R16","Hawthorn",11,18,84,"Essendon",18,12,120,"Glenferrie Oval",-36,1940,"Regular",16,"Away","Essendon","Hawthorn",36
3863,1940-08-17,"R16","Richmond",14,15,99,"Fitzroy",10,11,71,"Punt Rd",28,1940,"Regular",16,"Home","Richmond","Fitzroy",28
3864,1940-08-17,"R16","Footscray",17,22,124,"North Melbourne",8,13,61,"Western Oval",63,1940,"Regular",16,"Home","Footscray","North Melbourne",63
3865,1940-08-17,"R16","Sydney",12,19,91,"Geelong",13,9,87,"Lake Oval",4,1940,"Regular",16,"Home","Sydney","Geelong",4
3866,1940-08-24,"R17","Fitzroy",10,11,71,"Carlton",21,14,140,"Brunswick St",-69,1940,"Regular",17,"Away","Carlton","Fitzroy",69
3867,1940-08-24,"R17","Essendon",12,20,92,"Collingwood",6,16,52,"Windy Hill",40,1940,"Regular",17,"Home","Essendon","Collingwood",40
3868,1940-08-24,"R17","Geelong",12,17,89,"Footscray",11,18,84,"Corio Oval",5,1940,"Regular",17,"Home","Geelong","Footscray",5
3869,1940-08-24,"R17","Melbourne",26,20,176,"Hawthorn",8,14,62,"M.C.G.",114,1940,"Regular",17,"Home","Melbourne","Hawthorn",114
3870,1940-08-24,"R17","North Melbourne",8,5,53,"Sydney",16,23,119,"Arden St",-66,1940,"Regular",17,"Away","Sydney","North Melbourne",66
3871,1940-08-24,"R17","St Kilda",10,17,77,"Richmond",20,15,135,"Junction Oval",-58,1940,"Regular",17,"Away","Richmond","St Kilda",58
3872,1940-08-31,"R18","Carlton",15,12,102,"Footscray",11,14,80,"Princes Park",22,1940,"Regular",18,"Home","Carlton","Footscray",22
3873,1940-08-31,"R18","Collingwood",15,19,109,"St Kilda",10,15,75,"Victoria Park",34,1940,"Regular",18,"Home","Collingwood","St Kilda",34
3874,1940-08-31,"R18","Essendon",16,16,112,"Geelong",7,10,52,"Windy Hill",60,1940,"Regular",18,"Home","Essendon","Geelong",60
3875,1940-08-31,"R18","Hawthorn",13,16,94,"Fitzroy",5,8,38,"Glenferrie Oval",56,1940,"Regular",18,"Home","Hawthorn","Fitzroy",56
3876,1940-08-31,"R18","Melbourne",18,21,129,"North Melbourne",11,15,81,"M.C.G.",48,1940,"Regular",18,"Home","Melbourne","North Melbourne",48
3877,1940-08-31,"R18","Sydney",8,13,61,"Richmond",16,12,108,"Lake Oval",-47,1940,"Regular",18,"Away","Richmond","Sydney",47
3878,1940-09-07,"SF","Essendon",13,14,92,"Geelong",10,14,74,"M.C.G.",18,1940,"Finals",19,"Home","Essendon","Geelong",18
3879,1940-09-14,"SF","Melbourne",14,17,101,"Richmond",16,11,107,"M.C.G.",-6,1940,"Finals",19,"Away","Richmond","Melbourne",6
3880,1940-09-21,"PF","Melbourne",12,18,90,"Essendon",12,13,85,"M.C.G.",5,1940,"Finals",20,"Home","Melbourne","Essendon",5
3881,1940-09-28,"GF","Melbourne",15,17,107,"Richmond",10,8,68,"M.C.G.",39,1940,"Finals",21,"Home","Melbourne","Richmond",39
3882,1941-04-26,"R1","Carlton",15,12,102,"Essendon",15,9,99,"Princes Park",3,1941,"Regular",1,"Home","Carlton","Essendon",3
3883,1941-04-26,"R1","Collingwood",11,11,77,"Richmond",13,17,95,"Victoria Park",-18,1941,"Regular",1,"Away","Richmond","Collingwood",18
3884,1941-04-26,"R1","Melbourne",13,12,90,"Fitzroy",17,12,114,"M.C.G.",-24,1941,"Regular",1,"Away","Fitzroy","Melbourne",24
3885,1941-04-26,"R1","Footscray",13,15,93,"Hawthorn",7,10,52,"Western Oval",41,1941,"Regular",1,"Home","Footscray","Hawthorn",41
3886,1941-04-26,"R1","North Melbourne",15,18,108,"Geelong",15,17,107,"Arden St",1,1941,"Regular",1,"Home","North Melbourne","Geelong",1
3887,1941-04-26,"R1","St Kilda",12,20,92,"Sydney",12,15,87,"Junction Oval",5,1941,"Regular",1,"Home","St Kilda","Sydney",5
3888,1941-05-03,"R2","Richmond",13,12,90,"Carlton",12,8,80,"Punt Rd",10,1941,"Regular",2,"Home","Richmond","Carlton",10
3889,1941-05-03,"R2","Hawthorn",13,17,95,"Collingwood",17,16,118,"Glenferrie Oval",-23,1941,"Regular",2,"Away","Collingwood","Hawthorn",23
3890,1941-05-03,"R2","Essendon",22,13,145,"North Melbourne",16,12,108,"Windy Hill",37,1941,"Regular",2,"Home","Essendon","North Melbourne",37
3891,1941-05-03,"R2","Fitzroy",10,15,75,"Footscray",16,17,113,"Brunswick St",-38,1941,"Regular",2,"Away","Footscray","Fitzroy",38
3892,1941-05-03,"R2","Geelong",13,9,87,"St Kilda",11,19,85,"Kardinia Park",2,1941,"Regular",2,"Home","Geelong","St Kilda",2
3893,1941-05-03,"R2","Sydney",13,15,93,"Melbourne",14,17,101,"Lake Oval",-8,1941,"Regular",2,"Away","Melbourne","Sydney",8
3894,1941-05-10,"R3","Carlton",18,12,120,"Hawthorn",10,13,73,"Princes Park",47,1941,"Regular",3,"Home","Carlton","Hawthorn",47
3895,1941-05-10,"R3","Fitzroy",15,7,97,"Collingwood",18,15,123,"Brunswick St",-26,1941,"Regular",3,"Away","Collingwood","Fitzroy",26
3896,1941-05-10,"R3","St Kilda",7,16,58,"Essendon",16,7,103,"Junction Oval",-45,1941,"Regular",3,"Away","Essendon","St Kilda",45
3897,1941-05-10,"R3","Footscray",16,4,100,"Sydney",7,16,58,"Western Oval",42,1941,"Regular",3,"Home","Footscray","Sydney",42
3898,1941-05-10,"R3","Geelong",13,19,97,"Melbourne",16,12,108,"Kardinia Park",-11,1941,"Regular",3,"Away","Melbourne","Geelong",11
3899,1941-05-10,"R3","Richmond",18,15,123,"North Melbourne",14,11,95,"Punt Rd",28,1941,"Regular",3,"Home","Richmond","North Melbourne",28
3900,1941-05-17,"R4","North Melbourne",15,15,105,"Carlton",16,23,119,"Arden St",-14,1941,"Regular",4,"Away","Carlton","North Melbourne",14
3901,1941-05-17,"R4","Collingwood",14,11,95,"Footscray",14,10,94,"Victoria Park",1,1941,"Regular",4,"Home","Collingwood","Footscray",1
3902,1941-05-17,"R4","Essendon",15,14,104,"Richmond",14,8,92,"Windy Hill",12,1941,"Regular",4,"Home","Essendon","Richmond",12
3903,1941-05-17,"R4","Sydney",15,19,109,"Fitzroy",12,10,82,"Lake Oval",27,1941,"Regular",4,"Home","Sydney","Fitzroy",27
3904,1941-05-17,"R4","Hawthorn",13,16,94,"Geelong",11,13,79,"Glenferrie Oval",15,1941,"Regular",4,"Home","Hawthorn","Geelong",15
3905,1941-05-17,"R4","Melbourne",13,15,93,"St Kilda",13,11,89,"M.C.G.",4,1941,"Regular",4,"Home","Melbourne","St Kilda",4
3906,1941-05-31,"R5","St Kilda",13,12,90,"Carlton",15,18,108,"Junction Oval",-18,1941,"Regular",5,"Away","Carlton","St Kilda",18
3907,1941-05-31,"R5","Collingwood",19,13,127,"Melbourne",26,11,167,"Victoria Park",-40,1941,"Regular",5,"Away","Melbourne","Collingwood",40
3908,1941-05-31,"R5","Hawthorn",8,12,60,"Essendon",23,18,156,"Glenferrie Oval",-96,1941,"Regular",5,"Away","Essendon","Hawthorn",96
3909,1941-05-31,"R5","Richmond",17,18,120,"Fitzroy",15,8,98,"Punt Rd",22,1941,"Regular",5,"Home","Richmond","Fitzroy",22
3910,1941-05-31,"R5","Footscray",14,21,105,"North Melbourne",8,8,56,"Western Oval",49,1941,"Regular",5,"Home","Footscray","North Melbourne",49
3911,1941-05-31,"R5","Geelong",14,12,96,"Sydney",13,25,103,"Kardinia Park",-7,1941,"Regular",5,"Away","Sydney","Geelong",7
3912,1941-06-07,"R6","Carlton",13,21,99,"Collingwood",11,16,82,"Princes Park",17,1941,"Regular",6,"Home","Carlton","Collingwood",17
3913,1941-06-07,"R6","Sydney",8,13,61,"Essendon",13,18,96,"Lake Oval",-35,1941,"Regular",6,"Away","Essendon","Sydney",35
3914,1941-06-07,"R6","Fitzroy",17,14,116,"Geelong",10,15,75,"Brunswick St",41,1941,"Regular",6,"Home","Fitzroy","Geelong",41
3915,1941-06-07,"R6","Footscray",20,12,132,"Melbourne",14,20,104,"Western Oval",28,1941,"Regular",6,"Home","Footscray","Melbourne",28
3916,1941-06-07,"R6","Richmond",17,15,117,"Hawthorn",8,14,62,"Punt Rd",55,1941,"Regular",6,"Home","Richmond","Hawthorn",55
3917,1941-06-07,"R6","North Melbourne",17,12,114,"St Kilda",8,14,62,"Arden St",52,1941,"Regular",6,"Home","North Melbourne","St Kilda",52
3918,1941-06-14,"R7","Collingwood",17,19,121,"North Melbourne",16,15,111,"Victoria Park",10,1941,"Regular",7,"Home","Collingwood","North Melbourne",10
3919,1941-06-14,"R7","Essendon",9,24,78,"Fitzroy",4,12,36,"Windy Hill",42,1941,"Regular",7,"Home","Essendon","Fitzroy",42
3920,1941-06-14,"R7","St Kilda",15,14,104,"Footscray",9,8,62,"Junction Oval",42,1941,"Regular",7,"Home","St Kilda","Footscray",42
3921,1941-06-14,"R7","Geelong",10,14,74,"Richmond",10,15,75,"Kardinia Park",-1,1941,"Regular",7,"Away","Richmond","Geelong",1
3922,1941-06-14,"R7","Hawthorn",6,20,56,"Sydney",13,12,90,"Glenferrie Oval",-34,1941,"Regular",7,"Away","Sydney","Hawthorn",34
3923,1941-06-16,"R7","Melbourne",14,13,97,"Carlton",19,10,124,"M.C.G.",-27,1941,"Regular",7,"Away","Carlton","Melbourne",27
3924,1941-06-21,"R8","Carlton",10,17,77,"Fitzroy",12,13,85,"Princes Park",-8,1941,"Regular",8,"Away","Fitzroy","Carlton",8
3925,1941-06-21,"R8","Collingwood",8,12,60,"Essendon",7,10,52,"Victoria Park",8,1941,"Regular",8,"Home","Collingwood","Essendon",8
3926,1941-06-21,"R8","Geelong",10,18,78,"Footscray",13,15,93,"Kardinia Park",-15,1941,"Regular",8,"Away","Footscray","Geelong",15
3927,1941-06-21,"R8","Hawthorn",6,8,44,"Melbourne",12,12,84,"Glenferrie Oval",-40,1941,"Regular",8,"Away","Melbourne","Hawthorn",40
3928,1941-06-21,"R8","Sydney",8,16,64,"North Melbourne",6,6,42,"Lake Oval",22,1941,"Regular",8,"Home","Sydney","North Melbourne",22
3929,1941-06-21,"R8","Richmond",10,13,73,"St Kilda",6,11,47,"Punt Rd",26,1941,"Regular",8,"Home","Richmond","St Kilda",26
3930,1941-06-28,"R9","Footscray",12,14,86,"Carlton",15,11,101,"Western Oval",-15,1941,"Regular",9,"Away","Carlton","Footscray",15
3931,1941-06-28,"R9","St Kilda",12,11,83,"Collingwood",16,10,106,"Junction Oval",-23,1941,"Regular",9,"Away","Collingwood","St Kilda",23
3932,1941-06-28,"R9","Essendon",18,12,120,"Geelong",11,13,79,"Windy Hill",41,1941,"Regular",9,"Home","Essendon","Geelong",41
3933,1941-06-28,"R9","Fitzroy",21,19,145,"Hawthorn",10,20,80,"Brunswick St",65,1941,"Regular",9,"Home","Fitzroy","Hawthorn",65
3934,1941-06-28,"R9","North Melbourne",17,14,116,"Melbourne",20,9,129,"Arden St",-13,1941,"Regular",9,"Away","Melbourne","North Melbourne",13
3935,1941-06-28,"R9","Richmond",15,13,103,"Sydney",9,16,70,"Punt Rd",33,1941,"Regular",9,"Home","Richmond","Sydney",33
3936,1941-07-05,"R10","Carlton",12,25,97,"Geelong",13,11,89,"Princes Park",8,1941,"Regular",10,"Home","Carlton","Geelong",8
3937,1941-07-05,"R10","Collingwood",10,12,72,"Sydney",11,13,79,"Victoria Park",-7,1941,"Regular",10,"Away","Sydney","Collingwood",7
3938,1941-07-05,"R10","Melbourne",16,17,113,"Essendon",9,11,65,"M.C.G.",48,1941,"Regular",10,"Home","Melbourne","Essendon",48
3939,1941-07-05,"R10","St Kilda",12,4,76,"Fitzroy",12,6,78,"Junction Oval",-2,1941,"Regular",10,"Away","Fitzroy","St Kilda",2
3940,1941-07-05,"R10","Footscray",12,13,85,"Richmond",14,11,95,"Western Oval",-10,1941,"Regular",10,"Away","Richmond","Footscray",10
3941,1941-07-05,"R10","North Melbourne",13,20,98,"Hawthorn",6,14,50,"Arden St",48,1941,"Regular",10,"Home","North Melbourne","Hawthorn",48
3942,1941-07-12,"R11","Sydney",16,13,109,"Carlton",14,9,93,"Lake Oval",16,1941,"Regular",11,"Home","Sydney","Carlton",16
3943,1941-07-12,"R11","Geelong",7,16,58,"Collingwood",14,12,96,"Kardinia Park",-38,1941,"Regular",11,"Away","Collingwood","Geelong",38
3944,1941-07-12,"R11","Essendon",15,14,104,"Footscray",9,11,65,"Windy Hill",39,1941,"Regular",11,"Home","Essendon","Footscray",39
3945,1941-07-12,"R11","Fitzroy",18,15,123,"North Melbourne",18,16,124,"Brunswick St",-1,1941,"Regular",11,"Away","North Melbourne","Fitzroy",1
3946,1941-07-12,"R11","Hawthorn",13,12,90,"St Kilda",9,15,69,"Glenferrie Oval",21,1941,"Regular",11,"Home","Hawthorn","St Kilda",21
3947,1941-07-12,"R11","Melbourne",14,24,108,"Richmond",8,13,61,"M.C.G.",47,1941,"Regular",11,"Home","Melbourne","Richmond",47
3948,1941-07-19,"R12","Essendon",12,11,83,"Carlton",18,14,122,"Windy Hill",-39,1941,"Regular",12,"Away","Carlton","Essendon",39
3949,1941-07-19,"R12","Richmond",10,14,74,"Collingwood",13,14,92,"Punt Rd",-18,1941,"Regular",12,"Away","Collingwood","Richmond",18
3950,1941-07-19,"R12","Fitzroy",16,8,104,"Melbourne",18,18,126,"Brunswick St",-22,1941,"Regular",12,"Away","Melbourne","Fitzroy",22
3951,1941-07-19,"R12","Hawthorn",11,14,80,"Footscray",15,12,102,"Glenferrie Oval",-22,1941,"Regular",12,"Away","Footscray","Hawthorn",22
3952,1941-07-19,"R12","Geelong",13,21,99,"North Melbourne",14,11,95,"Kardinia Park",4,1941,"Regular",12,"Home","Geelong","North Melbourne",4
3953,1941-07-19,"R12","Sydney",14,12,96,"St Kilda",8,6,54,"Lake Oval",42,1941,"Regular",12,"Home","Sydney","St Kilda",42
3954,1941-07-26,"R13","Carlton",12,11,83,"Richmond",11,18,84,"Princes Park",-1,1941,"Regular",13,"Away","Richmond","Carlton",1
3955,1941-07-26,"R13","Collingwood",22,20,152,"Hawthorn",12,13,85,"Victoria Park",67,1941,"Regular",13,"Home","Collingwood","Hawthorn",67
3956,1941-07-26,"R13","North Melbourne",12,14,86,"Essendon",17,8,110,"Arden St",-24,1941,"Regular",13,"Away","Essendon","North Melbourne",24
3957,1941-07-26,"R13","Footscray",15,20,110,"Fitzroy",9,4,58,"Western Oval",52,1941,"Regular",13,"Home","Footscray","Fitzroy",52
3958,1941-07-26,"R13","St Kilda",18,14,122,"Geelong",11,15,81,"Junction Oval",41,1941,"Regular",13,"Home","St Kilda","Geelong",41
3959,1941-07-26,"R13","Melbourne",18,16,124,"Sydney",10,13,73,"M.C.G.",51,1941,"Regular",13,"Home","Melbourne","Sydney",51
3960,1941-08-02,"R14","Hawthorn",11,15,81,"Carlton",16,25,121,"Glenferrie Oval",-40,1941,"Regular",14,"Away","Carlton","Hawthorn",40
3961,1941-08-02,"R14","Collingwood",11,9,75,"Fitzroy",8,9,57,"Victoria Park",18,1941,"Regular",14,"Home","Collingwood","Fitzroy",18
3962,1941-08-02,"R14","Essendon",16,17,113,"St Kilda",6,13,49,"Windy Hill",64,1941,"Regular",14,"Home","Essendon","St Kilda",64
3963,1941-08-02,"R14","Sydney",7,13,55,"Footscray",10,21,81,"Lake Oval",-26,1941,"Regular",14,"Away","Footscray","Sydney",26
3964,1941-08-02,"R14","Melbourne",19,14,128,"Geelong",9,18,72,"M.C.G.",56,1941,"Regular",14,"Home","Melbourne","Geelong",56
3965,1941-08-02,"R14","North Melbourne",9,10,64,"Richmond",10,7,67,"Arden St",-3,1941,"Regular",14,"Away","Richmond","North Melbourne",3
3966,1941-08-09,"R15","Carlton",25,19,169,"North Melbourne",17,15,117,"Princes Park",52,1941,"Regular",15,"Home","Carlton","North Melbourne",52
3967,1941-08-09,"R15","Footscray",7,10,52,"Collingwood",10,21,81,"Western Oval",-29,1941,"Regular",15,"Away","Collingwood","Footscray",29
3968,1941-08-09,"R15","Richmond",14,11,95,"Essendon",12,16,88,"Punt Rd",7,1941,"Regular",15,"Home","Richmond","Essendon",7
3969,1941-08-09,"R15","Fitzroy",16,17,113,"Sydney",11,14,80,"Brunswick St",33,1941,"Regular",15,"Home","Fitzroy","Sydney",33
3970,1941-08-09,"R15","Geelong",22,12,144,"Hawthorn",19,15,129,"Kardinia Park",15,1941,"Regular",15,"Home","Geelong","Hawthorn",15
3971,1941-08-09,"R15","St Kilda",12,13,85,"Melbourne",14,17,101,"Junction Oval",-16,1941,"Regular",15,"Away","Melbourne","St Kilda",16
3972,1941-08-16,"R16","Carlton",20,17,137,"St Kilda",11,14,80,"Princes Park",57,1941,"Regular",16,"Home","Carlton","St Kilda",57
3973,1941-08-16,"R16","Melbourne",17,8,110,"Collingwood",11,21,87,"M.C.G.",23,1941,"Regular",16,"Home","Melbourne","Collingwood",23
3974,1941-08-16,"R16","Essendon",19,17,131,"Hawthorn",14,9,93,"Windy Hill",38,1941,"Regular",16,"Home","Essendon","Hawthorn",38
3975,1941-08-16,"R16","Fitzroy",14,15,99,"Richmond",12,16,88,"Brunswick St",11,1941,"Regular",16,"Home","Fitzroy","Richmond",11
3976,1941-08-16,"R16","North Melbourne",15,14,104,"Footscray",11,22,88,"Arden St",16,1941,"Regular",16,"Home","North Melbourne","Footscray",16
3977,1941-08-16,"R16","Sydney",10,10,70,"Geelong",10,9,69,"Lake Oval",1,1941,"Regular",16,"Home","Sydney","Geelong",1
3978,1941-08-23,"R17","Collingwood",10,21,81,"Carlton",11,17,83,"Victoria Park",-2,1941,"Regular",17,"Away","Carlton","Collingwood",2
3979,1941-08-23,"R17","Essendon",12,23,95,"Sydney",7,4,46,"Windy Hill",49,1941,"Regular",17,"Home","Essendon","Sydney",49
3980,1941-08-23,"R17","Geelong",13,16,94,"Fitzroy",16,13,109,"Kardinia Park",-15,1941,"Regular",17,"Away","Fitzroy","Geelong",15
3981,1941-08-23,"R17","Melbourne",17,20,122,"Footscray",16,9,105,"M.C.G.",17,1941,"Regular",17,"Home","Melbourne","Footscray",17
3982,1941-08-23,"R17","Hawthorn",8,12,60,"Richmond",18,22,130,"Glenferrie Oval",-70,1941,"Regular",17,"Away","Richmond","Hawthorn",70
3983,1941-08-23,"R17","St Kilda",16,18,114,"North Melbourne",21,10,136,"Junction Oval",-22,1941,"Regular",17,"Away","North Melbourne","St Kilda",22
3984,1941-08-30,"R18","Carlton",16,17,113,"Melbourne",11,22,88,"Princes Park",25,1941,"Regular",18,"Home","Carlton","Melbourne",25
3985,1941-08-30,"R18","North Melbourne",12,8,80,"Collingwood",13,20,98,"Arden St",-18,1941,"Regular",18,"Away","Collingwood","North Melbourne",18
3986,1941-08-30,"R18","Fitzroy",15,16,106,"Essendon",18,14,122,"Brunswick St",-16,1941,"Regular",18,"Away","Essendon","Fitzroy",16
3987,1941-08-30,"R18","Footscray",16,14,110,"St Kilda",13,17,95,"Western Oval",15,1941,"Regular",18,"Home","Footscray","St Kilda",15
3988,1941-08-30,"R18","Richmond",20,12,132,"Geelong",12,11,83,"Punt Rd",49,1941,"Regular",18,"Home","Richmond","Geelong",49
3989,1941-08-30,"R18","Sydney",7,12,54,"Hawthorn",11,17,83,"Lake Oval",-29,1941,"Regular",18,"Away","Hawthorn","Sydney",29
3990,1941-09-06,"SF","Richmond",11,15,81,"Essendon",21,9,135,"M.C.G.",-54,1941,"Finals",19,"Away","Essendon","Richmond",54
3991,1941-09-13,"SF","Carlton",11,16,82,"Melbourne",16,13,109,"M.C.G.",-27,1941,"Finals",19,"Away","Melbourne","Carlton",27
3992,1941-09-20,"PF","Carlton",9,14,68,"Essendon",13,15,93,"M.C.G.",-25,1941,"Finals",20,"Away","Essendon","Carlton",25
3993,1941-09-27,"GF","Melbourne",19,13,127,"Essendon",13,20,98,"M.C.G.",29,1941,"Finals",21,"Home","Melbourne","Essendon",29
3994,1942-05-09,"R1","Sydney",18,25,133,"Collingwood",14,11,95,"Princes Park",38,1942,"Regular",1,"Home","Sydney","Collingwood",38
3995,1942-05-09,"R1","Essendon",25,14,164,"Melbourne",16,14,110,"Windy Hill",54,1942,"Regular",1,"Home","Essendon","Melbourne",54
3996,1942-05-09,"R1","Fitzroy",14,13,97,"St Kilda",10,12,72,"Brunswick St",25,1942,"Regular",1,"Home","Fitzroy","St Kilda",25
3997,1942-05-09,"R1","Richmond",19,17,131,"Footscray",16,15,111,"Punt Rd",20,1942,"Regular",1,"Home","Richmond","Footscray",20
3998,1942-05-09,"R1","Hawthorn",13,15,93,"North Melbourne",18,19,127,"Glenferrie Oval",-34,1942,"Regular",1,"Away","North Melbourne","Hawthorn",34
3999,1942-05-16,"R2","Carlton",8,11,59,"Sydney",13,21,99,"Princes Park",-40,1942,"Regular",2,"Away","Sydney","Carlton",40
4000,1942-05-16,"R2","Footscray",12,16,88,"Essendon",14,8,92,"Yarraville Oval",-4,1942,"Regular",2,"Away","Essendon","Footscray",4
4001,1942-05-16,"R2","North Melbourne",14,10,94,"Fitzroy",17,13,115,"Arden St",-21,1942,"Regular",2,"Away","Fitzroy","North Melbourne",21
4002,1942-05-16,"R2","St Kilda",16,13,109,"Hawthorn",9,17,71,"Toorak Park",38,1942,"Regular",2,"Home","St Kilda","Hawthorn",38
4003,1942-05-16,"R2","Melbourne",18,9,117,"Richmond",30,16,196,"Punt Rd",-79,1942,"Regular",2,"Away","Richmond","Melbourne",79
4004,1942-05-23,"R3","Essendon",11,9,75,"Carlton",11,4,70,"Windy Hill",5,1942,"Regular",3,"Home","Essendon","Carlton",5
4005,1942-05-23,"R3","Richmond",25,25,175,"Collingwood",5,7,37,"Punt Rd",138,1942,"Regular",3,"Home","Richmond","Collingwood",138
4006,1942-05-23,"R3","Fitzroy",20,13,133,"Melbourne",11,11,77,"Brunswick St",56,1942,"Regular",3,"Home","Fitzroy","Melbourne",56
4007,1942-05-23,"R3","Hawthorn",5,11,41,"Footscray",17,15,117,"Glenferrie Oval",-76,1942,"Regular",3,"Away","Footscray","Hawthorn",76
4008,1942-05-23,"R3","Sydney",22,24,156,"St Kilda",11,16,82,"Princes Park",74,1942,"Regular",3,"Home","Sydney","St Kilda",74
4009,1942-05-30,"R4","Carlton",13,13,91,"Fitzroy",9,14,68,"Princes Park",23,1942,"Regular",4,"Home","Carlton","Fitzroy",23
4010,1942-05-30,"R4","Collingwood",13,9,87,"Essendon",20,16,136,"Victoria Park",-49,1942,"Regular",4,"Away","Essendon","Collingwood",49
4011,1942-05-30,"R4","Melbourne",16,15,111,"Hawthorn",8,17,65,"Punt Rd",46,1942,"Regular",4,"Home","Melbourne","Hawthorn",46
4012,1942-05-30,"R4","North Melbourne",12,8,80,"Sydney",8,17,65,"Arden St",15,1942,"Regular",4,"Home","North Melbourne","Sydney",15
4013,1942-05-30,"R4","St Kilda",11,17,83,"Richmond",25,13,163,"Toorak Park",-80,1942,"Regular",4,"Away","Richmond","St Kilda",80
4014,1942-06-06,"R5","Richmond",15,14,104,"Carlton",10,17,77,"Punt Rd",27,1942,"Regular",5,"Home","Richmond","Carlton",27
4015,1942-06-06,"R5","Hawthorn",13,10,88,"Collingwood",10,20,80,"Glenferrie Oval",8,1942,"Regular",5,"Home","Hawthorn","Collingwood",8
4016,1942-06-06,"R5","Essendon",15,19,109,"North Melbourne",9,15,69,"Windy Hill",40,1942,"Regular",5,"Home","Essendon","North Melbourne",40
4017,1942-06-06,"R5","Fitzroy",11,13,79,"Footscray",12,11,83,"Brunswick St",-4,1942,"Regular",5,"Away","Footscray","Fitzroy",4
4018,1942-06-06,"R5","Sydney",23,10,148,"Melbourne",16,19,115,"Princes Park",33,1942,"Regular",5,"Home","Sydney","Melbourne",33
4019,1942-06-13,"R6","Carlton",20,18,138,"North Melbourne",13,13,91,"Princes Park",47,1942,"Regular",6,"Home","Carlton","North Melbourne",47
4020,1942-06-13,"R6","Collingwood",11,12,78,"Footscray",11,21,87,"Victoria Park",-9,1942,"Regular",6,"Away","Footscray","Collingwood",9
4021,1942-06-13,"R6","Essendon",10,17,77,"Richmond",11,10,76,"Windy Hill",1,1942,"Regular",6,"Home","Essendon","Richmond",1
4022,1942-06-13,"R6","Sydney",9,15,69,"Fitzroy",11,17,83,"Toorak Park",-14,1942,"Regular",6,"Away","Fitzroy","Sydney",14
4023,1942-06-13,"R6","Melbourne",6,9,45,"St Kilda",13,11,89,"Punt Rd",-44,1942,"Regular",6,"Away","St Kilda","Melbourne",44
4024,1942-06-20,"R7","Footscray",12,19,91,"Carlton",10,12,72,"Yarraville Oval",19,1942,"Regular",7,"Home","Footscray","Carlton",19
4025,1942-06-20,"R7","St Kilda",11,14,80,"Collingwood",9,14,68,"Toorak Park",12,1942,"Regular",7,"Home","St Kilda","Collingwood",12
4026,1942-06-20,"R7","Fitzroy",16,14,110,"Hawthorn",14,10,94,"Brunswick St",16,1942,"Regular",7,"Home","Fitzroy","Hawthorn",16
4027,1942-06-20,"R7","North Melbourne",11,10,76,"Melbourne",12,11,83,"Arden St",-7,1942,"Regular",7,"Away","Melbourne","North Melbourne",7
4028,1942-06-20,"R7","Richmond",10,9,69,"Sydney",11,20,86,"Punt Rd",-17,1942,"Regular",7,"Away","Sydney","Richmond",17
4029,1942-06-27,"R8","Carlton",18,14,122,"St Kilda",10,11,71,"Princes Park",51,1942,"Regular",8,"Home","Carlton","St Kilda",51
4030,1942-06-27,"R8","Melbourne",11,14,80,"Collingwood",14,21,105,"Punt Rd",-25,1942,"Regular",8,"Away","Collingwood","Melbourne",25
4031,1942-06-27,"R8","Essendon",22,12,144,"Hawthorn",5,8,38,"Windy Hill",106,1942,"Regular",8,"Home","Essendon","Hawthorn",106
4032,1942-06-27,"R8","Fitzroy",12,9,81,"Richmond",15,15,105,"Brunswick St",-24,1942,"Regular",8,"Away","Richmond","Fitzroy",24
4033,1942-06-27,"R8","North Melbourne",9,8,62,"Footscray",17,16,118,"Arden St",-56,1942,"Regular",8,"Away","Footscray","North Melbourne",56
4034,1942-07-04,"R9","Hawthorn",8,10,58,"Carlton",12,14,86,"Glenferrie Oval",-28,1942,"Regular",9,"Away","Carlton","Hawthorn",28
4035,1942-07-04,"R9","Collingwood",10,18,78,"Fitzroy",12,7,79,"Victoria Park",-1,1942,"Regular",9,"Away","Fitzroy","Collingwood",1
4036,1942-07-04,"R9","St Kilda",6,9,45,"Essendon",4,15,39,"Toorak Park",6,1942,"Regular",9,"Home","St Kilda","Essendon",6
4037,1942-07-04,"R9","Footscray",7,3,45,"Sydney",11,9,75,"Yarraville Oval",-30,1942,"Regular",9,"Away","Sydney","Footscray",30
4038,1942-07-04,"R9","Richmond",11,14,80,"North Melbourne",11,11,77,"Punt Rd",3,1942,"Regular",9,"Home","Richmond","North Melbourne",3
4039,1942-07-11,"R10","Carlton",13,17,95,"Melbourne",10,7,67,"Princes Park",28,1942,"Regular",10,"Home","Carlton","Melbourne",28
4040,1942-07-11,"R10","North Melbourne",17,8,110,"Collingwood",11,16,82,"Arden St",28,1942,"Regular",10,"Home","North Melbourne","Collingwood",28
4041,1942-07-11,"R10","Fitzroy",12,10,82,"Essendon",15,17,107,"Brunswick St",-25,1942,"Regular",10,"Away","Essendon","Fitzroy",25
4042,1942-07-11,"R10","Footscray",19,17,131,"St Kilda",7,18,60,"Yarraville Oval",71,1942,"Regular",10,"Home","Footscray","St Kilda",71
4043,1942-07-11,"R10","Sydney",12,19,91,"Hawthorn",13,10,88,"Punt Rd",3,1942,"Regular",10,"Home","Sydney","Hawthorn",3
4044,1942-07-18,"R11","Collingwood",11,11,77,"Carlton",13,14,92,"Victoria Park",-15,1942,"Regular",11,"Away","Carlton","Collingwood",15
4045,1942-07-18,"R11","Essendon",10,15,75,"Sydney",8,7,55,"Windy Hill",20,1942,"Regular",11,"Home","Essendon","Sydney",20
4046,1942-07-18,"R11","Melbourne",14,11,95,"Footscray",19,12,126,"Punt Rd",-31,1942,"Regular",11,"Away","Footscray","Melbourne",31
4047,1942-07-18,"R11","Hawthorn",13,17,95,"Richmond",19,13,127,"Glenferrie Oval",-32,1942,"Regular",11,"Away","Richmond","Hawthorn",32
4048,1942-07-18,"R11","St Kilda",21,9,135,"North Melbourne",9,8,62,"Toorak Park",73,1942,"Regular",11,"Home","St Kilda","North Melbourne",73
4049,1942-07-25,"R12","Collingwood",9,15,69,"Sydney",15,21,111,"Victoria Park",-42,1942,"Regular",12,"Away","Sydney","Collingwood",42
4050,1942-07-25,"R12","Melbourne",14,20,104,"Essendon",12,12,84,"Punt Rd",20,1942,"Regular",12,"Home","Melbourne","Essendon",20
4051,1942-07-25,"R12","St Kilda",10,13,73,"Fitzroy",12,14,86,"Toorak Park",-13,1942,"Regular",12,"Away","Fitzroy","St Kilda",13
4052,1942-07-25,"R12","Footscray",19,15,129,"Richmond",17,20,122,"Yarraville Oval",7,1942,"Regular",12,"Home","Footscray","Richmond",7
4053,1942-07-25,"R12","North Melbourne",9,10,64,"Hawthorn",6,16,52,"Arden St",12,1942,"Regular",12,"Home","North Melbourne","Hawthorn",12
4054,1942-08-01,"R13","Sydney",10,24,84,"Carlton",12,17,89,"Princes Park",-5,1942,"Regular",13,"Away","Carlton","Sydney",5
4055,1942-08-01,"R13","Essendon",15,12,102,"Footscray",10,8,68,"Windy Hill",34,1942,"Regular",13,"Home","Essendon","Footscray",34
4056,1942-08-01,"R13","Fitzroy",20,14,134,"North Melbourne",10,8,68,"Brunswick St",66,1942,"Regular",13,"Home","Fitzroy","North Melbourne",66
4057,1942-08-01,"R13","Hawthorn",8,9,57,"St Kilda",10,15,75,"Glenferrie Oval",-18,1942,"Regular",13,"Away","St Kilda","Hawthorn",18
4058,1942-08-01,"R13","Richmond",15,21,111,"Melbourne",12,14,86,"Punt Rd",25,1942,"Regular",13,"Home","Richmond","Melbourne",25
4059,1942-08-08,"R14","Carlton",18,20,128,"Essendon",11,9,75,"Princes Park",53,1942,"Regular",14,"Home","Carlton","Essendon",53
4060,1942-08-08,"R14","Collingwood",12,11,83,"Richmond",16,21,117,"Victoria Park",-34,1942,"Regular",14,"Away","Richmond","Collingwood",34
4061,1942-08-08,"R14","Melbourne",12,13,85,"Fitzroy",10,8,68,"Punt Rd",17,1942,"Regular",14,"Home","Melbourne","Fitzroy",17
4062,1942-08-08,"R14","Footscray",20,17,137,"Hawthorn",9,4,58,"Yarraville Oval",79,1942,"Regular",14,"Home","Footscray","Hawthorn",79
4063,1942-08-08,"R14","St Kilda",6,10,46,"Sydney",13,11,89,"Toorak Park",-43,1942,"Regular",14,"Away","Sydney","St Kilda",43
4064,1942-08-15,"R15","Fitzroy",13,20,98,"Carlton",17,13,115,"Brunswick St",-17,1942,"Regular",15,"Away","Carlton","Fitzroy",17
4065,1942-08-15,"R15","Essendon",11,17,83,"Collingwood",9,10,64,"Windy Hill",19,1942,"Regular",15,"Home","Essendon","Collingwood",19
4066,1942-08-15,"R15","Hawthorn",7,15,57,"Melbourne",16,22,118,"Glenferrie Oval",-61,1942,"Regular",15,"Away","Melbourne","Hawthorn",61
4067,1942-08-15,"R15","Sydney",22,13,145,"North Melbourne",12,15,87,"Princes Park",58,1942,"Regular",15,"Home","Sydney","North Melbourne",58
4068,1942-08-15,"R15","Richmond",18,20,128,"St Kilda",8,8,56,"Punt Rd",72,1942,"Regular",15,"Home","Richmond","St Kilda",72
4069,1942-08-22,"R16","Carlton",18,19,127,"Richmond",10,14,74,"Princes Park",53,1942,"Regular",16,"Home","Carlton","Richmond",53
4070,1942-08-22,"R16","Collingwood",16,21,117,"Hawthorn",15,13,103,"Victoria Park",14,1942,"Regular",16,"Home","Collingwood","Hawthorn",14
4071,1942-08-22,"R16","North Melbourne",5,8,38,"Essendon",8,16,64,"Arden St",-26,1942,"Regular",16,"Away","Essendon","North Melbourne",26
4072,1942-08-22,"R16","Footscray",19,15,129,"Fitzroy",14,8,92,"Yarraville Oval",37,1942,"Regular",16,"Home","Footscray","Fitzroy",37
4073,1942-08-22,"R16","Melbourne",14,7,91,"Sydney",14,23,107,"Punt Rd",-16,1942,"Regular",16,"Away","Sydney","Melbourne",16
4074,1942-08-29,"SF","Sydney",13,13,91,"Footscray",7,22,64,"Princes Park",27,1942,"Finals",17,"Home","Sydney","Footscray",27
4075,1942-09-05,"SF","Essendon",8,8,56,"Richmond",11,12,78,"Princes Park",-22,1942,"Finals",17,"Away","Richmond","Essendon",22
4076,1942-09-12,"PF","Essendon",19,10,124,"Sydney",14,12,96,"Princes Park",28,1942,"Finals",18,"Home","Essendon","Sydney",28
4077,1942-09-19,"GF","Essendon",19,18,132,"Richmond",11,13,79,"Princes Park",53,1942,"Finals",19,"Home","Essendon","Richmond",53
4078,1943-05-08,"R1","Carlton",17,13,115,"Richmond",8,23,71,"Princes Park",44,1943,"Regular",1,"Home","Carlton","Richmond",44
4079,1943-05-08,"R1","Collingwood",6,22,58,"North Melbourne",7,12,54,"Victoria Park",4,1943,"Regular",1,"Home","Collingwood","North Melbourne",4
4080,1943-05-08,"R1","Essendon",18,9,117,"Sydney",13,14,92,"Windy Hill",25,1943,"Regular",1,"Home","Essendon","Sydney",25
4081,1943-05-08,"R1","Melbourne",14,12,96,"Fitzroy",15,9,99,"Punt Rd",-3,1943,"Regular",1,"Away","Fitzroy","Melbourne",3
4082,1943-05-08,"R1","St Kilda",14,9,93,"Hawthorn",13,17,95,"Toorak Park",-2,1943,"Regular",1,"Away","Hawthorn","St Kilda",2
4083,1943-05-15,"R2","Footscray",6,10,46,"Carlton",8,18,66,"Western Oval",-20,1943,"Regular",2,"Away","Carlton","Footscray",20
4084,1943-05-15,"R2","Richmond",13,7,85,"Collingwood",9,12,66,"Punt Rd",19,1943,"Regular",2,"Home","Richmond","Collingwood",19
4085,1943-05-15,"R2","Hawthorn",7,8,50,"Essendon",11,15,81,"Glenferrie Oval",-31,1943,"Regular",2,"Away","Essendon","Hawthorn",31
4086,1943-05-15,"R2","Sydney",12,14,86,"Melbourne",15,19,109,"Princes Park",-23,1943,"Regular",2,"Away","Melbourne","Sydney",23
4087,1943-05-15,"R2","North Melbourne",8,14,62,"St Kilda",8,14,62,"Arden St",0,1943,"Regular",2,"Home","North Melbourne","St Kilda",0
4088,1943-05-22,"R3","Collingwood",11,14,80,"Footscray",12,16,88,"Victoria Park",-8,1943,"Regular",3,"Away","Footscray","Collingwood",8
4089,1943-05-22,"R3","Essendon",11,12,78,"North Melbourne",9,11,65,"Windy Hill",13,1943,"Regular",3,"Home","Essendon","North Melbourne",13
4090,1943-05-22,"R3","Fitzroy",16,17,113,"Sydney",16,16,112,"Brunswick St",1,1943,"Regular",3,"Home","Fitzroy","Sydney",1
4091,1943-05-22,"R3","Melbourne",10,12,72,"Hawthorn",17,15,117,"Punt Rd",-45,1943,"Regular",3,"Away","Hawthorn","Melbourne",45
4092,1943-05-22,"R3","St Kilda",8,15,63,"Richmond",17,12,114,"Toorak Park",-51,1943,"Regular",3,"Away","Richmond","St Kilda",51
4093,1943-05-29,"R4","Carlton",12,5,77,"Collingwood",15,14,104,"Princes Park",-27,1943,"Regular",4,"Away","Collingwood","Carlton",27
4094,1943-05-29,"R4","Richmond",11,18,84,"Essendon",14,13,97,"Punt Rd",-13,1943,"Regular",4,"Away","Essendon","Richmond",13
4095,1943-05-29,"R4","Hawthorn",13,8,86,"Fitzroy",9,21,75,"Glenferrie Oval",11,1943,"Regular",4,"Home","Hawthorn","Fitzroy",11
4096,1943-05-29,"R4","Footscray",13,11,89,"St Kilda",6,12,48,"Western Oval",41,1943,"Regular",4,"Home","Footscray","St Kilda",41
4097,1943-05-29,"R4","North Melbourne",15,14,104,"Melbourne",10,11,71,"Arden St",33,1943,"Regular",4,"Home","North Melbourne","Melbourne",33
4098,1943-06-05,"R5","St Kilda",13,14,92,"Carlton",12,8,80,"Toorak Park",12,1943,"Regular",5,"Home","St Kilda","Carlton",12
4099,1943-06-05,"R5","Essendon",16,10,106,"Footscray",16,18,114,"Windy Hill",-8,1943,"Regular",5,"Away","Footscray","Essendon",8
4100,1943-06-05,"R5","Fitzroy",23,12,150,"North Melbourne",10,13,73,"Brunswick St",77,1943,"Regular",5,"Home","Fitzroy","North Melbourne",77
4101,1943-06-05,"R5","Sydney",10,15,75,"Hawthorn",12,13,85,"Princes Park",-10,1943,"Regular",5,"Away","Hawthorn","Sydney",10
4102,1943-06-05,"R5","Melbourne",17,11,113,"Richmond",21,15,141,"Punt Rd",-28,1943,"Regular",5,"Away","Richmond","Melbourne",28
4103,1943-06-12,"R6","Carlton",9,22,76,"Essendon",11,16,82,"Princes Park",-6,1943,"Regular",6,"Away","Essendon","Carlton",6
4104,1943-06-12,"R6","Collingwood",11,21,87,"St Kilda",5,12,42,"Victoria Park",45,1943,"Regular",6,"Home","Collingwood","St Kilda",45
4105,1943-06-12,"R6","Richmond",12,17,89,"Fitzroy",14,11,95,"Punt Rd",-6,1943,"Regular",6,"Away","Fitzroy","Richmond",6
4106,1943-06-12,"R6","Footscray",21,17,143,"Melbourne",8,15,63,"Western Oval",80,1943,"Regular",6,"Home","Footscray","Melbourne",80
4107,1943-06-12,"R6","North Melbourne",14,7,91,"Sydney",12,18,90,"Arden St",1,1943,"Regular",6,"Home","North Melbourne","Sydney",1
4108,1943-06-19,"R7","Melbourne",13,14,92,"Carlton",11,21,87,"Punt Rd",5,1943,"Regular",7,"Home","Melbourne","Carlton",5
4109,1943-06-19,"R7","Essendon",15,13,103,"Collingwood",8,14,62,"Windy Hill",41,1943,"Regular",7,"Home","Essendon","Collingwood",41
4110,1943-06-19,"R7","Fitzroy",16,11,107,"Footscray",11,7,73,"Brunswick St",34,1943,"Regular",7,"Home","Fitzroy","Footscray",34
4111,1943-06-19,"R7","Hawthorn",20,16,136,"North Melbourne",13,17,95,"Glenferrie Oval",41,1943,"Regular",7,"Home","Hawthorn","North Melbourne",41
4112,1943-06-19,"R7","Sydney",12,12,84,"Richmond",17,12,114,"Princes Park",-30,1943,"Regular",7,"Away","Richmond","Sydney",30
4113,1943-06-26,"R8","Carlton",15,16,106,"Fitzroy",9,13,67,"Princes Park",39,1943,"Regular",8,"Home","Carlton","Fitzroy",39
4114,1943-06-26,"R8","Collingwood",10,21,81,"Melbourne",13,9,87,"Victoria Park",-6,1943,"Regular",8,"Away","Melbourne","Collingwood",6
4115,1943-06-26,"R8","St Kilda",15,8,98,"Essendon",20,19,139,"Toorak Park",-41,1943,"Regular",8,"Away","Essendon","St Kilda",41
4116,1943-06-26,"R8","Footscray",10,11,71,"Sydney",6,14,50,"Western Oval",21,1943,"Regular",8,"Home","Footscray","Sydney",21
4117,1943-06-26,"R8","Richmond",15,16,106,"Hawthorn",8,14,62,"Punt Rd",44,1943,"Regular",8,"Home","Richmond","Hawthorn",44
4118,1943-07-03,"R9","Sydney",10,13,73,"Carlton",15,13,103,"Princes Park",-30,1943,"Regular",9,"Away","Carlton","Sydney",30
4119,1943-07-03,"R9","Fitzroy",15,18,108,"Collingwood",9,11,65,"Brunswick St",43,1943,"Regular",9,"Home","Fitzroy","Collingwood",43
4120,1943-07-03,"R9","Hawthorn",13,11,89,"Footscray",11,13,79,"Glenferrie Oval",10,1943,"Regular",9,"Home","Hawthorn","Footscray",10
4121,1943-07-03,"R9","Melbourne",16,14,110,"St Kilda",12,10,82,"Punt Rd",28,1943,"Regular",9,"Home","Melbourne","St Kilda",28
4122,1943-07-03,"R9","North Melbourne",9,2,56,"Richmond",13,7,85,"Arden St",-29,1943,"Regular",9,"Away","Richmond","North Melbourne",29
4123,1943-07-10,"R10","Carlton",16,9,105,"Hawthorn",11,14,80,"Princes Park",25,1943,"Regular",10,"Home","Carlton","Hawthorn",25
4124,1943-07-10,"R10","Collingwood",9,6,60,"Sydney",16,14,110,"Victoria Park",-50,1943,"Regular",10,"Away","Sydney","Collingwood",50
4125,1943-07-10,"R10","Essendon",9,16,70,"Melbourne",13,7,85,"Windy Hill",-15,1943,"Regular",10,"Away","Melbourne","Essendon",15
4126,1943-07-10,"R10","St Kilda",10,11,71,"Fitzroy",14,14,98,"Toorak Park",-27,1943,"Regular",10,"Away","Fitzroy","St Kilda",27
4127,1943-07-10,"R10","Footscray",9,23,77,"North Melbourne",12,14,86,"Western Oval",-9,1943,"Regular",10,"Away","North Melbourne","Footscray",9
4128,1943-07-17,"R11","North Melbourne",12,10,82,"Carlton",11,12,78,"Arden St",4,1943,"Regular",11,"Home","North Melbourne","Carlton",4
4129,1943-07-17,"R11","Hawthorn",16,14,110,"Collingwood",12,13,85,"Glenferrie Oval",25,1943,"Regular",11,"Home","Hawthorn","Collingwood",25
4130,1943-07-17,"R11","Fitzroy",7,14,56,"Essendon",9,24,78,"Brunswick St",-22,1943,"Regular",11,"Away","Essendon","Fitzroy",22
4131,1943-07-17,"R11","Richmond",10,19,79,"Footscray",8,9,57,"Punt Rd",22,1943,"Regular",11,"Home","Richmond","Footscray",22
4132,1943-07-17,"R11","Sydney",16,19,115,"St Kilda",11,14,80,"Princes Park",35,1943,"Regular",11,"Home","Sydney","St Kilda",35
4133,1943-07-31,"R12","Collingwood",11,8,74,"Carlton",28,10,178,"Victoria Park",-104,1943,"Regular",12,"Away","Carlton","Collingwood",104
4134,1943-07-31,"R12","Hawthorn",7,13,55,"Essendon",9,12,66,"Glenferrie Oval",-11,1943,"Regular",12,"Away","Essendon","Hawthorn",11
4135,1943-07-31,"R12","Fitzroy",10,10,70,"Richmond",7,17,59,"Brunswick St",11,1943,"Regular",12,"Home","Fitzroy","Richmond",11
4136,1943-07-31,"R12","Melbourne",23,16,154,"Footscray",11,8,74,"Punt Rd",80,1943,"Regular",12,"Home","Melbourne","Footscray",80
4137,1943-07-31,"R12","Sydney",14,11,95,"North Melbourne",6,6,42,"Princes Park",53,1943,"Regular",12,"Home","Sydney","North Melbourne",53
4138,1943-08-07,"R13","Carlton",13,19,97,"Hawthorn",10,15,75,"Princes Park",22,1943,"Regular",13,"Home","Carlton","Hawthorn",22
4139,1943-08-07,"R13","Collingwood",14,24,108,"North Melbourne",7,8,50,"Victoria Park",58,1943,"Regular",13,"Home","Collingwood","North Melbourne",58
4140,1943-08-07,"R13","Essendon",11,24,90,"Fitzroy",8,8,56,"Windy Hill",34,1943,"Regular",13,"Home","Essendon","Fitzroy",34
4141,1943-08-07,"R13","Footscray",7,17,59,"Richmond",19,19,133,"Western Oval",-74,1943,"Regular",13,"Away","Richmond","Footscray",74
4142,1943-08-07,"R13","Melbourne",9,6,60,"Sydney",21,13,139,"Punt Rd",-79,1943,"Regular",13,"Away","Sydney","Melbourne",79
4143,1943-08-14,"R14","Essendon",9,13,67,"Carlton",10,10,70,"Windy Hill",-3,1943,"Regular",14,"Away","Carlton","Essendon",3
4144,1943-08-14,"R14","Sydney",12,18,90,"Collingwood",11,7,73,"Princes Park",17,1943,"Regular",14,"Home","Sydney","Collingwood",17
4145,1943-08-14,"R14","Fitzroy",15,14,104,"Melbourne",7,12,54,"Brunswick St",50,1943,"Regular",14,"Home","Fitzroy","Melbourne",50
4146,1943-08-14,"R14","North Melbourne",7,11,53,"Footscray",9,10,64,"Arden St",-11,1943,"Regular",14,"Away","Footscray","North Melbourne",11
4147,1943-08-14,"R14","Richmond",9,14,68,"Hawthorn",11,7,73,"Punt Rd",-5,1943,"Regular",14,"Away","Hawthorn","Richmond",5
4148,1943-08-21,"R15","Carlton",15,23,113,"North Melbourne",7,5,47,"Princes Park",66,1943,"Regular",15,"Home","Carlton","North Melbourne",66
4149,1943-08-21,"R15","Collingwood",16,17,113,"Fitzroy",9,9,63,"Victoria Park",50,1943,"Regular",15,"Home","Collingwood","Fitzroy",50
4150,1943-08-21,"R15","Footscray",9,10,64,"Essendon",6,15,51,"Western Oval",13,1943,"Regular",15,"Home","Footscray","Essendon",13
4151,1943-08-21,"R15","Hawthorn",13,10,88,"Sydney",7,14,56,"Glenferrie Oval",32,1943,"Regular",15,"Home","Hawthorn","Sydney",32
4152,1943-08-21,"R15","Richmond",15,19,109,"Melbourne",12,13,85,"Punt Rd",24,1943,"Regular",15,"Home","Richmond","Melbourne",24
4153,1943-08-28,"R16","Fitzroy",12,12,84,"Carlton",10,9,69,"Brunswick St",15,1943,"Regular",16,"Home","Fitzroy","Carlton",15
4154,1943-08-28,"R16","Melbourne",16,17,113,"Collingwood",14,17,101,"Punt Rd",12,1943,"Regular",16,"Home","Melbourne","Collingwood",12
4155,1943-08-28,"R16","Essendon",10,11,71,"Richmond",14,14,98,"Windy Hill",-27,1943,"Regular",16,"Away","Richmond","Essendon",27
4156,1943-08-28,"R16","Sydney",10,19,79,"Footscray",10,6,66,"Princes Park",13,1943,"Regular",16,"Home","Sydney","Footscray",13
4157,1943-08-28,"R16","North Melbourne",8,11,59,"Hawthorn",7,16,58,"Arden St",1,1943,"Regular",16,"Home","North Melbourne","Hawthorn",1
4158,1943-09-04,"SF","Fitzroy",13,16,94,"Carlton",5,13,43,"Princes Park",51,1943,"Finals",17,"Home","Fitzroy","Carlton",51
4159,1943-09-11,"SF","Richmond",9,17,71,"Essendon",13,16,94,"Princes Park",-23,1943,"Finals",17,"Away","Essendon","Richmond",23
4160,1943-09-18,"PF","Richmond",12,14,86,"Fitzroy",8,13,61,"Princes Park",25,1943,"Finals",18,"Home","Richmond","Fitzroy",25
4161,1943-09-25,"GF","Richmond",12,14,86,"Essendon",11,15,81,"Princes Park",5,1943,"Finals",19,"Home","Richmond","Essendon",5
4162,1944-05-06,"R1","Sydney",13,10,88,"Carlton",9,7,61,"Junction Oval",27,1944,"Regular",1,"Home","Sydney","Carlton",27
4163,1944-05-06,"R1","North Melbourne",9,11,65,"Collingwood",14,17,101,"Arden St",-36,1944,"Regular",1,"Away","Collingwood","North Melbourne",36
4164,1944-05-06,"R1","Hawthorn",9,14,68,"Essendon",15,16,106,"Glenferrie Oval",-38,1944,"Regular",1,"Away","Essendon","Hawthorn",38
4165,1944-05-06,"R1","Fitzroy",11,16,82,"St Kilda",10,13,73,"Brunswick St",9,1944,"Regular",1,"Home","Fitzroy","St Kilda",9
4166,1944-05-06,"R1","Footscray",15,23,113,"Geelong",8,7,55,"Western Oval",58,1944,"Regular",1,"Home","Footscray","Geelong",58
4167,1944-05-06,"R1","Melbourne",14,8,92,"Richmond",19,18,132,"Punt Rd",-40,1944,"Regular",1,"Away","Richmond","Melbourne",40
4168,1944-05-13,"R2","Carlton",18,16,124,"Hawthorn",9,14,68,"Princes Park",56,1944,"Regular",2,"Home","Carlton","Hawthorn",56
4169,1944-05-13,"R2","Collingwood",11,17,83,"Fitzroy",19,17,131,"Victoria Park",-48,1944,"Regular",2,"Away","Fitzroy","Collingwood",48
4170,1944-05-13,"R2","Essendon",17,18,120,"Melbourne",16,4,100,"Windy Hill",20,1944,"Regular",2,"Home","Essendon","Melbourne",20
4171,1944-05-13,"R2","St Kilda",12,17,89,"Footscray",10,14,74,"Junction Oval",15,1944,"Regular",2,"Home","St Kilda","Footscray",15
4172,1944-05-13,"R2","Richmond",18,11,119,"North Melbourne",15,9,99,"Punt Rd",20,1944,"Regular",2,"Home","Richmond","North Melbourne",20
4173,1944-05-13,"R2","Geelong",9,11,65,"Sydney",11,18,84,"Kardinia Park",-19,1944,"Regular",2,"Away","Sydney","Geelong",19
4174,1944-05-20,"R3","Melbourne",12,5,77,"Carlton",14,8,92,"Punt Rd",-15,1944,"Regular",3,"Away","Carlton","Melbourne",15
4175,1944-05-20,"R3","Footscray",16,9,105,"Collingwood",13,19,97,"Western Oval",8,1944,"Regular",3,"Home","Footscray","Collingwood",8
4176,1944-05-20,"R3","Essendon",16,14,110,"Richmond",22,19,151,"Windy Hill",-41,1944,"Regular",3,"Away","Richmond","Essendon",41
4177,1944-05-20,"R3","Fitzroy",16,11,107,"North Melbourne",11,16,82,"Brunswick St",25,1944,"Regular",3,"Home","Fitzroy","North Melbourne",25
4178,1944-05-20,"R3","Hawthorn",22,12,144,"Geelong",13,13,91,"Glenferrie Oval",53,1944,"Regular",3,"Home","Hawthorn","Geelong",53
4179,1944-05-20,"R3","Sydney",9,10,64,"St Kilda",7,10,52,"Junction Oval",12,1944,"Regular",3,"Home","Sydney","St Kilda",12
4180,1944-05-27,"R4","Carlton",13,17,95,"Essendon",14,9,93,"Princes Park",2,1944,"Regular",4,"Home","Carlton","Essendon",2
4181,1944-05-27,"R4","Collingwood",11,18,84,"Sydney",12,18,90,"Victoria Park",-6,1944,"Regular",4,"Away","Sydney","Collingwood",6
4182,1944-05-27,"R4","Richmond",14,13,97,"Fitzroy",7,9,51,"Punt Rd",46,1944,"Regular",4,"Home","Richmond","Fitzroy",46
4183,1944-05-27,"R4","North Melbourne",15,14,104,"Footscray",9,16,70,"Arden St",34,1944,"Regular",4,"Home","North Melbourne","Footscray",34
4184,1944-05-27,"R4","Geelong",10,9,69,"Melbourne",22,10,142,"Kardinia Park",-73,1944,"Regular",4,"Away","Melbourne","Geelong",73
4185,1944-05-27,"R4","St Kilda",9,12,66,"Hawthorn",11,7,73,"Junction Oval",-7,1944,"Regular",4,"Away","Hawthorn","St Kilda",7
4186,1944-06-03,"R5","Carlton",16,12,108,"Richmond",14,8,92,"Princes Park",16,1944,"Regular",5,"Home","Carlton","Richmond",16
4187,1944-06-03,"R5","Hawthorn",8,9,57,"Collingwood",10,13,73,"Glenferrie Oval",-16,1944,"Regular",5,"Away","Collingwood","Hawthorn",16
4188,1944-06-03,"R5","Essendon",17,14,116,"Geelong",11,14,80,"Windy Hill",36,1944,"Regular",5,"Home","Essendon","Geelong",36
4189,1944-06-03,"R5","Footscray",8,15,63,"Fitzroy",8,10,58,"Western Oval",5,1944,"Regular",5,"Home","Footscray","Fitzroy",5
4190,1944-06-03,"R5","Melbourne",10,13,73,"St Kilda",13,8,86,"Punt Rd",-13,1944,"Regular",5,"Away","St Kilda","Melbourne",13
4191,1944-06-03,"R5","Sydney",10,12,72,"North Melbourne",10,13,73,"Junction Oval",-1,1944,"Regular",5,"Away","North Melbourne","Sydney",1
4192,1944-06-10,"R6","Geelong",5,10,40,"Carlton",13,25,103,"Kardinia Park",-63,1944,"Regular",6,"Away","Carlton","Geelong",63
4193,1944-06-10,"R6","Collingwood",10,9,69,"Melbourne",15,9,99,"Victoria Park",-30,1944,"Regular",6,"Away","Melbourne","Collingwood",30
4194,1944-06-10,"R6","St Kilda",9,17,71,"Essendon",9,17,71,"Junction Oval",0,1944,"Regular",6,"Home","St Kilda","Essendon",0
4195,1944-06-10,"R6","Fitzroy",14,7,91,"Sydney",10,17,77,"Brunswick St",14,1944,"Regular",6,"Home","Fitzroy","Sydney",14
4196,1944-06-10,"R6","Richmond",19,11,125,"Footscray",18,17,125,"Punt Rd",0,1944,"Regular",6,"Home","Richmond","Footscray",0
4197,1944-06-10,"R6","North Melbourne",21,16,142,"Hawthorn",17,11,113,"Arden St",29,1944,"Regular",6,"Home","North Melbourne","Hawthorn",29
4198,1944-06-17,"R7","St Kilda",6,12,48,"Carlton",15,13,103,"Junction Oval",-55,1944,"Regular",7,"Away","Carlton","St Kilda",55
4199,1944-06-17,"R7","Collingwood",12,21,93,"Essendon",9,10,64,"Victoria Park",29,1944,"Regular",7,"Home","Collingwood","Essendon",29
4200,1944-06-17,"R7","Fitzroy",14,13,97,"Hawthorn",7,10,52,"Brunswick St",45,1944,"Regular",7,"Home","Fitzroy","Hawthorn",45
4201,1944-06-17,"R7","Footscray",9,13,67,"Sydney",8,10,58,"Western Oval",9,1944,"Regular",7,"Home","Footscray","Sydney",9
4202,1944-06-17,"R7","Richmond",25,23,173,"Geelong",9,2,56,"Punt Rd",117,1944,"Regular",7,"Home","Richmond","Geelong",117
4203,1944-06-17,"R7","North Melbourne",15,20,110,"Melbourne",12,10,82,"Arden St",28,1944,"Regular",7,"Home","North Melbourne","Melbourne",28
4204,1944-06-24,"R8","Carlton",17,12,114,"Collingwood",12,11,83,"Princes Park",31,1944,"Regular",8,"Home","Carlton","Collingwood",31
4205,1944-06-24,"R8","Melbourne",7,10,52,"Fitzroy",10,17,77,"Punt Rd",-25,1944,"Regular",8,"Away","Fitzroy","Melbourne",25
4206,1944-06-24,"R8","Hawthorn",9,10,64,"Footscray",14,18,102,"Glenferrie Oval",-38,1944,"Regular",8,"Away","Footscray","Hawthorn",38
4207,1944-06-24,"R8","Geelong",9,13,67,"St Kilda",13,14,92,"Kardinia Park",-25,1944,"Regular",8,"Away","St Kilda","Geelong",25
4208,1944-06-24,"R8","Sydney",11,11,77,"Richmond",17,10,112,"Junction Oval",-35,1944,"Regular",8,"Away","Richmond","Sydney",35
4209,1944-06-24,"R8","Essendon",21,18,144,"North Melbourne",8,12,60,"Windy Hill",84,1944,"Regular",8,"Home","Essendon","North Melbourne",84
4210,1944-07-01,"R9","North Melbourne",11,15,81,"Carlton",7,10,52,"Arden St",29,1944,"Regular",9,"Home","North Melbourne","Carlton",29
4211,1944-07-01,"R9","Collingwood",15,12,102,"Geelong",9,13,67,"Victoria Park",35,1944,"Regular",9,"Home","Collingwood","Geelong",35
4212,1944-07-01,"R9","Fitzroy",12,11,83,"Essendon",11,17,83,"Brunswick St",0,1944,"Regular",9,"Home","Fitzroy","Essendon",0
4213,1944-07-01,"R9","Footscray",8,15,63,"Melbourne",8,13,61,"Western Oval",2,1944,"Regular",9,"Home","Footscray","Melbourne",2
4214,1944-07-01,"R9","Sydney",15,12,102,"Hawthorn",11,11,77,"Junction Oval",25,1944,"Regular",9,"Home","Sydney","Hawthorn",25
4215,1944-07-01,"R9","Richmond",11,18,84,"St Kilda",7,11,53,"Punt Rd",31,1944,"Regular",9,"Home","Richmond","St Kilda",31
4216,1944-07-08,"R10","Carlton",11,15,81,"Fitzroy",6,15,51,"Princes Park",30,1944,"Regular",10,"Home","Carlton","Fitzroy",30
4217,1944-07-08,"R10","St Kilda",17,11,113,"Collingwood",6,9,45,"Junction Oval",68,1944,"Regular",10,"Home","St Kilda","Collingwood",68
4218,1944-07-08,"R10","Essendon",14,16,100,"Footscray",8,13,61,"Windy Hill",39,1944,"Regular",10,"Home","Essendon","Footscray",39
4219,1944-07-08,"R10","Geelong",13,9,87,"North Melbourne",21,14,140,"Kardinia Park",-53,1944,"Regular",10,"Away","North Melbourne","Geelong",53
4220,1944-07-08,"R10","Hawthorn",11,9,75,"Richmond",13,16,94,"Glenferrie Oval",-19,1944,"Regular",10,"Away","Richmond","Hawthorn",19
4221,1944-07-08,"R10","Melbourne",10,10,70,"Sydney",9,13,67,"Punt Rd",3,1944,"Regular",10,"Home","Melbourne","Sydney",3
4222,1944-07-15,"R11","Footscray",13,8,86,"Carlton",12,11,83,"Western Oval",3,1944,"Regular",11,"Home","Footscray","Carlton",3
4223,1944-07-15,"R11","Richmond",16,17,113,"Collingwood",9,13,67,"Punt Rd",46,1944,"Regular",11,"Home","Richmond","Collingwood",46
4224,1944-07-15,"R11","Sydney",7,15,57,"Essendon",15,16,106,"Junction Oval",-49,1944,"Regular",11,"Away","Essendon","Sydney",49
4225,1944-07-15,"R11","Fitzroy",25,29,179,"Geelong",8,8,56,"Brunswick St",123,1944,"Regular",11,"Home","Fitzroy","Geelong",123
4226,1944-07-15,"R11","Hawthorn",7,10,52,"Melbourne",22,25,157,"Glenferrie Oval",-105,1944,"Regular",11,"Away","Melbourne","Hawthorn",105
4227,1944-07-15,"R11","North Melbourne",11,20,86,"St Kilda",7,11,53,"Arden St",33,1944,"Regular",11,"Home","North Melbourne","St Kilda",33
4228,1944-07-22,"R12","Carlton",10,14,74,"Sydney",8,12,60,"Princes Park",14,1944,"Regular",12,"Home","Carlton","Sydney",14
4229,1944-07-22,"R12","Collingwood",13,11,89,"North Melbourne",10,10,70,"Victoria Park",19,1944,"Regular",12,"Home","Collingwood","North Melbourne",19
4230,1944-07-22,"R12","Essendon",19,18,132,"Hawthorn",3,7,25,"Windy Hill",107,1944,"Regular",12,"Home","Essendon","Hawthorn",107
4231,1944-07-22,"R12","St Kilda",12,16,88,"Fitzroy",8,14,62,"Junction Oval",26,1944,"Regular",12,"Home","St Kilda","Fitzroy",26
4232,1944-07-22,"R12","Geelong",11,11,77,"Footscray",14,17,101,"Kardinia Park",-24,1944,"Regular",12,"Away","Footscray","Geelong",24
4233,1944-07-22,"R12","Richmond",17,8,110,"Melbourne",9,15,69,"Punt Rd",41,1944,"Regular",12,"Home","Richmond","Melbourne",41
4234,1944-07-29,"R13","Hawthorn",10,2,62,"Carlton",13,28,106,"Glenferrie Oval",-44,1944,"Regular",13,"Away","Carlton","Hawthorn",44
4235,1944-07-29,"R13","Fitzroy",12,17,89,"Collingwood",4,14,38,"Brunswick St",51,1944,"Regular",13,"Home","Fitzroy","Collingwood",51
4236,1944-07-29,"R13","Melbourne",11,12,78,"Essendon",14,14,98,"Punt Rd",-20,1944,"Regular",13,"Away","Essendon","Melbourne",20
4237,1944-07-29,"R13","Footscray",14,15,99,"St Kilda",11,10,76,"Western Oval",23,1944,"Regular",13,"Home","Footscray","St Kilda",23
4238,1944-07-29,"R13","Sydney",8,30,78,"Geelong",8,8,56,"Junction Oval",22,1944,"Regular",13,"Home","Sydney","Geelong",22
4239,1944-07-29,"R13","North Melbourne",11,21,87,"Richmond",14,2,86,"Arden St",1,1944,"Regular",13,"Home","North Melbourne","Richmond",1
4240,1944-08-05,"R14","Carlton",4,14,38,"Melbourne",8,6,54,"Princes Park",-16,1944,"Regular",14,"Away","Melbourne","Carlton",16
4241,1944-08-05,"R14","Collingwood",8,12,60,"Footscray",15,9,99,"Victoria Park",-39,1944,"Regular",14,"Away","Footscray","Collingwood",39
4242,1944-08-05,"R14","Richmond",11,17,83,"Essendon",12,15,87,"Punt Rd",-4,1944,"Regular",14,"Away","Essendon","Richmond",4
4243,1944-08-05,"R14","North Melbourne",11,12,78,"Fitzroy",15,11,101,"Arden St",-23,1944,"Regular",14,"Away","Fitzroy","North Melbourne",23
4244,1944-08-05,"R14","Geelong",11,20,86,"Hawthorn",9,7,61,"Kardinia Park",25,1944,"Regular",14,"Home","Geelong","Hawthorn",25
4245,1944-08-05,"R14","St Kilda",7,12,54,"Sydney",10,19,79,"Junction Oval",-25,1944,"Regular",14,"Away","Sydney","St Kilda",25
4246,1944-08-12,"R15","Essendon",6,9,45,"Carlton",14,20,104,"Windy Hill",-59,1944,"Regular",15,"Away","Carlton","Essendon",59
4247,1944-08-12,"R15","Sydney",16,10,106,"Collingwood",8,22,70,"Junction Oval",36,1944,"Regular",15,"Home","Sydney","Collingwood",36
4248,1944-08-12,"R15","Fitzroy",16,10,106,"Richmond",7,14,56,"Brunswick St",50,1944,"Regular",15,"Home","Fitzroy","Richmond",50
4249,1944-08-12,"R15","Footscray",12,6,78,"North Melbourne",11,8,74,"Western Oval",4,1944,"Regular",15,"Home","Footscray","North Melbourne",4
4250,1944-08-12,"R15","Melbourne",8,21,69,"Geelong",8,8,56,"Punt Rd",13,1944,"Regular",15,"Home","Melbourne","Geelong",13
4251,1944-08-12,"R15","Hawthorn",12,16,88,"St Kilda",12,16,88,"Glenferrie Oval",0,1944,"Regular",15,"Home","Hawthorn","St Kilda",0
4252,1944-08-19,"R16","Richmond",11,16,82,"Carlton",8,16,64,"Punt Rd",18,1944,"Regular",16,"Home","Richmond","Carlton",18
4253,1944-08-19,"R16","Collingwood",18,20,128,"Hawthorn",7,14,56,"Victoria Park",72,1944,"Regular",16,"Home","Collingwood","Hawthorn",72
4254,1944-08-19,"R16","Geelong",10,12,72,"Essendon",13,19,97,"Kardinia Park",-25,1944,"Regular",16,"Away","Essendon","Geelong",25
4255,1944-08-19,"R16","Fitzroy",13,14,92,"Footscray",12,18,90,"Brunswick St",2,1944,"Regular",16,"Home","Fitzroy","Footscray",2
4256,1944-08-19,"R16","St Kilda",13,13,91,"Melbourne",7,10,52,"Junction Oval",39,1944,"Regular",16,"Home","St Kilda","Melbourne",39
4257,1944-08-19,"R16","North Melbourne",6,12,48,"Sydney",13,16,94,"Arden St",-46,1944,"Regular",16,"Away","Sydney","North Melbourne",46
4258,1944-08-26,"R17","Carlton",23,28,166,"Geelong",8,12,60,"Princes Park",106,1944,"Regular",17,"Home","Carlton","Geelong",106
4259,1944-08-26,"R17","Melbourne",11,17,83,"Collingwood",15,12,102,"Punt Rd",-19,1944,"Regular",17,"Away","Collingwood","Melbourne",19
4260,1944-08-26,"R17","Essendon",28,21,189,"St Kilda",12,11,83,"Windy Hill",106,1944,"Regular",17,"Home","Essendon","St Kilda",106
4261,1944-08-26,"R17","Sydney",8,13,61,"Fitzroy",17,14,116,"Junction Oval",-55,1944,"Regular",17,"Away","Fitzroy","Sydney",55
4262,1944-08-26,"R17","Footscray",5,14,44,"Richmond",9,15,69,"Western Oval",-25,1944,"Regular",17,"Away","Richmond","Footscray",25
4263,1944-08-26,"R17","Hawthorn",12,12,84,"North Melbourne",15,19,109,"Glenferrie Oval",-25,1944,"Regular",17,"Away","North Melbourne","Hawthorn",25
4264,1944-09-02,"R18","Carlton",13,10,88,"Footscray",12,17,89,"Princes Park",-1,1944,"Regular",18,"Away","Footscray","Carlton",1
4265,1944-09-02,"R18","Collingwood",10,8,68,"Richmond",15,18,108,"Victoria Park",-40,1944,"Regular",18,"Away","Richmond","Collingwood",40
4266,1944-09-02,"R18","Essendon",17,24,126,"Sydney",6,8,44,"Windy Hill",82,1944,"Regular",18,"Home","Essendon","Sydney",82
4267,1944-09-02,"R18","Geelong",10,10,70,"Fitzroy",15,15,105,"Kardinia Park",-35,1944,"Regular",18,"Away","Fitzroy","Geelong",35
4268,1944-09-02,"R18","Melbourne",14,27,111,"Hawthorn",6,13,49,"Punt Rd",62,1944,"Regular",18,"Home","Melbourne","Hawthorn",62
4269,1944-09-02,"R18","St Kilda",12,10,82,"North Melbourne",16,15,111,"Junction Oval",-29,1944,"Regular",18,"Away","North Melbourne","St Kilda",29
4270,1944-09-09,"SF","Essendon",14,17,101,"Footscray",8,4,52,"Junction Oval",49,1944,"Finals",19,"Home","Essendon","Footscray",49
4271,1944-09-16,"SF","Richmond",10,10,70,"Fitzroy",11,15,81,"Junction Oval",-11,1944,"Finals",19,"Away","Fitzroy","Richmond",11
4272,1944-09-23,"PF","Richmond",16,12,108,"Essendon",12,15,87,"Junction Oval",21,1944,"Finals",20,"Home","Richmond","Essendon",21
4273,1944-09-30,"GF","Richmond",7,9,51,"Fitzroy",9,12,66,"Junction Oval",-15,1944,"Finals",21,"Away","Fitzroy","Richmond",15
4274,1945-04-21,"R1","Carlton",13,9,87,"Melbourne",15,18,108,"Princes Park",-21,1945,"Regular",1,"Away","Melbourne","Carlton",21
4275,1945-04-21,"R1","Collingwood",13,13,91,"North Melbourne",10,10,70,"Victoria Park",21,1945,"Regular",1,"Home","Collingwood","North Melbourne",21
4276,1945-04-21,"R1","Essendon",22,18,150,"Hawthorn",12,7,79,"Windy Hill",71,1945,"Regular",1,"Home","Essendon","Hawthorn",71
4277,1945-04-21,"R1","Geelong",10,8,68,"Fitzroy",15,16,106,"Kardinia Park",-38,1945,"Regular",1,"Away","Fitzroy","Geelong",38
4278,1945-04-21,"R1","Richmond",14,11,95,"Footscray",16,9,105,"Punt Rd",-10,1945,"Regular",1,"Away","Footscray","Richmond",10
4279,1945-04-21,"R1","St Kilda",10,17,77,"Sydney",17,16,118,"Junction Oval",-41,1945,"Regular",1,"Away","Sydney","St Kilda",41
4280,1945-04-28,"R2","Hawthorn",16,10,106,"Carlton",9,18,72,"Glenferrie Oval",34,1945,"Regular",2,"Home","Hawthorn","Carlton",34
4281,1945-04-28,"R2","Sydney",12,14,86,"Collingwood",11,10,76,"Junction Oval",10,1945,"Regular",2,"Home","Sydney","Collingwood",10
4282,1945-04-28,"R2","Fitzroy",8,16,64,"Essendon",9,10,64,"Brunswick St",0,1945,"Regular",2,"Home","Fitzroy","Essendon",0
4283,1945-04-28,"R2","Footscray",18,9,117,"Geelong",12,9,81,"Western Oval",36,1945,"Regular",2,"Home","Footscray","Geelong",36
4284,1945-04-28,"R2","Melbourne",17,16,118,"St Kilda",7,7,49,"Punt Rd",69,1945,"Regular",2,"Home","Melbourne","St Kilda",69
4285,1945-04-28,"R2","North Melbourne",7,18,60,"Richmond",8,17,65,"Arden St",-5,1945,"Regular",2,"Away","Richmond","North Melbourne",5
4286,1945-05-05,"R3","Essendon",22,18,150,"Carlton",7,8,50,"Windy Hill",100,1945,"Regular",3,"Home","Essendon","Carlton",100
4287,1945-05-05,"R3","Collingwood",10,21,81,"Melbourne",11,12,78,"Victoria Park",3,1945,"Regular",3,"Home","Collingwood","Melbourne",3
4288,1945-05-05,"R3","Fitzroy",12,9,81,"Footscray",14,14,98,"Brunswick St",-17,1945,"Regular",3,"Away","Footscray","Fitzroy",17
4289,1945-05-05,"R3","North Melbourne",14,15,99,"Geelong",10,15,75,"Arden St",24,1945,"Regular",3,"Home","North Melbourne","Geelong",24
4290,1945-05-05,"R3","St Kilda",15,10,100,"Hawthorn",11,13,79,"Junction Oval",21,1945,"Regular",3,"Home","St Kilda","Hawthorn",21
4291,1945-05-05,"R3","Richmond",13,11,89,"Sydney",15,19,109,"Punt Rd",-20,1945,"Regular",3,"Away","Sydney","Richmond",20
4292,1945-05-12,"R4","Carlton",12,12,84,"Fitzroy",11,11,77,"Princes Park",7,1945,"Regular",4,"Home","Carlton","Fitzroy",7
4293,1945-05-12,"R4","Collingwood",13,23,101,"Hawthorn",9,9,63,"Victoria Park",38,1945,"Regular",4,"Home","Collingwood","Hawthorn",38
4294,1945-05-12,"R4","St Kilda",14,17,101,"Essendon",23,18,156,"Junction Oval",-55,1945,"Regular",4,"Away","Essendon","St Kilda",55
4295,1945-05-12,"R4","Footscray",11,13,79,"North Melbourne",14,8,92,"Western Oval",-13,1945,"Regular",4,"Away","North Melbourne","Footscray",13
4296,1945-05-12,"R4","Geelong",9,13,67,"Sydney",10,23,83,"Kardinia Park",-16,1945,"Regular",4,"Away","Sydney","Geelong",16
4297,1945-05-12,"R4","Melbourne",9,11,65,"Richmond",13,7,85,"Punt Rd",-20,1945,"Regular",4,"Away","Richmond","Melbourne",20
4298,1945-05-19,"R5","Carlton",12,18,90,"St Kilda",11,13,79,"Princes Park",11,1945,"Regular",5,"Home","Carlton","St Kilda",11
4299,1945-05-19,"R5","Essendon",12,16,88,"Collingwood",11,21,87,"Windy Hill",1,1945,"Regular",5,"Home","Essendon","Collingwood",1
4300,1945-05-19,"R5","Fitzroy",11,10,76,"North Melbourne",13,14,92,"Brunswick St",-16,1945,"Regular",5,"Away","North Melbourne","Fitzroy",16
4301,1945-05-19,"R5","Sydney",15,9,99,"Footscray",12,11,83,"Junction Oval",16,1945,"Regular",5,"Home","Sydney","Footscray",16
4302,1945-05-19,"R5","Melbourne",18,12,120,"Geelong",15,10,100,"Punt Rd",20,1945,"Regular",5,"Home","Melbourne","Geelong",20
4303,1945-05-19,"R5","Hawthorn",15,7,97,"Richmond",20,11,131,"Glenferrie Oval",-34,1945,"Regular",5,"Away","Richmond","Hawthorn",34
4304,1945-05-26,"R6","Collingwood",15,18,108,"Carlton",12,11,83,"Victoria Park",25,1945,"Regular",6,"Home","Collingwood","Carlton",25
4305,1945-05-26,"R6","Richmond",12,11,83,"Essendon",9,17,71,"Punt Rd",12,1945,"Regular",6,"Home","Richmond","Essendon",12
4306,1945-05-26,"R6","St Kilda",8,20,68,"Fitzroy",12,21,93,"Junction Oval",-25,1945,"Regular",6,"Away","Fitzroy","St Kilda",25
4307,1945-05-26,"R6","Footscray",11,16,82,"Melbourne",7,13,55,"Western Oval",27,1945,"Regular",6,"Home","Footscray","Melbourne",27
4308,1945-05-26,"R6","Geelong",10,16,76,"Hawthorn",10,8,68,"Kardinia Park",8,1945,"Regular",6,"Home","Geelong","Hawthorn",8
4309,1945-05-26,"R6","North Melbourne",9,12,66,"Sydney",8,10,58,"Arden St",8,1945,"Regular",6,"Home","North Melbourne","Sydney",8
4310,1945-06-02,"R7","Carlton",12,17,89,"Richmond",13,16,94,"Princes Park",-5,1945,"Regular",7,"Away","Richmond","Carlton",5
4311,1945-06-02,"R7","St Kilda",7,12,54,"Collingwood",19,16,130,"Junction Oval",-76,1945,"Regular",7,"Away","Collingwood","St Kilda",76
4312,1945-06-02,"R7","Essendon",14,28,112,"Geelong",9,10,64,"Windy Hill",48,1945,"Regular",7,"Home","Essendon","Geelong",48
4313,1945-06-02,"R7","Fitzroy",7,23,65,"Sydney",10,15,75,"Brunswick St",-10,1945,"Regular",7,"Away","Sydney","Fitzroy",10
4314,1945-06-02,"R7","Hawthorn",11,15,81,"Footscray",17,14,116,"Glenferrie Oval",-35,1945,"Regular",7,"Away","Footscray","Hawthorn",35
4315,1945-06-02,"R7","Melbourne",10,12,72,"North Melbourne",18,11,119,"Punt Rd",-47,1945,"Regular",7,"Away","North Melbourne","Melbourne",47
4316,1945-06-09,"R8","Geelong",10,9,69,"Carlton",14,21,105,"Kardinia Park",-36,1945,"Regular",8,"Away","Carlton","Geelong",36
4317,1945-06-09,"R8","Fitzroy",23,15,153,"Collingwood",8,10,58,"Brunswick St",95,1945,"Regular",8,"Home","Fitzroy","Collingwood",95
4318,1945-06-09,"R8","Footscray",12,15,87,"Essendon",7,14,56,"Western Oval",31,1945,"Regular",8,"Home","Footscray","Essendon",31
4319,1945-06-09,"R8","North Melbourne",16,10,106,"Hawthorn",10,8,68,"Arden St",38,1945,"Regular",8,"Home","North Melbourne","Hawthorn",38
4320,1945-06-09,"R8","Sydney",12,16,88,"Melbourne",9,4,58,"Junction Oval",30,1945,"Regular",8,"Home","Sydney","Melbourne",30
4321,1945-06-09,"R8","Richmond",16,15,111,"St Kilda",13,6,84,"Punt Rd",27,1945,"Regular",8,"Home","Richmond","St Kilda",27
4322,1945-06-16,"R9","Carlton",11,11,77,"Footscray",11,20,86,"Princes Park",-9,1945,"Regular",9,"Away","Footscray","Carlton",9
4323,1945-06-16,"R9","Collingwood",13,12,90,"Richmond",8,13,61,"Victoria Park",29,1945,"Regular",9,"Home","Collingwood","Richmond",29
4324,1945-06-16,"R9","Essendon",12,20,92,"North Melbourne",18,14,122,"Windy Hill",-30,1945,"Regular",9,"Away","North Melbourne","Essendon",30
4325,1945-06-16,"R9","Melbourne",11,15,81,"Fitzroy",14,17,101,"Punt Rd",-20,1945,"Regular",9,"Away","Fitzroy","Melbourne",20
4326,1945-06-16,"R9","St Kilda",14,17,101,"Geelong",14,12,96,"Junction Oval",5,1945,"Regular",9,"Home","St Kilda","Geelong",5
4327,1945-06-16,"R9","Hawthorn",12,10,82,"Sydney",20,10,130,"Glenferrie Oval",-48,1945,"Regular",9,"Away","Sydney","Hawthorn",48
4328,1945-06-23,"R10","North Melbourne",7,17,59,"Carlton",12,12,84,"Arden St",-25,1945,"Regular",10,"Away","Carlton","North Melbourne",25
4329,1945-06-23,"R10","Geelong",7,5,47,"Collingwood",21,18,144,"Kardinia Park",-97,1945,"Regular",10,"Away","Collingwood","Geelong",97
4330,1945-06-23,"R10","Sydney",12,15,87,"Essendon",5,11,41,"Junction Oval",46,1945,"Regular",10,"Home","Sydney","Essendon",46
4331,1945-06-23,"R10","Fitzroy",12,14,86,"Richmond",13,11,89,"Brunswick St",-3,1945,"Regular",10,"Away","Richmond","Fitzroy",3
4332,1945-06-23,"R10","Footscray",16,15,111,"St Kilda",7,6,48,"Western Oval",63,1945,"Regular",10,"Home","Footscray","St Kilda",63
4333,1945-06-23,"R10","Melbourne",15,14,104,"Hawthorn",12,14,86,"Punt Rd",18,1945,"Regular",10,"Home","Melbourne","Hawthorn",18
4334,1945-06-30,"R11","Carlton",8,8,56,"Sydney",7,8,50,"Princes Park",6,1945,"Regular",11,"Home","Carlton","Sydney",6
4335,1945-06-30,"R11","Collingwood",9,10,64,"Footscray",10,9,69,"Victoria Park",-5,1945,"Regular",11,"Away","Footscray","Collingwood",5
4336,1945-06-30,"R11","Essendon",7,12,54,"Melbourne",9,14,68,"Windy Hill",-14,1945,"Regular",11,"Away","Melbourne","Essendon",14
4337,1945-06-30,"R11","Hawthorn",7,8,50,"Fitzroy",10,15,75,"Glenferrie Oval",-25,1945,"Regular",11,"Away","Fitzroy","Hawthorn",25
4338,1945-06-30,"R11","Richmond",14,28,112,"Geelong",8,8,56,"Punt Rd",56,1945,"Regular",11,"Home","Richmond","Geelong",56
4339,1945-06-30,"R11","St Kilda",6,15,51,"North Melbourne",6,21,57,"Junction Oval",-6,1945,"Regular",11,"Away","North Melbourne","St Kilda",6
4340,1945-07-07,"R12","Melbourne",12,8,80,"Carlton",12,9,81,"Punt Rd",-1,1945,"Regular",12,"Away","Carlton","Melbourne",1
4341,1945-07-07,"R12","North Melbourne",11,11,77,"Collingwood",13,5,83,"Arden St",-6,1945,"Regular",12,"Away","Collingwood","North Melbourne",6
4342,1945-07-07,"R12","Hawthorn",15,17,107,"Essendon",7,12,54,"Glenferrie Oval",53,1945,"Regular",12,"Home","Hawthorn","Essendon",53
4343,1945-07-07,"R12","Fitzroy",17,27,129,"Geelong",4,9,33,"Brunswick St",96,1945,"Regular",12,"Home","Fitzroy","Geelong",96
4344,1945-07-07,"R12","Footscray",15,12,102,"Richmond",11,8,74,"Western Oval",28,1945,"Regular",12,"Home","Footscray","Richmond",28
4345,1945-07-07,"R12","Sydney",14,22,106,"St Kilda",6,14,50,"Junction Oval",56,1945,"Regular",12,"Home","Sydney","St Kilda",56
4346,1945-07-14,"R13","Carlton",13,12,90,"Hawthorn",8,11,59,"Princes Park",31,1945,"Regular",13,"Home","Carlton","Hawthorn",31
4347,1945-07-14,"R13","Collingwood",11,14,80,"Sydney",7,12,54,"Victoria Park",26,1945,"Regular",13,"Home","Collingwood","Sydney",26
4348,1945-07-14,"R13","Essendon",7,14,56,"Fitzroy",11,14,80,"Windy Hill",-24,1945,"Regular",13,"Away","Fitzroy","Essendon",24
4349,1945-07-14,"R13","Geelong",11,14,80,"Footscray",13,19,97,"Kardinia Park",-17,1945,"Regular",13,"Away","Footscray","Geelong",17
4350,1945-07-14,"R13","St Kilda",9,10,64,"Melbourne",10,23,83,"Junction Oval",-19,1945,"Regular",13,"Away","Melbourne","St Kilda",19
4351,1945-07-14,"R13","Richmond",18,10,118,"North Melbourne",15,9,99,"Punt Rd",19,1945,"Regular",13,"Home","Richmond","North Melbourne",19
4352,1945-07-21,"R14","Carlton",11,9,75,"Essendon",10,18,78,"Princes Park",-3,1945,"Regular",14,"Away","Essendon","Carlton",3
4353,1945-07-21,"R14","Melbourne",10,17,77,"Collingwood",16,16,112,"Punt Rd",-35,1945,"Regular",14,"Away","Collingwood","Melbourne",35
4354,1945-07-21,"R14","Footscray",9,7,61,"Fitzroy",8,15,63,"Western Oval",-2,1945,"Regular",14,"Away","Fitzroy","Footscray",2
4355,1945-07-21,"R14","Geelong",9,9,63,"North Melbourne",13,19,97,"Kardinia Park",-34,1945,"Regular",14,"Away","North Melbourne","Geelong",34
4356,1945-07-21,"R14","Hawthorn",15,15,105,"St Kilda",13,3,81,"Glenferrie Oval",24,1945,"Regular",14,"Home","Hawthorn","St Kilda",24
4357,1945-07-21,"R14","Sydney",14,11,95,"Richmond",10,17,77,"Junction Oval",18,1945,"Regular",14,"Home","Sydney","Richmond",18
4358,1945-07-28,"R15","Fitzroy",7,12,54,"Carlton",9,4,58,"Brunswick St",-4,1945,"Regular",15,"Away","Carlton","Fitzroy",4
4359,1945-07-28,"R15","Hawthorn",9,13,67,"Collingwood",15,9,99,"Glenferrie Oval",-32,1945,"Regular",15,"Away","Collingwood","Hawthorn",32
4360,1945-07-28,"R15","Essendon",18,15,123,"St Kilda",3,6,24,"Windy Hill",99,1945,"Regular",15,"Home","Essendon","St Kilda",99
4361,1945-07-28,"R15","North Melbourne",11,7,73,"Footscray",8,6,54,"Arden St",19,1945,"Regular",15,"Home","North Melbourne","Footscray",19
4362,1945-07-28,"R15","Sydney",18,27,135,"Geelong",10,7,67,"Junction Oval",68,1945,"Regular",15,"Home","Sydney","Geelong",68
4363,1945-07-28,"R15","Richmond",13,14,92,"Melbourne",11,13,79,"Punt Rd",13,1945,"Regular",15,"Home","Richmond","Melbourne",13
4364,1945-08-04,"R16","St Kilda",7,15,57,"Carlton",11,13,79,"Junction Oval",-22,1945,"Regular",16,"Away","Carlton","St Kilda",22
4365,1945-08-04,"R16","Collingwood",16,8,104,"Essendon",10,15,75,"Victoria Park",29,1945,"Regular",16,"Home","Collingwood","Essendon",29
4366,1945-08-04,"R16","North Melbourne",12,6,78,"Fitzroy",4,9,33,"Arden St",45,1945,"Regular",16,"Home","North Melbourne","Fitzroy",45
4367,1945-08-04,"R16","Footscray",7,13,55,"Sydney",8,8,56,"Western Oval",-1,1945,"Regular",16,"Away","Sydney","Footscray",1
4368,1945-08-04,"R16","Geelong",7,14,56,"Melbourne",17,13,115,"Kardinia Park",-59,1945,"Regular",16,"Away","Melbourne","Geelong",59
4369,1945-08-04,"R16","Richmond",15,15,105,"Hawthorn",19,7,121,"Punt Rd",-16,1945,"Regular",16,"Away","Hawthorn","Richmond",16
4370,1945-08-11,"R17","Carlton",13,11,89,"Collingwood",13,5,83,"Princes Park",6,1945,"Regular",17,"Home","Carlton","Collingwood",6
4371,1945-08-11,"R17","Essendon",14,22,106,"Richmond",10,13,73,"Windy Hill",33,1945,"Regular",17,"Home","Essendon","Richmond",33
4372,1945-08-11,"R17","Fitzroy",17,27,129,"St Kilda",8,14,62,"Brunswick St",67,1945,"Regular",17,"Home","Fitzroy","St Kilda",67
4373,1945-08-11,"R17","Melbourne",12,18,90,"Footscray",12,9,81,"Punt Rd",9,1945,"Regular",17,"Home","Melbourne","Footscray",9
4374,1945-08-11,"R17","Hawthorn",14,21,105,"Geelong",9,13,67,"Glenferrie Oval",38,1945,"Regular",17,"Home","Hawthorn","Geelong",38
4375,1945-08-11,"R17","Sydney",21,8,134,"North Melbourne",10,16,76,"Junction Oval",58,1945,"Regular",17,"Home","Sydney","North Melbourne",58
4376,1945-08-18,"R18","Richmond",12,9,81,"Carlton",13,15,93,"Punt Rd",-12,1945,"Regular",18,"Away","Carlton","Richmond",12
4377,1945-08-18,"R18","Collingwood",17,19,121,"St Kilda",5,12,42,"Victoria Park",79,1945,"Regular",18,"Home","Collingwood","St Kilda",79
4378,1945-08-18,"R18","Geelong",14,7,91,"Essendon",16,13,109,"Kardinia Park",-18,1945,"Regular",18,"Away","Essendon","Geelong",18
4379,1945-08-18,"R18","Sydney",10,13,73,"Fitzroy",11,16,82,"Junction Oval",-9,1945,"Regular",18,"Away","Fitzroy","Sydney",9
4380,1945-08-18,"R18","Footscray",15,15,105,"Hawthorn",13,11,89,"Western Oval",16,1945,"Regular",18,"Home","Footscray","Hawthorn",16
4381,1945-08-18,"R18","North Melbourne",11,17,83,"Melbourne",8,10,58,"Arden St",25,1945,"Regular",18,"Home","North Melbourne","Melbourne",25
4382,1945-08-25,"R19","Carlton",23,23,161,"Geelong",9,13,67,"Princes Park",94,1945,"Regular",19,"Home","Carlton","Geelong",94
4383,1945-08-25,"R19","Collingwood",16,7,103,"Fitzroy",10,17,77,"Victoria Park",26,1945,"Regular",19,"Home","Collingwood","Fitzroy",26
4384,1945-08-25,"R19","Essendon",15,17,107,"Footscray",9,13,67,"Windy Hill",40,1945,"Regular",19,"Home","Essendon","Footscray",40
4385,1945-08-25,"R19","Hawthorn",11,11,77,"North Melbourne",10,10,70,"Glenferrie Oval",7,1945,"Regular",19,"Home","Hawthorn","North Melbourne",7
4386,1945-08-25,"R19","Melbourne",10,13,73,"Sydney",12,20,92,"Punt Rd",-19,1945,"Regular",19,"Away","Sydney","Melbourne",19
4387,1945-08-25,"R19","St Kilda",7,6,48,"Richmond",13,22,100,"Junction Oval",-52,1945,"Regular",19,"Away","Richmond","St Kilda",52
4388,1945-09-01,"R20","Footscray",8,14,62,"Carlton",16,19,115,"Western Oval",-53,1945,"Regular",20,"Away","Carlton","Footscray",53
4389,1945-09-01,"R20","Richmond",8,19,67,"Collingwood",12,15,87,"Punt Rd",-20,1945,"Regular",20,"Away","Collingwood","Richmond",20
4390,1945-09-01,"R20","North Melbourne",14,17,101,"Essendon",13,17,95,"Arden St",6,1945,"Regular",20,"Home","North Melbourne","Essendon",6
4391,1945-09-01,"R20","Fitzroy",14,22,106,"Melbourne",15,11,101,"Brunswick St",5,1945,"Regular",20,"Home","Fitzroy","Melbourne",5
4392,1945-09-01,"R20","Geelong",13,14,92,"St Kilda",9,11,65,"Kardinia Park",27,1945,"Regular",20,"Home","Geelong","St Kilda",27
4393,1945-09-01,"R20","Sydney",16,16,112,"Hawthorn",11,10,76,"Junction Oval",36,1945,"Regular",20,"Home","Sydney","Hawthorn",36
4394,1945-09-08,"SF","North Melbourne",8,20,68,"Carlton",14,10,94,"Princes Park",-26,1945,"Finals",21,"Away","Carlton","North Melbourne",26
4395,1945-09-15,"SF","Sydney",13,10,88,"Collingwood",11,11,77,"Princes Park",11,1945,"Finals",21,"Home","Sydney","Collingwood",11
4396,1945-09-22,"PF","Collingwood",12,8,80,"Carlton",13,12,90,"Princes Park",-10,1945,"Finals",22,"Away","Carlton","Collingwood",10
4397,1945-09-29,"GF","Sydney",10,15,75,"Carlton",15,13,103,"Princes Park",-28,1945,"Finals",23,"Away","Carlton","Sydney",28
4398,1946-04-20,"R1","Footscray",15,10,100,"Essendon",14,14,98,"Western Oval",2,1946,"Regular",1,"Home","Footscray","Essendon",2
4399,1946-04-20,"R1","Fitzroy",12,11,83,"Richmond",12,15,87,"Brunswick St",-4,1946,"Regular",1,"Away","Richmond","Fitzroy",4
4400,1946-04-20,"R1","Melbourne",20,17,137,"Geelong",12,19,91,"Punt Rd",46,1946,"Regular",1,"Home","Melbourne","Geelong",46
4401,1946-04-22,"R1","Sydney",16,13,109,"Carlton",18,9,117,"Junction Oval",-8,1946,"Regular",1,"Away","Carlton","Sydney",8
4402,1946-04-22,"R1","Hawthorn",7,19,61,"Collingwood",18,16,124,"Glenferrie Oval",-63,1946,"Regular",1,"Away","Collingwood","Hawthorn",63
4403,1946-04-22,"R1","North Melbourne",19,23,137,"St Kilda",12,6,78,"Arden St",59,1946,"Regular",1,"Home","North Melbourne","St Kilda",59
4404,1946-04-27,"R2","Carlton",9,12,66,"Melbourne",10,12,72,"Princes Park",-6,1946,"Regular",2,"Away","Melbourne","Carlton",6
4405,1946-04-27,"R2","Collingwood",10,14,74,"Fitzroy",8,10,58,"Victoria Park",16,1946,"Regular",2,"Home","Collingwood","Fitzroy",16
4406,1946-04-27,"R2","Essendon",10,11,71,"Sydney",8,5,53,"Windy Hill",18,1946,"Regular",2,"Home","Essendon","Sydney",18
4407,1946-04-27,"R2","St Kilda",11,3,69,"Footscray",16,21,117,"Junction Oval",-48,1946,"Regular",2,"Away","Footscray","St Kilda",48
4408,1946-04-27,"R2","Geelong",15,14,104,"Hawthorn",9,19,73,"Kardinia Park",31,1946,"Regular",2,"Home","Geelong","Hawthorn",31
4409,1946-04-27,"R2","Richmond",15,15,105,"North Melbourne",19,19,133,"Punt Rd",-28,1946,"Regular",2,"Away","North Melbourne","Richmond",28
4410,1946-05-04,"R3","Hawthorn",15,11,101,"Carlton",19,17,131,"Glenferrie Oval",-30,1946,"Regular",3,"Away","Carlton","Hawthorn",30
4411,1946-05-04,"R3","North Melbourne",10,14,74,"Collingwood",12,12,84,"Arden St",-10,1946,"Regular",3,"Away","Collingwood","North Melbourne",10
4412,1946-05-04,"R3","Essendon",21,15,141,"Melbourne",12,13,85,"Windy Hill",56,1946,"Regular",3,"Home","Essendon","Melbourne",56
4413,1946-05-04,"R3","Fitzroy",20,19,139,"Geelong",9,9,63,"Brunswick St",76,1946,"Regular",3,"Home","Fitzroy","Geelong",76
4414,1946-05-04,"R3","Sydney",12,14,86,"Footscray",14,18,102,"Junction Oval",-16,1946,"Regular",3,"Away","Footscray","Sydney",16
4415,1946-05-04,"R3","Richmond",16,14,110,"St Kilda",6,15,51,"Punt Rd",59,1946,"Regular",3,"Home","Richmond","St Kilda",59
4416,1946-05-11,"R4","Carlton",6,16,52,"Fitzroy",16,18,114,"Princes Park",-62,1946,"Regular",4,"Away","Fitzroy","Carlton",62
4417,1946-05-11,"R4","St Kilda",13,7,85,"Collingwood",14,20,104,"Junction Oval",-19,1946,"Regular",4,"Away","Collingwood","St Kilda",19
4418,1946-05-11,"R4","Hawthorn",8,6,54,"Essendon",24,13,157,"Glenferrie Oval",-103,1946,"Regular",4,"Away","Essendon","Hawthorn",103
4419,1946-05-11,"R4","Footscray",19,19,133,"Richmond",17,10,112,"Western Oval",21,1946,"Regular",4,"Home","Footscray","Richmond",21
4420,1946-05-11,"R4","Geelong",11,18,84,"North Melbourne",19,12,126,"Kardinia Park",-42,1946,"Regular",4,"Away","North Melbourne","Geelong",42
4421,1946-05-11,"R4","Melbourne",12,15,87,"Sydney",11,8,74,"Punt Rd",13,1946,"Regular",4,"Home","Melbourne","Sydney",13
4422,1946-05-18,"R5","Carlton",11,15,81,"North Melbourne",9,11,65,"Princes Park",16,1946,"Regular",5,"Home","Carlton","North Melbourne",16
4423,1946-05-18,"R5","Collingwood",2,16,28,"Richmond",14,10,94,"Victoria Park",-66,1946,"Regular",5,"Away","Richmond","Collingwood",66
4424,1946-05-18,"R5","Essendon",11,13,79,"Fitzroy",4,15,39,"Windy Hill",40,1946,"Regular",5,"Home","Essendon","Fitzroy",40
4425,1946-05-18,"R5","Melbourne",12,13,85,"Footscray",22,14,146,"Punt Rd",-61,1946,"Regular",5,"Away","Footscray","Melbourne",61
4426,1946-05-18,"R5","Geelong",11,8,74,"St Kilda",13,17,95,"Kardinia Park",-21,1946,"Regular",5,"Away","St Kilda","Geelong",21
4427,1946-05-18,"R5","Sydney",11,21,87,"Hawthorn",6,17,53,"Junction Oval",34,1946,"Regular",5,"Home","Sydney","Hawthorn",34
4428,1946-05-25,"R6","St Kilda",10,12,72,"Carlton",22,17,149,"Junction Oval",-77,1946,"Regular",6,"Away","Carlton","St Kilda",77
4429,1946-05-25,"R6","Footscray",10,12,72,"Collingwood",9,15,69,"Western Oval",3,1946,"Regular",6,"Home","Footscray","Collingwood",3
4430,1946-05-25,"R6","North Melbourne",5,13,43,"Essendon",11,17,83,"Arden St",-40,1946,"Regular",6,"Away","Essendon","North Melbourne",40
4431,1946-05-25,"R6","Fitzroy",7,21,63,"Sydney",10,12,72,"Brunswick St",-9,1946,"Regular",6,"Away","Sydney","Fitzroy",9
4432,1946-05-25,"R6","Richmond",21,23,149,"Geelong",13,9,87,"Punt Rd",62,1946,"Regular",6,"Home","Richmond","Geelong",62
4433,1946-05-25,"R6","Hawthorn",16,10,106,"Melbourne",13,13,91,"Glenferrie Oval",15,1946,"Regular",6,"Home","Hawthorn","Melbourne",15
4434,1946-06-01,"R7","Carlton",15,13,103,"Richmond",11,10,76,"Princes Park",27,1946,"Regular",7,"Home","Carlton","Richmond",27
4435,1946-06-01,"R7","Geelong",10,8,68,"Collingwood",20,12,132,"Kardinia Park",-64,1946,"Regular",7,"Away","Collingwood","Geelong",64
4436,1946-06-01,"R7","Essendon",20,20,140,"St Kilda",7,16,58,"Windy Hill",82,1946,"Regular",7,"Home","Essendon","St Kilda",82
4437,1946-06-01,"R7","Melbourne",5,11,41,"Fitzroy",14,13,97,"Punt Rd",-56,1946,"Regular",7,"Away","Fitzroy","Melbourne",56
4438,1946-06-01,"R7","Hawthorn",13,12,90,"Footscray",14,15,99,"Glenferrie Oval",-9,1946,"Regular",7,"Away","Footscray","Hawthorn",9
4439,1946-06-01,"R7","Sydney",10,16,76,"North Melbourne",10,10,70,"Junction Oval",6,1946,"Regular",7,"Home","Sydney","North Melbourne",6
4440,1946-06-08,"R8","Richmond",10,10,70,"Essendon",15,17,107,"Punt Rd",-37,1946,"Regular",8,"Away","Essendon","Richmond",37
4441,1946-06-08,"R8","Fitzroy",14,14,98,"Hawthorn",9,10,64,"Brunswick St",34,1946,"Regular",8,"Home","Fitzroy","Hawthorn",34
4442,1946-06-08,"R8","North Melbourne",9,2,56,"Melbourne",3,9,27,"Arden St",29,1946,"Regular",8,"Home","North Melbourne","Melbourne",29
4443,1946-06-10,"R8","Collingwood",16,16,112,"Carlton",7,14,56,"Victoria Park",56,1946,"Regular",8,"Home","Collingwood","Carlton",56
4444,1946-06-10,"R8","Footscray",16,22,118,"Geelong",7,13,55,"Western Oval",63,1946,"Regular",8,"Home","Footscray","Geelong",63
4445,1946-06-10,"R8","St Kilda",7,5,47,"Sydney",15,22,112,"Junction Oval",-65,1946,"Regular",8,"Away","Sydney","St Kilda",65
4446,1946-06-15,"R9","Essendon",16,22,118,"Collingwood",11,10,76,"Windy Hill",42,1946,"Regular",9,"Home","Essendon","Collingwood",42
4447,1946-06-15,"R9","Footscray",16,10,106,"Fitzroy",15,9,99,"Western Oval",7,1946,"Regular",9,"Home","Footscray","Fitzroy",7
4448,1946-06-15,"R9","Melbourne",14,12,96,"St Kilda",8,9,57,"Punt Rd",39,1946,"Regular",9,"Home","Melbourne","St Kilda",39
4449,1946-06-17,"R9","Carlton",18,20,128,"Geelong",13,11,89,"Princes Park",39,1946,"Regular",9,"Home","Carlton","Geelong",39
4450,1946-06-17,"R9","Hawthorn",17,20,122,"North Melbourne",14,13,97,"Glenferrie Oval",25,1946,"Regular",9,"Home","Hawthorn","North Melbourne",25
4451,1946-06-17,"R9","Sydney",18,16,124,"Richmond",15,20,110,"Junction Oval",14,1946,"Regular",9,"Home","Sydney","Richmond",14
4452,1946-06-22,"R10","Carlton",12,20,92,"Footscray",13,10,88,"Princes Park",4,1946,"Regular",10,"Home","Carlton","Footscray",4
4453,1946-06-22,"R10","Collingwood",18,17,125,"Sydney",12,12,84,"Victoria Park",41,1946,"Regular",10,"Home","Collingwood","Sydney",41
4454,1946-06-22,"R10","Geelong",18,18,126,"Essendon",12,15,87,"Kardinia Park",39,1946,"Regular",10,"Home","Geelong","Essendon",39
4455,1946-06-22,"R10","North Melbourne",15,8,98,"Fitzroy",13,10,88,"Arden St",10,1946,"Regular",10,"Home","North Melbourne","Fitzroy",10
4456,1946-06-22,"R10","St Kilda",10,24,84,"Hawthorn",9,12,66,"Junction Oval",18,1946,"Regular",10,"Home","St Kilda","Hawthorn",18
4457,1946-06-22,"R10","Richmond",9,16,70,"Melbourne",13,8,86,"Punt Rd",-16,1946,"Regular",10,"Away","Melbourne","Richmond",16
4458,1946-07-06,"R11","Essendon",12,12,84,"Carlton",9,9,63,"Windy Hill",21,1946,"Regular",11,"Home","Essendon","Carlton",21
4459,1946-07-06,"R11","Melbourne",13,13,91,"Collingwood",10,9,69,"Punt Rd",22,1946,"Regular",11,"Home","Melbourne","Collingwood",22
4460,1946-07-06,"R11","Fitzroy",12,14,86,"St Kilda",7,11,53,"Brunswick St",33,1946,"Regular",11,"Home","Fitzroy","St Kilda",33
4461,1946-07-06,"R11","Footscray",18,9,117,"North Melbourne",9,12,66,"Western Oval",51,1946,"Regular",11,"Home","Footscray","North Melbourne",51
4462,1946-07-06,"R11","Sydney",12,19,91,"Geelong",7,12,54,"Junction Oval",37,1946,"Regular",11,"Home","Sydney","Geelong",37
4463,1946-07-06,"R11","Hawthorn",9,6,60,"Richmond",14,14,98,"Glenferrie Oval",-38,1946,"Regular",11,"Away","Richmond","Hawthorn",38
4464,1946-07-13,"R12","Carlton",12,13,85,"Sydney",11,18,84,"Princes Park",1,1946,"Regular",12,"Home","Carlton","Sydney",1
4465,1946-07-13,"R12","Collingwood",15,23,113,"Hawthorn",11,14,80,"Victoria Park",33,1946,"Regular",12,"Home","Collingwood","Hawthorn",33
4466,1946-07-13,"R12","Essendon",16,24,120,"Footscray",14,8,92,"Windy Hill",28,1946,"Regular",12,"Home","Essendon","Footscray",28
4467,1946-07-13,"R12","Richmond",14,14,98,"Fitzroy",10,12,72,"Punt Rd",26,1946,"Regular",12,"Home","Richmond","Fitzroy",26
4468,1946-07-13,"R12","Geelong",15,7,97,"Melbourne",21,14,140,"Kardinia Park",-43,1946,"Regular",12,"Away","Melbourne","Geelong",43
4469,1946-07-13,"R12","St Kilda",10,14,74,"North Melbourne",12,11,83,"Junction Oval",-9,1946,"Regular",12,"Away","North Melbourne","St Kilda",9
4470,1946-07-20,"R13","Melbourne",10,12,72,"Carlton",7,13,55,"Punt Rd",17,1946,"Regular",13,"Home","Melbourne","Carlton",17
4471,1946-07-20,"R13","Fitzroy",8,8,56,"Collingwood",8,13,61,"Brunswick St",-5,1946,"Regular",13,"Away","Collingwood","Fitzroy",5
4472,1946-07-20,"R13","Sydney",9,13,67,"Essendon",10,8,68,"Junction Oval",-1,1946,"Regular",13,"Away","Essendon","Sydney",1
4473,1946-07-20,"R13","Footscray",5,11,41,"St Kilda",6,10,46,"Western Oval",-5,1946,"Regular",13,"Away","St Kilda","Footscray",5
4474,1946-07-20,"R13","Hawthorn",15,22,112,"Geelong",11,15,81,"Glenferrie Oval",31,1946,"Regular",13,"Home","Hawthorn","Geelong",31
4475,1946-07-20,"R13","North Melbourne",6,11,47,"Richmond",11,9,75,"Arden St",-28,1946,"Regular",13,"Away","Richmond","North Melbourne",28
4476,1946-07-27,"R14","Carlton",15,18,108,"Hawthorn",10,11,71,"Princes Park",37,1946,"Regular",14,"Home","Carlton","Hawthorn",37
4477,1946-07-27,"R14","Collingwood",17,19,121,"North Melbourne",9,16,70,"Victoria Park",51,1946,"Regular",14,"Home","Collingwood","North Melbourne",51
4478,1946-07-27,"R14","Melbourne",9,24,78,"Essendon",10,13,73,"Punt Rd",5,1946,"Regular",14,"Home","Melbourne","Essendon",5
4479,1946-07-27,"R14","Geelong",9,9,63,"Fitzroy",8,7,55,"Kardinia Park",8,1946,"Regular",14,"Home","Geelong","Fitzroy",8
4480,1946-07-27,"R14","Footscray",12,12,84,"Sydney",4,7,31,"Western Oval",53,1946,"Regular",14,"Home","Footscray","Sydney",53
4481,1946-07-27,"R14","St Kilda",9,9,63,"Richmond",16,16,112,"Junction Oval",-49,1946,"Regular",14,"Away","Richmond","St Kilda",49
4482,1946-08-03,"R15","Fitzroy",14,10,94,"Carlton",11,8,74,"Brunswick St",20,1946,"Regular",15,"Home","Fitzroy","Carlton",20
4483,1946-08-03,"R15","Collingwood",15,24,114,"St Kilda",10,9,69,"Victoria Park",45,1946,"Regular",15,"Home","Collingwood","St Kilda",45
4484,1946-08-03,"R15","Essendon",21,18,144,"Hawthorn",12,7,79,"Windy Hill",65,1946,"Regular",15,"Home","Essendon","Hawthorn",65
4485,1946-08-03,"R15","Richmond",12,21,93,"Footscray",14,15,99,"Punt Rd",-6,1946,"Regular",15,"Away","Footscray","Richmond",6
4486,1946-08-03,"R15","North Melbourne",15,10,100,"Geelong",6,12,48,"Arden St",52,1946,"Regular",15,"Home","North Melbourne","Geelong",52
4487,1946-08-03,"R15","Sydney",15,16,106,"Melbourne",14,11,95,"Junction Oval",11,1946,"Regular",15,"Home","Sydney","Melbourne",11
4488,1946-08-10,"R16","North Melbourne",13,9,87,"Carlton",10,18,78,"Arden St",9,1946,"Regular",16,"Home","North Melbourne","Carlton",9
4489,1946-08-10,"R16","Richmond",18,9,117,"Collingwood",12,15,87,"Punt Rd",30,1946,"Regular",16,"Home","Richmond","Collingwood",30
4490,1946-08-10,"R16","Fitzroy",14,18,102,"Essendon",7,16,58,"Brunswick St",44,1946,"Regular",16,"Home","Fitzroy","Essendon",44
4491,1946-08-10,"R16","Footscray",13,13,91,"Melbourne",16,16,112,"Western Oval",-21,1946,"Regular",16,"Away","Melbourne","Footscray",21
4492,1946-08-10,"R16","St Kilda",20,10,130,"Geelong",8,11,59,"Junction Oval",71,1946,"Regular",16,"Home","St Kilda","Geelong",71
4493,1946-08-10,"R16","Hawthorn",12,15,87,"Sydney",16,14,110,"Glenferrie Oval",-23,1946,"Regular",16,"Away","Sydney","Hawthorn",23
4494,1946-08-17,"R17","Carlton",14,8,92,"St Kilda",10,17,77,"Princes Park",15,1946,"Regular",17,"Home","Carlton","St Kilda",15
4495,1946-08-17,"R17","Collingwood",20,12,132,"Footscray",10,10,70,"Victoria Park",62,1946,"Regular",17,"Home","Collingwood","Footscray",62
4496,1946-08-17,"R17","Essendon",18,14,122,"North Melbourne",4,10,34,"Windy Hill",88,1946,"Regular",17,"Home","Essendon","North Melbourne",88
4497,1946-08-17,"R17","Sydney",7,16,58,"Fitzroy",12,15,87,"Junction Oval",-29,1946,"Regular",17,"Away","Fitzroy","Sydney",29
4498,1946-08-17,"R17","Geelong",13,11,89,"Richmond",16,11,107,"Kardinia Park",-18,1946,"Regular",17,"Away","Richmond","Geelong",18
4499,1946-08-17,"R17","Melbourne",18,15,123,"Hawthorn",13,8,86,"M.C.G.",37,1946,"Regular",17,"Home","Melbourne","Hawthorn",37
4500,1946-08-24,"R18","Richmond",16,29,125,"Carlton",13,15,93,"Punt Rd",32,1946,"Regular",18,"Home","Richmond","Carlton",32
4501,1946-08-24,"R18","Collingwood",17,26,128,"Geelong",7,11,53,"Victoria Park",75,1946,"Regular",18,"Home","Collingwood","Geelong",75
4502,1946-08-24,"R18","St Kilda",11,9,75,"Essendon",16,20,116,"Junction Oval",-41,1946,"Regular",18,"Away","Essendon","St Kilda",41
4503,1946-08-24,"R18","Fitzroy",9,11,65,"Melbourne",10,9,69,"Brunswick St",-4,1946,"Regular",18,"Away","Melbourne","Fitzroy",4
4504,1946-08-24,"R18","Footscray",23,27,165,"Hawthorn",8,5,53,"Western Oval",112,1946,"Regular",18,"Home","Footscray","Hawthorn",112
4505,1946-08-24,"R18","North Melbourne",11,8,74,"Sydney",15,19,109,"Arden St",-35,1946,"Regular",18,"Away","Sydney","North Melbourne",35
4506,1946-08-31,"R19","Carlton",15,11,101,"Collingwood",14,12,96,"Princes Park",5,1946,"Regular",19,"Home","Carlton","Collingwood",5
4507,1946-08-31,"R19","Essendon",16,18,114,"Richmond",18,5,113,"Windy Hill",1,1946,"Regular",19,"Home","Essendon","Richmond",1
4508,1946-08-31,"R19","Hawthorn",9,15,69,"Fitzroy",12,22,94,"Glenferrie Oval",-25,1946,"Regular",19,"Away","Fitzroy","Hawthorn",25
4509,1946-08-31,"R19","Geelong",17,18,120,"Footscray",12,5,77,"Kardinia Park",43,1946,"Regular",19,"Home","Geelong","Footscray",43
4510,1946-08-31,"R19","Melbourne",17,11,113,"North Melbourne",11,10,76,"M.C.G.",37,1946,"Regular",19,"Home","Melbourne","North Melbourne",37
4511,1946-08-31,"R19","Sydney",14,10,94,"St Kilda",6,13,49,"Junction Oval",45,1946,"Regular",19,"Home","Sydney","St Kilda",45
4512,1946-09-07,"SF","Footscray",15,12,102,"Melbourne",17,18,120,"M.C.G.",-18,1946,"Finals",20,"Away","Melbourne","Footscray",18
4513,1946-09-14,"SF","Essendon",14,16,100,"Collingwood",13,22,100,"M.C.G.",0,1946,"Finals",20,"Home","Essendon","Collingwood",0
4514,1946-09-21,"SF","Essendon",10,16,76,"Collingwood",8,9,57,"M.C.G.",19,1946,"Finals",20,"Home","Essendon","Collingwood",19
4515,1946-09-28,"PF","Collingwood",14,16,100,"Melbourne",16,17,113,"M.C.G.",-13,1946,"Finals",21,"Away","Melbourne","Collingwood",13
4516,1946-10-05,"GF","Essendon",22,18,150,"Melbourne",13,9,87,"M.C.G.",63,1946,"Finals",22,"Home","Essendon","Melbourne",63
4517,1947-04-19,"R1","Carlton",17,20,122,"Melbourne",16,13,109,"Princes Park",13,1947,"Regular",1,"Home","Carlton","Melbourne",13
4518,1947-04-19,"R1","Collingwood",20,18,138,"Fitzroy",14,8,92,"Victoria Park",46,1947,"Regular",1,"Home","Collingwood","Fitzroy",46
4519,1947-04-19,"R1","Essendon",16,23,119,"Sydney",10,8,68,"Windy Hill",51,1947,"Regular",1,"Home","Essendon","Sydney",51
4520,1947-04-19,"R1","St Kilda",12,16,88,"Footscray",22,17,149,"Junction Oval",-61,1947,"Regular",1,"Away","Footscray","St Kilda",61
4521,1947-04-19,"R1","Geelong",19,15,129,"Hawthorn",12,12,84,"Kardinia Park",45,1947,"Regular",1,"Home","Geelong","Hawthorn",45
4522,1947-04-19,"R1","Richmond",18,27,135,"North Melbourne",15,14,104,"Punt Rd",31,1947,"Regular",1,"Home","Richmond","North Melbourne",31
4523,1947-04-26,"R2","Sydney",12,12,84,"Carlton",9,16,70,"Lake Oval",14,1947,"Regular",2,"Home","Sydney","Carlton",14
4524,1947-04-26,"R2","Hawthorn",13,9,87,"Collingwood",19,20,134,"Glenferrie Oval",-47,1947,"Regular",2,"Away","Collingwood","Hawthorn",47
4525,1947-04-26,"R2","Footscray",15,13,103,"Essendon",13,11,89,"Western Oval",14,1947,"Regular",2,"Home","Footscray","Essendon",14
4526,1947-04-26,"R2","Fitzroy",13,22,100,"Richmond",11,11,77,"Brunswick St",23,1947,"Regular",2,"Home","Fitzroy","Richmond",23
4527,1947-04-26,"R2","Melbourne",14,25,109,"Geelong",11,7,73,"M.C.G.",36,1947,"Regular",2,"Home","Melbourne","Geelong",36
4528,1947-04-26,"R2","North Melbourne",8,11,59,"St Kilda",8,13,61,"Arden St",-2,1947,"Regular",2,"Away","St Kilda","North Melbourne",2
4529,1947-05-03,"R3","Richmond",5,18,48,"Carlton",17,19,121,"Punt Rd",-73,1947,"Regular",3,"Away","Carlton","Richmond",73
4530,1947-05-03,"R3","Geelong",12,17,89,"Collingwood",14,24,108,"Kardinia Park",-19,1947,"Regular",3,"Away","Collingwood","Geelong",19
4531,1947-05-03,"R3","Essendon",21,10,136,"St Kilda",19,11,125,"Windy Hill",11,1947,"Regular",3,"Home","Essendon","St Kilda",11
4532,1947-05-03,"R3","Fitzroy",12,20,92,"Melbourne",12,11,83,"Brunswick St",9,1947,"Regular",3,"Home","Fitzroy","Melbourne",9
4533,1947-05-03,"R3","Hawthorn",12,10,82,"Footscray",20,14,134,"Glenferrie Oval",-52,1947,"Regular",3,"Away","Footscray","Hawthorn",52
4534,1947-05-03,"R3","Sydney",10,18,78,"North Melbourne",12,10,82,"Lake Oval",-4,1947,"Regular",3,"Away","North Melbourne","Sydney",4
4535,1947-05-10,"R4","Carlton",16,16,112,"Footscray",7,16,58,"Princes Park",54,1947,"Regular",4,"Home","Carlton","Footscray",54
4536,1947-05-10,"R4","Collingwood",19,24,138,"Sydney",12,14,86,"Victoria Park",52,1947,"Regular",4,"Home","Collingwood","Sydney",52
4537,1947-05-10,"R4","Geelong",11,17,83,"Essendon",16,19,115,"Kardinia Park",-32,1947,"Regular",4,"Away","Essendon","Geelong",32
4538,1947-05-10,"R4","North Melbourne",4,15,39,"Fitzroy",19,26,140,"Arden St",-101,1947,"Regular",4,"Away","Fitzroy","North Melbourne",101
4539,1947-05-10,"R4","St Kilda",10,17,77,"Hawthorn",12,12,84,"Junction Oval",-7,1947,"Regular",4,"Away","Hawthorn","St Kilda",7
4540,1947-05-10,"R4","Richmond",10,12,72,"Melbourne",18,12,120,"Punt Rd",-48,1947,"Regular",4,"Away","Melbourne","Richmond",48
4541,1947-05-17,"R5","Essendon",8,16,64,"Carlton",14,7,91,"Windy Hill",-27,1947,"Regular",5,"Away","Carlton","Essendon",27
4542,1947-05-17,"R5","Melbourne",15,5,95,"Collingwood",9,16,70,"M.C.G.",25,1947,"Regular",5,"Home","Melbourne","Collingwood",25
4543,1947-05-17,"R5","Fitzroy",19,18,132,"St Kilda",7,14,56,"Brunswick St",76,1947,"Regular",5,"Home","Fitzroy","St Kilda",76
4544,1947-05-17,"R5","Footscray",17,18,120,"North Melbourne",11,13,79,"Western Oval",41,1947,"Regular",5,"Home","Footscray","North Melbourne",41
4545,1947-05-17,"R5","Sydney",13,9,87,"Geelong",15,16,106,"Lake Oval",-19,1947,"Regular",5,"Away","Geelong","Sydney",19
4546,1947-05-17,"R5","Hawthorn",16,11,107,"Richmond",10,9,69,"Glenferrie Oval",38,1947,"Regular",5,"Home","Hawthorn","Richmond",38
4547,1947-05-24,"R6","St Kilda",7,11,53,"Carlton",23,17,155,"Junction Oval",-102,1947,"Regular",6,"Away","Carlton","St Kilda",102
4548,1947-05-24,"R6","Footscray",13,12,90,"Collingwood",10,16,76,"Western Oval",14,1947,"Regular",6,"Home","Footscray","Collingwood",14
4549,1947-05-24,"R6","North Melbourne",15,12,102,"Essendon",14,10,94,"Arden St",8,1947,"Regular",6,"Home","North Melbourne","Essendon",8
4550,1947-05-24,"R6","Fitzroy",8,15,63,"Sydney",15,11,101,"Brunswick St",-38,1947,"Regular",6,"Away","Sydney","Fitzroy",38
4551,1947-05-24,"R6","Richmond",18,18,126,"Geelong",11,11,77,"Punt Rd",49,1947,"Regular",6,"Home","Richmond","Geelong",49
4552,1947-05-24,"R6","Hawthorn",9,12,66,"Melbourne",12,9,81,"Glenferrie Oval",-15,1947,"Regular",6,"Away","Melbourne","Hawthorn",15
4553,1947-05-31,"R7","Carlton",13,21,99,"North Melbourne",11,14,80,"Princes Park",19,1947,"Regular",7,"Home","Carlton","North Melbourne",19
4554,1947-05-31,"R7","Collingwood",10,13,73,"Richmond",10,14,74,"Victoria Park",-1,1947,"Regular",7,"Away","Richmond","Collingwood",1
4555,1947-05-31,"R7","Essendon",11,17,83,"Fitzroy",10,14,74,"Windy Hill",9,1947,"Regular",7,"Home","Essendon","Fitzroy",9
4556,1947-05-31,"R7","Melbourne",17,3,105,"Footscray",15,8,98,"M.C.G.",7,1947,"Regular",7,"Home","Melbourne","Footscray",7
4557,1947-05-31,"R7","Geelong",7,12,54,"St Kilda",6,13,49,"Kardinia Park",5,1947,"Regular",7,"Home","Geelong","St Kilda",5
4558,1947-05-31,"R7","Sydney",15,14,104,"Hawthorn",12,20,92,"Lake Oval",12,1947,"Regular",7,"Home","Sydney","Hawthorn",12
4559,1947-06-07,"R8","Carlton",16,21,117,"Geelong",7,10,52,"Princes Park",65,1947,"Regular",8,"Home","Carlton","Geelong",65
4560,1947-06-07,"R8","Essendon",9,14,68,"Collingwood",11,16,82,"Windy Hill",-14,1947,"Regular",8,"Away","Collingwood","Essendon",14
4561,1947-06-07,"R8","Footscray",12,11,83,"Fitzroy",7,7,49,"Western Oval",34,1947,"Regular",8,"Home","Footscray","Fitzroy",34
4562,1947-06-07,"R8","Hawthorn",10,15,75,"North Melbourne",10,11,71,"Glenferrie Oval",4,1947,"Regular",8,"Home","Hawthorn","North Melbourne",4
4563,1947-06-07,"R8","Melbourne",15,15,105,"St Kilda",5,13,43,"M.C.G.",62,1947,"Regular",8,"Home","Melbourne","St Kilda",62
4564,1947-06-07,"R8","Sydney",15,9,99,"Richmond",15,13,103,"Lake Oval",-4,1947,"Regular",8,"Away","Richmond","Sydney",4
4565,1947-06-14,"R9","Richmond",7,14,56,"Essendon",18,17,125,"Punt Rd",-69,1947,"Regular",9,"Away","Essendon","Richmond",69
4566,1947-06-14,"R9","Fitzroy",16,15,111,"Hawthorn",8,14,62,"Brunswick St",49,1947,"Regular",9,"Home","Fitzroy","Hawthorn",49
4567,1947-06-14,"R9","Geelong",16,7,103,"Footscray",11,20,86,"Kardinia Park",17,1947,"Regular",9,"Home","Geelong","Footscray",17
4568,1947-06-14,"R9","North Melbourne",9,6,60,"Melbourne",11,15,81,"Arden St",-21,1947,"Regular",9,"Away","Melbourne","North Melbourne",21
4569,1947-06-16,"R9","Collingwood",16,16,112,"Carlton",13,8,86,"Victoria Park",26,1947,"Regular",9,"Home","Collingwood","Carlton",26
4570,1947-06-16,"R9","St Kilda",11,9,75,"Sydney",18,13,121,"Junction Oval",-46,1947,"Regular",9,"Away","Sydney","St Kilda",46
4571,1947-06-21,"R10","Fitzroy",8,7,55,"Carlton",10,8,68,"Brunswick St",-13,1947,"Regular",10,"Away","Carlton","Fitzroy",13
4572,1947-06-21,"R10","St Kilda",9,13,67,"Collingwood",15,20,110,"Junction Oval",-43,1947,"Regular",10,"Away","Collingwood","St Kilda",43
4573,1947-06-21,"R10","Hawthorn",6,9,45,"Essendon",18,20,128,"Glenferrie Oval",-83,1947,"Regular",10,"Away","Essendon","Hawthorn",83
4574,1947-06-21,"R10","Footscray",4,17,41,"Richmond",10,12,72,"Western Oval",-31,1947,"Regular",10,"Away","Richmond","Footscray",31
4575,1947-06-21,"R10","North Melbourne",13,8,86,"Geelong",18,11,119,"Arden St",-33,1947,"Regular",10,"Away","Geelong","North Melbourne",33
4576,1947-06-21,"R10","Melbourne",8,11,59,"Sydney",9,15,69,"M.C.G.",-10,1947,"Regular",10,"Away","Sydney","Melbourne",10
4577,1947-06-28,"R11","Carlton",18,17,125,"Hawthorn",8,14,62,"Princes Park",63,1947,"Regular",11,"Home","Carlton","Hawthorn",63
4578,1947-06-28,"R11","Collingwood",14,19,103,"North Melbourne",9,15,69,"Victoria Park",34,1947,"Regular",11,"Home","Collingwood","North Melbourne",34
4579,1947-06-28,"R11","Essendon",12,13,85,"Melbourne",10,15,75,"Windy Hill",10,1947,"Regular",11,"Home","Essendon","Melbourne",10
4580,1947-06-28,"R11","Geelong",10,10,70,"Fitzroy",11,15,81,"Kardinia Park",-11,1947,"Regular",11,"Away","Fitzroy","Geelong",11
4581,1947-06-28,"R11","Sydney",15,9,99,"Footscray",12,10,82,"Lake Oval",17,1947,"Regular",11,"Home","Sydney","Footscray",17
4582,1947-06-28,"R11","Richmond",23,15,153,"St Kilda",7,10,52,"Punt Rd",101,1947,"Regular",11,"Home","Richmond","St Kilda",101
4583,1947-07-05,"R12","Melbourne",9,10,64,"Carlton",10,9,69,"M.C.G.",-5,1947,"Regular",12,"Away","Carlton","Melbourne",5
4584,1947-07-05,"R12","Fitzroy",9,11,65,"Collingwood",7,6,48,"Brunswick St",17,1947,"Regular",12,"Home","Fitzroy","Collingwood",17
4585,1947-07-05,"R12","Sydney",8,14,62,"Essendon",11,17,83,"Lake Oval",-21,1947,"Regular",12,"Away","Essendon","Sydney",21
4586,1947-07-05,"R12","Footscray",5,14,44,"St Kilda",6,8,44,"Western Oval",0,1947,"Regular",12,"Home","Footscray","St Kilda",0
4587,1947-07-05,"R12","Hawthorn",12,11,83,"Geelong",16,21,117,"Glenferrie Oval",-34,1947,"Regular",12,"Away","Geelong","Hawthorn",34
4588,1947-07-05,"R12","North Melbourne",4,10,34,"Richmond",12,11,83,"Arden St",-49,1947,"Regular",12,"Away","Richmond","North Melbourne",49
4589,1947-07-12,"R13","Carlton",10,14,74,"Sydney",9,16,70,"Princes Park",4,1947,"Regular",13,"Home","Carlton","Sydney",4
4590,1947-07-12,"R13","Collingwood",8,17,65,"Hawthorn",6,9,45,"Victoria Park",20,1947,"Regular",13,"Home","Collingwood","Hawthorn",20
4591,1947-07-12,"R13","Essendon",10,18,78,"Footscray",8,11,59,"Windy Hill",19,1947,"Regular",13,"Home","Essendon","Footscray",19
4592,1947-07-12,"R13","Richmond",12,12,84,"Fitzroy",11,12,78,"Punt Rd",6,1947,"Regular",13,"Home","Richmond","Fitzroy",6
4593,1947-07-12,"R13","Geelong",16,11,107,"Melbourne",5,16,46,"Kardinia Park",61,1947,"Regular",13,"Home","Geelong","Melbourne",61
4594,1947-07-12,"R13","St Kilda",8,15,63,"North Melbourne",13,25,103,"Junction Oval",-40,1947,"Regular",13,"Away","North Melbourne","St Kilda",40
4595,1947-07-19,"R14","Carlton",10,10,70,"Richmond",9,9,63,"Princes Park",7,1947,"Regular",14,"Home","Carlton","Richmond",7
4596,1947-07-19,"R14","Collingwood",12,11,83,"Geelong",11,11,77,"Victoria Park",6,1947,"Regular",14,"Home","Collingwood","Geelong",6
4597,1947-07-19,"R14","St Kilda",7,13,55,"Essendon",14,18,102,"Junction Oval",-47,1947,"Regular",14,"Away","Essendon","St Kilda",47
4598,1947-07-19,"R14","Melbourne",7,10,52,"Fitzroy",11,8,74,"M.C.G.",-22,1947,"Regular",14,"Away","Fitzroy","Melbourne",22
4599,1947-07-19,"R14","Footscray",13,18,96,"Hawthorn",10,7,67,"Western Oval",29,1947,"Regular",14,"Home","Footscray","Hawthorn",29
4600,1947-07-19,"R14","North Melbourne",8,14,62,"Sydney",8,18,66,"Arden St",-4,1947,"Regular",14,"Away","Sydney","North Melbourne",4
4601,1947-07-26,"R15","Footscray",13,11,89,"Carlton",14,9,93,"Western Oval",-4,1947,"Regular",15,"Away","Carlton","Footscray",4
4602,1947-07-26,"R15","Sydney",9,15,69,"Collingwood",9,15,69,"Lake Oval",0,1947,"Regular",15,"Home","Sydney","Collingwood",0
4603,1947-07-26,"R15","Essendon",16,21,117,"Geelong",12,5,77,"Windy Hill",40,1947,"Regular",15,"Home","Essendon","Geelong",40
4604,1947-07-26,"R15","Fitzroy",16,7,103,"North Melbourne",7,14,56,"Brunswick St",47,1947,"Regular",15,"Home","Fitzroy","North Melbourne",47
4605,1947-07-26,"R15","Hawthorn",16,18,114,"St Kilda",10,9,69,"Glenferrie Oval",45,1947,"Regular",15,"Home","Hawthorn","St Kilda",45
4606,1947-07-26,"R15","Melbourne",10,12,72,"Richmond",11,15,81,"M.C.G.",-9,1947,"Regular",15,"Away","Richmond","Melbourne",9
4607,1947-08-02,"R16","Carlton",7,12,54,"Essendon",13,16,94,"Princes Park",-40,1947,"Regular",16,"Away","Essendon","Carlton",40
4608,1947-08-02,"R16","St Kilda",9,9,63,"Fitzroy",10,17,77,"Junction Oval",-14,1947,"Regular",16,"Away","Fitzroy","St Kilda",14
4609,1947-08-02,"R16","Richmond",13,18,96,"Hawthorn",8,7,55,"Punt Rd",41,1947,"Regular",16,"Home","Richmond","Hawthorn",41
4610,1947-08-09,"R16","Collingwood",7,14,56,"Melbourne",7,19,61,"Victoria Park",-5,1947,"Regular",16,"Away","Melbourne","Collingwood",5
4611,1947-08-09,"R16","North Melbourne",10,12,72,"Footscray",11,10,76,"Arden St",-4,1947,"Regular",16,"Away","Footscray","North Melbourne",4
4612,1947-08-09,"R16","Geelong",13,19,97,"Sydney",7,19,61,"Kardinia Park",36,1947,"Regular",16,"Home","Geelong","Sydney",36
4613,1947-08-16,"R17","Carlton",14,19,103,"St Kilda",3,12,30,"Princes Park",73,1947,"Regular",17,"Home","Carlton","St Kilda",73
4614,1947-08-16,"R17","Collingwood",17,10,112,"Footscray",12,12,84,"Victoria Park",28,1947,"Regular",17,"Home","Collingwood","Footscray",28
4615,1947-08-16,"R17","Essendon",19,12,126,"North Melbourne",12,14,86,"Windy Hill",40,1947,"Regular",17,"Home","Essendon","North Melbourne",40
4616,1947-08-16,"R17","Sydney",10,11,71,"Fitzroy",12,10,82,"Lake Oval",-11,1947,"Regular",17,"Away","Fitzroy","Sydney",11
4617,1947-08-16,"R17","Geelong",16,19,115,"Richmond",13,9,87,"Kardinia Park",28,1947,"Regular",17,"Home","Geelong","Richmond",28
4618,1947-08-16,"R17","Melbourne",13,21,99,"Hawthorn",14,9,93,"M.C.G.",6,1947,"Regular",17,"Home","Melbourne","Hawthorn",6
4619,1947-08-23,"R18","North Melbourne",10,12,72,"Carlton",14,13,97,"Arden St",-25,1947,"Regular",18,"Away","Carlton","North Melbourne",25
4620,1947-08-23,"R18","Richmond",20,14,134,"Collingwood",8,12,60,"Punt Rd",74,1947,"Regular",18,"Home","Richmond","Collingwood",74
4621,1947-08-23,"R18","Fitzroy",18,22,130,"Essendon",8,14,62,"Brunswick St",68,1947,"Regular",18,"Home","Fitzroy","Essendon",68
4622,1947-08-23,"R18","Footscray",11,14,80,"Melbourne",24,11,155,"Western Oval",-75,1947,"Regular",18,"Away","Melbourne","Footscray",75
4623,1947-08-23,"R18","St Kilda",10,13,73,"Geelong",15,17,107,"Junction Oval",-34,1947,"Regular",18,"Away","Geelong","St Kilda",34
4624,1947-08-23,"R18","Hawthorn",12,11,83,"Sydney",19,14,128,"Glenferrie Oval",-45,1947,"Regular",18,"Away","Sydney","Hawthorn",45
4625,1947-08-30,"R19","Geelong",17,7,109,"Carlton",16,11,107,"Kardinia Park",2,1947,"Regular",19,"Home","Geelong","Carlton",2
4626,1947-08-30,"R19","Collingwood",14,17,101,"Essendon",16,12,108,"Victoria Park",-7,1947,"Regular",19,"Away","Essendon","Collingwood",7
4627,1947-08-30,"R19","Fitzroy",20,18,138,"Footscray",10,14,74,"Brunswick St",64,1947,"Regular",19,"Home","Fitzroy","Footscray",64
4628,1947-08-30,"R19","North Melbourne",10,14,74,"Hawthorn",10,10,70,"Arden St",4,1947,"Regular",19,"Home","North Melbourne","Hawthorn",4
4629,1947-08-30,"R19","St Kilda",10,18,78,"Melbourne",27,9,171,"Junction Oval",-93,1947,"Regular",19,"Away","Melbourne","St Kilda",93
4630,1947-08-30,"R19","Richmond",16,17,113,"Sydney",11,13,79,"Punt Rd",34,1947,"Regular",19,"Home","Richmond","Sydney",34
4631,1947-09-06,"SF","Fitzroy",16,7,103,"Richmond",11,9,75,"M.C.G.",28,1947,"Finals",20,"Home","Fitzroy","Richmond",28
4632,1947-09-13,"SF","Carlton",14,15,99,"Essendon",11,17,83,"M.C.G.",16,1947,"Finals",20,"Home","Carlton","Essendon",16
4633,1947-09-20,"PF","Essendon",16,13,109,"Fitzroy",14,12,96,"M.C.G.",13,1947,"Finals",21,"Home","Essendon","Fitzroy",13
4634,1947-09-27,"GF","Carlton",13,8,86,"Essendon",11,19,85,"M.C.G.",1,1947,"Finals",22,"Home","Carlton","Essendon",1
4635,1948-04-17,"R1","Hawthorn",11,10,76,"Carlton",17,15,117,"Glenferrie Oval",-41,1948,"Regular",1,"Away","Carlton","Hawthorn",41
4636,1948-04-17,"R1","North Melbourne",9,12,66,"Collingwood",11,20,86,"Arden St",-20,1948,"Regular",1,"Away","Collingwood","North Melbourne",20
4637,1948-04-17,"R1","Melbourne",12,5,77,"Essendon",13,18,96,"M.C.G.",-19,1948,"Regular",1,"Away","Essendon","Melbourne",19
4638,1948-04-17,"R1","Fitzroy",13,14,92,"Geelong",9,16,70,"Brunswick St",22,1948,"Regular",1,"Home","Fitzroy","Geelong",22
4639,1948-04-17,"R1","Footscray",21,19,145,"St Kilda",9,11,65,"Western Oval",80,1948,"Regular",1,"Home","Footscray","St Kilda",80
4640,1948-04-17,"R1","Sydney",18,15,123,"Richmond",17,6,108,"Lake Oval",15,1948,"Regular",1,"Home","Sydney","Richmond",15
4641,1948-04-24,"R2","Carlton",8,10,58,"Fitzroy",10,18,78,"Princes Park",-20,1948,"Regular",2,"Away","Fitzroy","Carlton",20
4642,1948-04-24,"R2","Richmond",20,12,132,"Footscray",8,9,57,"Punt Rd",75,1948,"Regular",2,"Home","Richmond","Footscray",75
4643,1948-04-24,"R2","Geelong",15,17,107,"North Melbourne",10,8,68,"Kardinia Park",39,1948,"Regular",2,"Home","Geelong","North Melbourne",39
4644,1948-04-24,"R2","St Kilda",7,6,48,"Melbourne",11,13,79,"Junction Oval",-31,1948,"Regular",2,"Away","Melbourne","St Kilda",31
4645,1948-04-26,"R2","Collingwood",18,17,125,"Sydney",10,12,72,"Victoria Park",53,1948,"Regular",2,"Home","Collingwood","Sydney",53
4646,1948-04-26,"R2","Essendon",11,16,82,"Hawthorn",8,11,59,"Windy Hill",23,1948,"Regular",2,"Home","Essendon","Hawthorn",23
4647,1948-05-01,"R3","Geelong",12,15,87,"Carlton",13,11,89,"Kardinia Park",-2,1948,"Regular",3,"Away","Carlton","Geelong",2
4648,1948-05-01,"R3","Essendon",16,12,108,"Collingwood",14,9,93,"Windy Hill",15,1948,"Regular",3,"Home","Essendon","Collingwood",15
4649,1948-05-01,"R3","Melbourne",6,12,48,"Fitzroy",12,14,86,"M.C.G.",-38,1948,"Regular",3,"Away","Fitzroy","Melbourne",38
4650,1948-05-01,"R3","Footscray",12,12,84,"Hawthorn",6,9,45,"Western Oval",39,1948,"Regular",3,"Home","Footscray","Hawthorn",39
4651,1948-05-01,"R3","North Melbourne",10,11,71,"Sydney",13,16,94,"Arden St",-23,1948,"Regular",3,"Away","Sydney","North Melbourne",23
4652,1948-05-01,"R3","St Kilda",11,12,78,"Richmond",15,16,106,"Junction Oval",-28,1948,"Regular",3,"Away","Richmond","St Kilda",28
4653,1948-05-08,"R4","Carlton",12,24,96,"Footscray",15,8,98,"Princes Park",-2,1948,"Regular",4,"Away","Footscray","Carlton",2
4654,1948-05-08,"R4","Collingwood",18,13,121,"Geelong",13,10,88,"Victoria Park",33,1948,"Regular",4,"Home","Collingwood","Geelong",33
4655,1948-05-08,"R4","Sydney",11,12,78,"Essendon",20,20,140,"Lake Oval",-62,1948,"Regular",4,"Away","Essendon","Sydney",62
4656,1948-05-08,"R4","Fitzroy",19,14,128,"St Kilda",6,8,44,"Brunswick St",84,1948,"Regular",4,"Home","Fitzroy","St Kilda",84
4657,1948-05-08,"R4","Hawthorn",14,21,105,"North Melbourne",11,15,81,"Glenferrie Oval",24,1948,"Regular",4,"Home","Hawthorn","North Melbourne",24
4658,1948-05-08,"R4","Richmond",12,12,84,"Melbourne",13,11,89,"Punt Rd",-5,1948,"Regular",4,"Away","Melbourne","Richmond",5
4659,1948-05-15,"R5","Collingwood",8,17,65,"Carlton",9,9,63,"Victoria Park",2,1948,"Regular",5,"Home","Collingwood","Carlton",2
4660,1948-05-15,"R5","Essendon",13,17,95,"Richmond",14,11,95,"Windy Hill",0,1948,"Regular",5,"Home","Essendon","Richmond",0
4661,1948-05-15,"R5","Fitzroy",15,19,109,"Hawthorn",6,11,47,"Brunswick St",62,1948,"Regular",5,"Home","Fitzroy","Hawthorn",62
4662,1948-05-15,"R5","Geelong",11,13,79,"Footscray",8,10,58,"Kardinia Park",21,1948,"Regular",5,"Home","Geelong","Footscray",21
4663,1948-05-15,"R5","Melbourne",14,11,95,"North Melbourne",6,14,50,"M.C.G.",45,1948,"Regular",5,"Home","Melbourne","North Melbourne",45
4664,1948-05-15,"R5","St Kilda",12,12,84,"Sydney",14,23,107,"Junction Oval",-23,1948,"Regular",5,"Away","Sydney","St Kilda",23
4665,1948-05-22,"R6","Carlton",14,9,93,"Essendon",19,7,121,"Princes Park",-28,1948,"Regular",6,"Away","Essendon","Carlton",28
4666,1948-05-22,"R6","Richmond",21,14,140,"Collingwood",9,21,75,"Punt Rd",65,1948,"Regular",6,"Home","Richmond","Collingwood",65
4667,1948-05-22,"R6","Footscray",10,11,71,"Fitzroy",9,10,64,"Western Oval",7,1948,"Regular",6,"Home","Footscray","Fitzroy",7
4668,1948-05-22,"R6","Hawthorn",17,10,112,"Geelong",12,3,75,"Glenferrie Oval",37,1948,"Regular",6,"Home","Hawthorn","Geelong",37
4669,1948-05-22,"R6","Sydney",9,5,59,"Melbourne",15,15,105,"Lake Oval",-46,1948,"Regular",6,"Away","Melbourne","Sydney",46
4670,1948-05-22,"R6","North Melbourne",12,16,88,"St Kilda",9,10,64,"Arden St",24,1948,"Regular",6,"Home","North Melbourne","St Kilda",24
4671,1948-05-29,"R7","Melbourne",15,12,102,"Carlton",7,9,51,"M.C.G.",51,1948,"Regular",7,"Home","Melbourne","Carlton",51
4672,1948-05-29,"R7","St Kilda",4,12,36,"Collingwood",10,18,78,"Junction Oval",-42,1948,"Regular",7,"Away","Collingwood","St Kilda",42
4673,1948-05-29,"R7","Essendon",12,11,83,"Geelong",14,15,99,"Windy Hill",-16,1948,"Regular",7,"Away","Geelong","Essendon",16
4674,1948-05-29,"R7","Fitzroy",9,20,74,"North Melbourne",7,8,50,"Brunswick St",24,1948,"Regular",7,"Home","Fitzroy","North Melbourne",24
4675,1948-05-29,"R7","Footscray",8,12,60,"Sydney",3,10,28,"Western Oval",32,1948,"Regular",7,"Home","Footscray","Sydney",32
4676,1948-05-29,"R7","Hawthorn",9,11,65,"Richmond",12,14,86,"Glenferrie Oval",-21,1948,"Regular",7,"Away","Richmond","Hawthorn",21
4677,1948-06-05,"R8","Richmond",13,10,88,"Carlton",9,21,75,"Punt Rd",13,1948,"Regular",8,"Home","Richmond","Carlton",13
4678,1948-06-05,"R8","Collingwood",11,17,83,"Melbourne",11,10,76,"Victoria Park",7,1948,"Regular",8,"Home","Collingwood","Melbourne",7
4679,1948-06-05,"R8","Fitzroy",12,8,80,"Essendon",9,10,64,"Brunswick St",16,1948,"Regular",8,"Home","Fitzroy","Essendon",16
4680,1948-06-05,"R8","North Melbourne",11,6,72,"Footscray",8,9,57,"Arden St",15,1948,"Regular",8,"Home","North Melbourne","Footscray",15
4681,1948-06-05,"R8","Geelong",15,16,106,"Sydney",19,12,126,"Kardinia Park",-20,1948,"Regular",8,"Away","Sydney","Geelong",20
4682,1948-06-05,"R8","St Kilda",7,12,54,"Hawthorn",10,12,72,"Junction Oval",-18,1948,"Regular",8,"Away","Hawthorn","St Kilda",18
4683,1948-06-12,"R9","Hawthorn",8,8,56,"Collingwood",12,27,99,"Glenferrie Oval",-43,1948,"Regular",9,"Away","Collingwood","Hawthorn",43
4684,1948-06-12,"R9","Essendon",12,14,86,"North Melbourne",4,8,32,"Windy Hill",54,1948,"Regular",9,"Home","Essendon","North Melbourne",54
4685,1948-06-12,"R9","Sydney",9,12,66,"Fitzroy",15,11,101,"Lake Oval",-35,1948,"Regular",9,"Away","Fitzroy","Sydney",35
4686,1948-06-14,"R9","Carlton",12,12,84,"St Kilda",7,18,60,"Princes Park",24,1948,"Regular",9,"Home","Carlton","St Kilda",24
4687,1948-06-14,"R9","Footscray",11,9,75,"Melbourne",9,14,68,"Western Oval",7,1948,"Regular",9,"Home","Footscray","Melbourne",7
4688,1948-06-14,"R9","Richmond",15,14,104,"Geelong",14,19,103,"Punt Rd",1,1948,"Regular",9,"Home","Richmond","Geelong",1
4689,1948-06-19,"R10","Sydney",13,9,87,"Carlton",23,11,149,"Lake Oval",-62,1948,"Regular",10,"Away","Carlton","Sydney",62
4690,1948-06-19,"R10","Collingwood",15,12,102,"Fitzroy",13,7,85,"Victoria Park",17,1948,"Regular",10,"Home","Collingwood","Fitzroy",17
4691,1948-06-19,"R10","Essendon",18,12,120,"Footscray",4,14,38,"Windy Hill",82,1948,"Regular",10,"Home","Essendon","Footscray",82
4692,1948-06-19,"R10","Geelong",21,13,139,"St Kilda",9,9,63,"Kardinia Park",76,1948,"Regular",10,"Home","Geelong","St Kilda",76
4693,1948-06-19,"R10","Melbourne",18,12,120,"Hawthorn",11,13,79,"M.C.G.",41,1948,"Regular",10,"Home","Melbourne","Hawthorn",41
4694,1948-06-19,"R10","North Melbourne",14,6,90,"Richmond",9,16,70,"Arden St",20,1948,"Regular",10,"Home","North Melbourne","Richmond",20
4695,1948-07-03,"R11","Carlton",10,23,83,"North Melbourne",14,10,94,"Princes Park",-11,1948,"Regular",11,"Away","North Melbourne","Carlton",11
4696,1948-07-03,"R11","Footscray",10,11,71,"Collingwood",19,9,123,"Western Oval",-52,1948,"Regular",11,"Away","Collingwood","Footscray",52
4697,1948-07-03,"R11","St Kilda",11,6,72,"Essendon",17,22,124,"Junction Oval",-52,1948,"Regular",11,"Away","Essendon","St Kilda",52
4698,1948-07-03,"R11","Fitzroy",19,20,134,"Richmond",14,11,95,"Brunswick St",39,1948,"Regular",11,"Home","Fitzroy","Richmond",39
4699,1948-07-03,"R11","Melbourne",9,17,71,"Geelong",8,9,57,"M.C.G.",14,1948,"Regular",11,"Home","Melbourne","Geelong",14
4700,1948-07-03,"R11","Hawthorn",9,7,61,"Sydney",12,15,87,"Glenferrie Oval",-26,1948,"Regular",11,"Away","Sydney","Hawthorn",26
4701,1948-07-10,"R12","Carlton",17,10,112,"Hawthorn",10,9,69,"Princes Park",43,1948,"Regular",12,"Home","Carlton","Hawthorn",43
4702,1948-07-10,"R12","Collingwood",19,13,127,"North Melbourne",10,11,71,"Victoria Park",56,1948,"Regular",12,"Home","Collingwood","North Melbourne",56
4703,1948-07-10,"R12","Essendon",13,13,91,"Melbourne",9,11,65,"Windy Hill",26,1948,"Regular",12,"Home","Essendon","Melbourne",26
4704,1948-07-10,"R12","Geelong",13,9,87,"Fitzroy",9,17,71,"Kardinia Park",16,1948,"Regular",12,"Home","Geelong","Fitzroy",16
4705,1948-07-10,"R12","St Kilda",7,11,53,"Footscray",13,13,91,"Junction Oval",-38,1948,"Regular",12,"Away","Footscray","St Kilda",38
4706,1948-07-10,"R12","Richmond",21,18,144,"Sydney",9,13,67,"Punt Rd",77,1948,"Regular",12,"Home","Richmond","Sydney",77
4707,1948-07-17,"R13","Fitzroy",12,12,84,"Carlton",16,17,113,"Brunswick St",-29,1948,"Regular",13,"Away","Carlton","Fitzroy",29
4708,1948-07-17,"R13","Sydney",10,12,72,"Collingwood",13,16,94,"Lake Oval",-22,1948,"Regular",13,"Away","Collingwood","Sydney",22
4709,1948-07-17,"R13","Hawthorn",9,12,66,"Essendon",18,14,122,"Glenferrie Oval",-56,1948,"Regular",13,"Away","Essendon","Hawthorn",56
4710,1948-07-17,"R13","Footscray",10,14,74,"Richmond",12,9,81,"Western Oval",-7,1948,"Regular",13,"Away","Richmond","Footscray",7
4711,1948-07-17,"R13","North Melbourne",10,8,68,"Geelong",10,15,75,"Arden St",-7,1948,"Regular",13,"Away","Geelong","North Melbourne",7
4712,1948-07-17,"R13","Melbourne",24,19,163,"St Kilda",8,10,58,"M.C.G.",105,1948,"Regular",13,"Home","Melbourne","St Kilda",105
4713,1948-07-24,"R14","Carlton",24,9,153,"Geelong",9,8,62,"Princes Park",91,1948,"Regular",14,"Home","Carlton","Geelong",91
4714,1948-07-24,"R14","Collingwood",12,13,85,"Essendon",16,11,107,"Victoria Park",-22,1948,"Regular",14,"Away","Essendon","Collingwood",22
4715,1948-07-24,"R14","Fitzroy",11,11,77,"Melbourne",17,11,113,"Brunswick St",-36,1948,"Regular",14,"Away","Melbourne","Fitzroy",36
4716,1948-07-24,"R14","Hawthorn",11,7,73,"Footscray",11,12,78,"Glenferrie Oval",-5,1948,"Regular",14,"Away","Footscray","Hawthorn",5
4717,1948-07-24,"R14","Sydney",14,18,102,"North Melbourne",15,14,104,"Lake Oval",-2,1948,"Regular",14,"Away","North Melbourne","Sydney",2
4718,1948-07-24,"R14","Richmond",21,20,146,"St Kilda",5,9,39,"Punt Rd",107,1948,"Regular",14,"Home","Richmond","St Kilda",107
4719,1948-07-31,"R15","Geelong",10,18,78,"Collingwood",10,13,73,"Kardinia Park",5,1948,"Regular",15,"Home","Geelong","Collingwood",5
4720,1948-07-31,"R15","St Kilda",11,6,72,"Fitzroy",9,10,64,"Junction Oval",8,1948,"Regular",15,"Home","St Kilda","Fitzroy",8
4721,1948-07-31,"R15","North Melbourne",11,18,84,"Hawthorn",8,9,57,"Arden St",27,1948,"Regular",15,"Home","North Melbourne","Hawthorn",27
4722,1948-08-07,"R15","Footscray",4,17,41,"Carlton",15,19,109,"Western Oval",-68,1948,"Regular",15,"Away","Carlton","Footscray",68
4723,1948-08-07,"R15","Essendon",11,21,87,"Sydney",8,11,59,"Windy Hill",28,1948,"Regular",15,"Home","Essendon","Sydney",28
4724,1948-08-07,"R15","Melbourne",6,8,44,"Richmond",15,16,106,"M.C.G.",-62,1948,"Regular",15,"Away","Richmond","Melbourne",62
4725,1948-08-14,"R16","Carlton",10,20,80,"Collingwood",10,10,70,"Princes Park",10,1948,"Regular",16,"Home","Carlton","Collingwood",10
4726,1948-08-14,"R16","Richmond",8,7,55,"Essendon",8,10,58,"Punt Rd",-3,1948,"Regular",16,"Away","Essendon","Richmond",3
4727,1948-08-14,"R16","Hawthorn",6,7,43,"Fitzroy",4,16,40,"Glenferrie Oval",3,1948,"Regular",16,"Home","Hawthorn","Fitzroy",3
4728,1948-08-14,"R16","Footscray",11,25,91,"Geelong",7,15,57,"Western Oval",34,1948,"Regular",16,"Home","Footscray","Geelong",34
4729,1948-08-14,"R16","North Melbourne",5,12,42,"Melbourne",10,14,74,"Arden St",-32,1948,"Regular",16,"Away","Melbourne","North Melbourne",32
4730,1948-08-14,"R16","Sydney",5,11,41,"St Kilda",5,9,39,"Lake Oval",2,1948,"Regular",16,"Home","Sydney","St Kilda",2
4731,1948-08-21,"R17","Essendon",16,15,111,"Carlton",11,11,77,"Windy Hill",34,1948,"Regular",17,"Home","Essendon","Carlton",34
4732,1948-08-21,"R17","Collingwood",15,18,108,"Richmond",10,12,72,"Victoria Park",36,1948,"Regular",17,"Home","Collingwood","Richmond",36
4733,1948-08-21,"R17","Fitzroy",9,9,63,"Footscray",11,15,81,"Brunswick St",-18,1948,"Regular",17,"Away","Footscray","Fitzroy",18
4734,1948-08-21,"R17","Geelong",11,14,80,"Hawthorn",11,15,81,"Kardinia Park",-1,1948,"Regular",17,"Away","Hawthorn","Geelong",1
4735,1948-08-21,"R17","Melbourne",15,13,103,"Sydney",7,12,54,"M.C.G.",49,1948,"Regular",17,"Home","Melbourne","Sydney",49
4736,1948-08-21,"R17","St Kilda",8,10,58,"North Melbourne",7,19,61,"Junction Oval",-3,1948,"Regular",17,"Away","North Melbourne","St Kilda",3
4737,1948-08-28,"R18","Carlton",13,14,92,"Melbourne",15,11,101,"Princes Park",-9,1948,"Regular",18,"Away","Melbourne","Carlton",9
4738,1948-08-28,"R18","Collingwood",15,19,109,"St Kilda",11,4,70,"Victoria Park",39,1948,"Regular",18,"Home","Collingwood","St Kilda",39
4739,1948-08-28,"R18","Geelong",9,10,64,"Essendon",10,12,72,"Kardinia Park",-8,1948,"Regular",18,"Away","Essendon","Geelong",8
4740,1948-08-28,"R18","North Melbourne",8,12,60,"Fitzroy",6,10,46,"Arden St",14,1948,"Regular",18,"Home","North Melbourne","Fitzroy",14
4741,1948-08-28,"R18","Sydney",7,7,49,"Footscray",14,16,100,"Lake Oval",-51,1948,"Regular",18,"Away","Footscray","Sydney",51
4742,1948-08-28,"R18","Richmond",17,11,113,"Hawthorn",9,6,60,"Punt Rd",53,1948,"Regular",18,"Home","Richmond","Hawthorn",53
4743,1948-09-04,"R19","Carlton",9,21,75,"Richmond",9,16,70,"Princes Park",5,1948,"Regular",19,"Home","Carlton","Richmond",5
4744,1948-09-04,"R19","Melbourne",13,11,89,"Collingwood",8,11,59,"M.C.G.",30,1948,"Regular",19,"Home","Melbourne","Collingwood",30
4745,1948-09-04,"R19","Essendon",10,11,71,"Fitzroy",7,11,53,"Windy Hill",18,1948,"Regular",19,"Home","Essendon","Fitzroy",18
4746,1948-09-04,"R19","Footscray",18,21,129,"North Melbourne",11,10,76,"Western Oval",53,1948,"Regular",19,"Home","Footscray","North Melbourne",53
4747,1948-09-04,"R19","Sydney",21,15,141,"Geelong",6,9,45,"Lake Oval",96,1948,"Regular",19,"Home","Sydney","Geelong",96
4748,1948-09-04,"R19","Hawthorn",7,12,54,"St Kilda",9,13,67,"Glenferrie Oval",-13,1948,"Regular",19,"Away","St Kilda","Hawthorn",13
4749,1948-09-11,"SF","Collingwood",17,17,119,"Footscray",12,12,84,"M.C.G.",35,1948,"Finals",20,"Home","Collingwood","Footscray",35
4750,1948-09-18,"SF","Essendon",13,16,94,"Melbourne",8,10,58,"M.C.G.",36,1948,"Finals",20,"Home","Essendon","Melbourne",36
4751,1948-09-25,"PF","Melbourne",25,16,166,"Collingwood",15,11,101,"M.C.G.",65,1948,"Finals",21,"Home","Melbourne","Collingwood",65
4752,1948-10-02,"GF","Essendon",7,27,69,"Melbourne",10,9,69,"M.C.G.",0,1948,"Finals",22,"Home","Essendon","Melbourne",0
4753,1948-10-09,"GF","Essendon",7,8,50,"Melbourne",13,11,89,"M.C.G.",-39,1948,"Finals",22,"Away","Melbourne","Essendon",39
4754,1949-04-16,"R1","Collingwood",19,13,127,"North Melbourne",10,17,77,"Victoria Park",50,1949,"Regular",1,"Home","Collingwood","North Melbourne",50
4755,1949-04-16,"R1","Essendon",18,12,120,"Hawthorn",9,3,57,"Windy Hill",63,1949,"Regular",1,"Home","Essendon","Hawthorn",63
4756,1949-04-16,"R1","St Kilda",11,10,76,"Fitzroy",14,14,98,"Junction Oval",-22,1949,"Regular",1,"Away","Fitzroy","St Kilda",22
4757,1949-04-16,"R1","Geelong",21,19,145,"Melbourne",12,11,83,"Kardinia Park",62,1949,"Regular",1,"Home","Geelong","Melbourne",62
4758,1949-04-18,"R1","Carlton",16,16,112,"Sydney",6,12,48,"Princes Park",64,1949,"Regular",1,"Home","Carlton","Sydney",64
4759,1949-04-18,"R1","Richmond",19,13,127,"Footscray",8,10,58,"Punt Rd",69,1949,"Regular",1,"Home","Richmond","Footscray",69
4760,1949-04-23,"R2","Fitzroy",15,16,106,"Carlton",15,15,105,"Brunswick St",1,1949,"Regular",2,"Home","Fitzroy","Carlton",1
4761,1949-04-23,"R2","Melbourne",12,8,80,"Collingwood",11,16,82,"M.C.G.",-2,1949,"Regular",2,"Away","Collingwood","Melbourne",2
4762,1949-04-23,"R2","North Melbourne",7,14,56,"Essendon",10,15,75,"Arden St",-19,1949,"Regular",2,"Away","Essendon","North Melbourne",19
4763,1949-04-23,"R2","Footscray",12,7,79,"Geelong",9,14,68,"Western Oval",11,1949,"Regular",2,"Home","Footscray","Geelong",11
4764,1949-04-23,"R2","Hawthorn",5,13,43,"Richmond",20,12,132,"Glenferrie Oval",-89,1949,"Regular",2,"Away","Richmond","Hawthorn",89
4765,1949-04-23,"R2","Sydney",12,13,85,"St Kilda",12,10,82,"Lake Oval",3,1949,"Regular",2,"Home","Sydney","St Kilda",3
4766,1949-04-30,"R3","Carlton",21,27,153,"Hawthorn",7,6,48,"Princes Park",105,1949,"Regular",3,"Home","Carlton","Hawthorn",105
4767,1949-04-30,"R3","Collingwood",7,14,56,"Fitzroy",8,9,57,"Victoria Park",-1,1949,"Regular",3,"Away","Fitzroy","Collingwood",1
4768,1949-04-30,"R3","St Kilda",5,15,45,"Essendon",13,16,94,"Junction Oval",-49,1949,"Regular",3,"Away","Essendon","St Kilda",49
4769,1949-04-30,"R3","Melbourne",14,16,100,"Footscray",7,6,48,"M.C.G.",52,1949,"Regular",3,"Home","Melbourne","Footscray",52
4770,1949-04-30,"R3","Geelong",14,14,98,"Sydney",10,15,75,"Kardinia Park",23,1949,"Regular",3,"Home","Geelong","Sydney",23
4771,1949-04-30,"R3","North Melbourne",14,8,92,"Richmond",9,5,59,"Arden St",33,1949,"Regular",3,"Home","North Melbourne","Richmond",33
4772,1949-05-07,"R4","Essendon",6,9,45,"Carlton",7,22,64,"Windy Hill",-19,1949,"Regular",4,"Away","Carlton","Essendon",19
4773,1949-05-07,"R4","Hawthorn",5,10,40,"Collingwood",9,11,65,"Glenferrie Oval",-25,1949,"Regular",4,"Away","Collingwood","Hawthorn",25
4774,1949-05-07,"R4","Fitzroy",13,15,93,"Geelong",15,15,105,"Brunswick St",-12,1949,"Regular",4,"Away","Geelong","Fitzroy",12
4775,1949-05-07,"R4","Footscray",4,15,39,"North Melbourne",12,3,75,"Western Oval",-36,1949,"Regular",4,"Away","North Melbourne","Footscray",36
4776,1949-05-07,"R4","Sydney",8,11,59,"Melbourne",7,9,51,"Lake Oval",8,1949,"Regular",4,"Home","Sydney","Melbourne",8
4777,1949-05-07,"R4","Richmond",17,11,113,"St Kilda",11,14,80,"Punt Rd",33,1949,"Regular",4,"Home","Richmond","St Kilda",33
4778,1949-05-14,"R5","Carlton",16,8,104,"Collingwood",10,14,74,"Princes Park",30,1949,"Regular",5,"Home","Carlton","Collingwood",30
4779,1949-05-14,"R5","Essendon",11,18,84,"Richmond",9,15,69,"Windy Hill",15,1949,"Regular",5,"Home","Essendon","Richmond",15
4780,1949-05-14,"R5","Hawthorn",9,13,67,"Fitzroy",14,21,105,"Glenferrie Oval",-38,1949,"Regular",5,"Away","Fitzroy","Hawthorn",38
4781,1949-05-14,"R5","Sydney",10,8,68,"Footscray",6,14,50,"Lake Oval",18,1949,"Regular",5,"Home","Sydney","Footscray",18
4782,1949-05-14,"R5","Geelong",15,13,103,"St Kilda",10,11,71,"Kardinia Park",32,1949,"Regular",5,"Home","Geelong","St Kilda",32
4783,1949-05-14,"R5","Melbourne",5,16,46,"North Melbourne",6,12,48,"M.C.G.",-2,1949,"Regular",5,"Away","North Melbourne","Melbourne",2
4784,1949-05-21,"R6","Carlton",18,13,121,"Geelong",12,10,82,"Princes Park",39,1949,"Regular",6,"Home","Carlton","Geelong",39
4785,1949-05-21,"R6","Collingwood",11,16,82,"Essendon",12,9,81,"Victoria Park",1,1949,"Regular",6,"Home","Collingwood","Essendon",1
4786,1949-05-21,"R6","Fitzroy",12,14,86,"Footscray",10,22,82,"Brunswick St",4,1949,"Regular",6,"Home","Fitzroy","Footscray",4
4787,1949-05-21,"R6","North Melbourne",13,23,101,"Hawthorn",12,7,79,"Arden St",22,1949,"Regular",6,"Home","North Melbourne","Hawthorn",22
4788,1949-05-21,"R6","St Kilda",4,13,37,"Melbourne",8,13,61,"Junction Oval",-24,1949,"Regular",6,"Away","Melbourne","St Kilda",24
4789,1949-05-21,"R6","Richmond",15,13,103,"Sydney",8,12,60,"Punt Rd",43,1949,"Regular",6,"Home","Richmond","Sydney",43
4790,1949-05-28,"R7","St Kilda",8,14,62,"Carlton",14,11,95,"Junction Oval",-33,1949,"Regular",7,"Away","Carlton","St Kilda",33
4791,1949-05-28,"R7","Footscray",8,10,58,"Collingwood",12,15,87,"Western Oval",-29,1949,"Regular",7,"Away","Collingwood","Footscray",29
4792,1949-05-28,"R7","Essendon",11,9,75,"Melbourne",13,12,90,"Windy Hill",-15,1949,"Regular",7,"Away","Melbourne","Essendon",15
4793,1949-05-28,"R7","Richmond",21,21,147,"Fitzroy",9,12,66,"Punt Rd",81,1949,"Regular",7,"Home","Richmond","Fitzroy",81
4794,1949-05-28,"R7","North Melbourne",8,13,61,"Geelong",8,7,55,"Arden St",6,1949,"Regular",7,"Home","North Melbourne","Geelong",6
4795,1949-05-28,"R7","Hawthorn",6,12,48,"Sydney",12,15,87,"Glenferrie Oval",-39,1949,"Regular",7,"Away","Sydney","Hawthorn",39
4796,1949-06-04,"R8","Carlton",14,13,97,"North Melbourne",10,7,67,"Princes Park",30,1949,"Regular",8,"Home","Carlton","North Melbourne",30
4797,1949-06-04,"R8","Collingwood",21,22,148,"St Kilda",4,12,36,"Victoria Park",112,1949,"Regular",8,"Home","Collingwood","St Kilda",112
4798,1949-06-04,"R8","Footscray",7,17,59,"Essendon",10,12,72,"Western Oval",-13,1949,"Regular",8,"Away","Essendon","Footscray",13
4799,1949-06-04,"R8","Sydney",12,7,79,"Fitzroy",14,14,98,"Lake Oval",-19,1949,"Regular",8,"Away","Fitzroy","Sydney",19
4800,1949-06-04,"R8","Geelong",10,15,75,"Richmond",11,13,79,"Kardinia Park",-4,1949,"Regular",8,"Away","Richmond","Geelong",4
4801,1949-06-04,"R8","Melbourne",10,17,77,"Hawthorn",10,6,66,"M.C.G.",11,1949,"Regular",8,"Home","Melbourne","Hawthorn",11
4802,1949-06-11,"R9","Collingwood",17,14,116,"Geelong",12,7,79,"Victoria Park",37,1949,"Regular",9,"Home","Collingwood","Geelong",37
4803,1949-06-11,"R9","Sydney",15,16,106,"Essendon",12,9,81,"Lake Oval",25,1949,"Regular",9,"Home","Sydney","Essendon",25
4804,1949-06-11,"R9","Hawthorn",10,13,73,"Footscray",8,15,63,"Glenferrie Oval",10,1949,"Regular",9,"Home","Hawthorn","Footscray",10
4805,1949-06-13,"R9","Richmond",12,12,84,"Carlton",14,15,99,"Punt Rd",-15,1949,"Regular",9,"Away","Carlton","Richmond",15
4806,1949-06-13,"R9","Fitzroy",7,10,52,"Melbourne",10,14,74,"Brunswick St",-22,1949,"Regular",9,"Away","Melbourne","Fitzroy",22
4807,1949-06-13,"R9","North Melbourne",11,12,78,"St Kilda",7,7,49,"Arden St",29,1949,"Regular",9,"Home","North Melbourne","St Kilda",29
4808,1949-06-18,"R10","Carlton",11,12,78,"Melbourne",12,14,86,"Princes Park",-8,1949,"Regular",10,"Away","Melbourne","Carlton",8
4809,1949-06-18,"R10","Richmond",16,5,101,"Collingwood",16,8,104,"Punt Rd",-3,1949,"Regular",10,"Away","Collingwood","Richmond",3
4810,1949-06-18,"R10","Essendon",8,19,67,"Fitzroy",10,10,70,"Windy Hill",-3,1949,"Regular",10,"Away","Fitzroy","Essendon",3
4811,1949-06-18,"R10","St Kilda",7,14,56,"Footscray",11,11,77,"Junction Oval",-21,1949,"Regular",10,"Away","Footscray","St Kilda",21
4812,1949-06-18,"R10","Geelong",20,12,132,"Hawthorn",6,10,46,"Kardinia Park",86,1949,"Regular",10,"Home","Geelong","Hawthorn",86
4813,1949-06-18,"R10","North Melbourne",18,25,133,"Sydney",6,9,45,"Arden St",88,1949,"Regular",10,"Home","North Melbourne","Sydney",88
4814,1949-07-02,"R11","Footscray",9,9,63,"Carlton",7,16,58,"Western Oval",5,1949,"Regular",11,"Home","Footscray","Carlton",5
4815,1949-07-02,"R11","Collingwood",15,16,106,"Sydney",6,16,52,"Victoria Park",54,1949,"Regular",11,"Home","Collingwood","Sydney",54
4816,1949-07-02,"R11","Geelong",25,17,167,"Essendon",11,6,72,"Kardinia Park",95,1949,"Regular",11,"Home","Geelong","Essendon",95
4817,1949-07-02,"R11","Fitzroy",10,12,72,"North Melbourne",12,9,81,"Brunswick St",-9,1949,"Regular",11,"Away","North Melbourne","Fitzroy",9
4818,1949-07-02,"R11","St Kilda",13,11,89,"Hawthorn",14,13,97,"Junction Oval",-8,1949,"Regular",11,"Away","Hawthorn","St Kilda",8
4819,1949-07-02,"R11","Melbourne",14,17,101,"Richmond",9,9,63,"M.C.G.",38,1949,"Regular",11,"Home","Melbourne","Richmond",38
4820,1949-07-09,"R12","Sydney",6,12,48,"Carlton",11,15,81,"Lake Oval",-33,1949,"Regular",12,"Away","Carlton","Sydney",33
4821,1949-07-09,"R12","North Melbourne",8,6,54,"Collingwood",4,13,37,"Arden St",17,1949,"Regular",12,"Home","North Melbourne","Collingwood",17
4822,1949-07-09,"R12","Hawthorn",7,0,42,"Essendon",16,16,112,"Glenferrie Oval",-70,1949,"Regular",12,"Away","Essendon","Hawthorn",70
4823,1949-07-09,"R12","Fitzroy",14,10,94,"St Kilda",6,13,49,"Brunswick St",45,1949,"Regular",12,"Home","Fitzroy","St Kilda",45
4824,1949-07-09,"R12","Footscray",12,11,83,"Richmond",7,18,60,"Western Oval",23,1949,"Regular",12,"Home","Footscray","Richmond",23
4825,1949-07-09,"R12","Melbourne",14,17,101,"Geelong",14,14,98,"M.C.G.",3,1949,"Regular",12,"Home","Melbourne","Geelong",3
4826,1949-07-16,"R13","Carlton",9,13,67,"Fitzroy",9,8,62,"Princes Park",5,1949,"Regular",13,"Home","Carlton","Fitzroy",5
4827,1949-07-16,"R13","Collingwood",7,16,58,"Melbourne",10,13,73,"Victoria Park",-15,1949,"Regular",13,"Away","Melbourne","Collingwood",15
4828,1949-07-16,"R13","Essendon",8,22,70,"North Melbourne",6,13,49,"Windy Hill",21,1949,"Regular",13,"Home","Essendon","North Melbourne",21
4829,1949-07-16,"R13","Geelong",13,15,93,"Footscray",4,10,34,"Kardinia Park",59,1949,"Regular",13,"Home","Geelong","Footscray",59
4830,1949-07-16,"R13","Richmond",16,21,117,"Hawthorn",9,13,67,"Punt Rd",50,1949,"Regular",13,"Home","Richmond","Hawthorn",50
4831,1949-07-16,"R13","St Kilda",16,15,111,"Sydney",13,13,91,"Junction Oval",20,1949,"Regular",13,"Home","St Kilda","Sydney",20
4832,1949-07-23,"R14","Hawthorn",8,5,53,"Carlton",9,17,71,"Glenferrie Oval",-18,1949,"Regular",14,"Away","Carlton","Hawthorn",18
4833,1949-07-23,"R14","Fitzroy",10,11,71,"Collingwood",11,15,81,"Brunswick St",-10,1949,"Regular",14,"Away","Collingwood","Fitzroy",10
4834,1949-07-23,"R14","Essendon",13,17,95,"St Kilda",9,10,64,"Windy Hill",31,1949,"Regular",14,"Home","Essendon","St Kilda",31
4835,1949-07-23,"R14","Footscray",11,8,74,"Melbourne",10,12,72,"Western Oval",2,1949,"Regular",14,"Home","Footscray","Melbourne",2
4836,1949-07-23,"R14","Sydney",11,15,81,"Geelong",14,13,97,"Lake Oval",-16,1949,"Regular",14,"Away","Geelong","Sydney",16
4837,1949-07-23,"R14","Richmond",8,24,72,"North Melbourne",17,11,113,"Punt Rd",-41,1949,"Regular",14,"Away","North Melbourne","Richmond",41
4838,1949-07-30,"R15","Carlton",11,16,82,"Essendon",17,11,113,"Princes Park",-31,1949,"Regular",15,"Away","Essendon","Carlton",31
4839,1949-07-30,"R15","Collingwood",16,23,119,"Hawthorn",5,6,36,"Victoria Park",83,1949,"Regular",15,"Home","Collingwood","Hawthorn",83
4840,1949-07-30,"R15","Geelong",13,9,87,"Fitzroy",6,7,43,"Kardinia Park",44,1949,"Regular",15,"Home","Geelong","Fitzroy",44
4841,1949-07-30,"R15","North Melbourne",8,14,62,"Footscray",8,11,59,"Arden St",3,1949,"Regular",15,"Home","North Melbourne","Footscray",3
4842,1949-07-30,"R15","Melbourne",12,7,79,"Sydney",9,11,65,"M.C.G.",14,1949,"Regular",15,"Home","Melbourne","Sydney",14
4843,1949-07-30,"R15","St Kilda",13,11,89,"Richmond",9,14,68,"Junction Oval",21,1949,"Regular",15,"Home","St Kilda","Richmond",21
4844,1949-08-06,"R16","Collingwood",7,16,58,"Carlton",7,13,55,"Victoria Park",3,1949,"Regular",16,"Home","Collingwood","Carlton",3
4845,1949-08-06,"R16","Richmond",7,14,56,"Essendon",11,12,78,"Punt Rd",-22,1949,"Regular",16,"Away","Essendon","Richmond",22
4846,1949-08-06,"R16","Fitzroy",10,19,79,"Hawthorn",8,17,65,"Brunswick St",14,1949,"Regular",16,"Home","Fitzroy","Hawthorn",14
4847,1949-08-06,"R16","Footscray",10,14,74,"Sydney",8,10,58,"Western Oval",16,1949,"Regular",16,"Home","Footscray","Sydney",16
4848,1949-08-06,"R16","St Kilda",10,9,69,"Geelong",8,12,60,"Junction Oval",9,1949,"Regular",16,"Home","St Kilda","Geelong",9
4849,1949-08-06,"R16","North Melbourne",9,10,64,"Melbourne",8,10,58,"Arden St",6,1949,"Regular",16,"Home","North Melbourne","Melbourne",6
4850,1949-08-13,"R17","Geelong",6,11,47,"Carlton",12,18,90,"Kardinia Park",-43,1949,"Regular",17,"Away","Carlton","Geelong",43
4851,1949-08-13,"R17","Essendon",16,21,117,"Collingwood",10,11,71,"Windy Hill",46,1949,"Regular",17,"Home","Essendon","Collingwood",46
4852,1949-08-13,"R17","Footscray",13,16,94,"Fitzroy",8,11,59,"Western Oval",35,1949,"Regular",17,"Home","Footscray","Fitzroy",35
4853,1949-08-13,"R17","Hawthorn",13,10,88,"North Melbourne",9,16,70,"Glenferrie Oval",18,1949,"Regular",17,"Home","Hawthorn","North Melbourne",18
4854,1949-08-13,"R17","Melbourne",15,16,106,"St Kilda",7,10,52,"M.C.G.",54,1949,"Regular",17,"Home","Melbourne","St Kilda",54
4855,1949-08-13,"R17","Sydney",9,13,67,"Richmond",10,17,77,"Lake Oval",-10,1949,"Regular",17,"Away","Richmond","Sydney",10
4856,1949-08-20,"R18","Carlton",13,17,95,"St Kilda",10,14,74,"Princes Park",21,1949,"Regular",18,"Home","Carlton","St Kilda",21
4857,1949-08-20,"R18","Collingwood",9,19,73,"Footscray",7,14,56,"Victoria Park",17,1949,"Regular",18,"Home","Collingwood","Footscray",17
4858,1949-08-20,"R18","Melbourne",11,10,76,"Essendon",15,11,101,"M.C.G.",-25,1949,"Regular",18,"Away","Essendon","Melbourne",25
4859,1949-08-20,"R18","Fitzroy",6,15,51,"Richmond",9,8,62,"Brunswick St",-11,1949,"Regular",18,"Away","Richmond","Fitzroy",11
4860,1949-08-20,"R18","Geelong",7,14,56,"North Melbourne",11,16,82,"Kardinia Park",-26,1949,"Regular",18,"Away","North Melbourne","Geelong",26
4861,1949-08-20,"R18","Sydney",14,8,92,"Hawthorn",8,14,62,"Lake Oval",30,1949,"Regular",18,"Home","Sydney","Hawthorn",30
4862,1949-08-27,"R19","North Melbourne",15,18,108,"Carlton",7,10,52,"Arden St",56,1949,"Regular",19,"Home","North Melbourne","Carlton",56
4863,1949-08-27,"R19","St Kilda",11,15,81,"Collingwood",10,12,72,"Junction Oval",9,1949,"Regular",19,"Home","St Kilda","Collingwood",9
4864,1949-08-27,"R19","Essendon",14,13,97,"Footscray",8,13,61,"Windy Hill",36,1949,"Regular",19,"Home","Essendon","Footscray",36
4865,1949-08-27,"R19","Fitzroy",19,12,126,"Sydney",10,17,77,"Brunswick St",49,1949,"Regular",19,"Home","Fitzroy","Sydney",49
4866,1949-08-27,"R19","Richmond",22,12,144,"Geelong",10,15,75,"Punt Rd",69,1949,"Regular",19,"Home","Richmond","Geelong",69
4867,1949-08-27,"R19","Hawthorn",10,16,76,"Melbourne",15,12,102,"Glenferrie Oval",-26,1949,"Regular",19,"Away","Melbourne","Hawthorn",26
4868,1949-09-03,"SF","Collingwood",8,6,54,"Essendon",20,16,136,"M.C.G.",-82,1949,"Finals",20,"Away","Essendon","Collingwood",82
4869,1949-09-10,"SF","North Melbourne",14,7,91,"Carlton",15,13,103,"M.C.G.",-12,1949,"Finals",20,"Away","Carlton","North Melbourne",12
4870,1949-09-17,"PF","North Melbourne",9,7,61,"Essendon",11,12,78,"M.C.G.",-17,1949,"Finals",21,"Away","Essendon","North Melbourne",17
4871,1949-09-24,"GF","Carlton",6,16,52,"Essendon",18,17,125,"M.C.G.",-73,1949,"Finals",22,"Away","Essendon","Carlton",73
4872,1950-04-22,"R1","Melbourne",13,13,91,"Carlton",10,11,71,"M.C.G.",20,1950,"Regular",1,"Home","Melbourne","Carlton",20
4873,1950-04-22,"R1","Sydney",14,12,96,"Collingwood",11,10,76,"Lake Oval",20,1950,"Regular",1,"Home","Sydney","Collingwood",20
4874,1950-04-22,"R1","Fitzroy",9,10,64,"Essendon",9,16,70,"Brunswick St",-6,1950,"Regular",1,"Away","Essendon","Fitzroy",6
4875,1950-04-22,"R1","Footscray",9,20,74,"St Kilda",12,11,83,"Western Oval",-9,1950,"Regular",1,"Away","St Kilda","Footscray",9
4876,1950-04-22,"R1","Hawthorn",4,15,39,"Geelong",18,11,119,"Glenferrie Oval",-80,1950,"Regular",1,"Away","Geelong","Hawthorn",80
4877,1950-04-22,"R1","North Melbourne",11,8,74,"Richmond",9,10,64,"Arden St",10,1950,"Regular",1,"Home","North Melbourne","Richmond",10
4878,1950-04-29,"R2","Carlton",18,18,126,"North Melbourne",16,14,110,"Princes Park",16,1950,"Regular",2,"Home","Carlton","North Melbourne",16
4879,1950-04-29,"R2","Collingwood",16,11,107,"Fitzroy",9,11,65,"Victoria Park",42,1950,"Regular",2,"Home","Collingwood","Fitzroy",42
4880,1950-04-29,"R2","Essendon",29,7,181,"Sydney",10,16,76,"Windy Hill",105,1950,"Regular",2,"Home","Essendon","Sydney",105
4881,1950-04-29,"R2","Geelong",18,17,125,"Footscray",13,14,92,"Kardinia Park",33,1950,"Regular",2,"Home","Geelong","Footscray",33
4882,1950-04-29,"R2","St Kilda",20,24,144,"Hawthorn",5,5,35,"Junction Oval",109,1950,"Regular",2,"Home","St Kilda","Hawthorn",109
4883,1950-04-29,"R2","Richmond",10,12,72,"Melbourne",10,13,73,"Punt Rd",-1,1950,"Regular",2,"Away","Melbourne","Richmond",1
4884,1950-05-06,"R3","Collingwood",8,22,70,"Carlton",12,9,81,"Victoria Park",-11,1950,"Regular",3,"Away","Carlton","Collingwood",11
4885,1950-05-06,"R3","Geelong",8,16,64,"Essendon",18,11,119,"Kardinia Park",-55,1950,"Regular",3,"Away","Essendon","Geelong",55
4886,1950-05-06,"R3","Richmond",9,15,69,"Fitzroy",8,11,59,"Punt Rd",10,1950,"Regular",3,"Home","Richmond","Fitzroy",10
4887,1950-05-06,"R3","Footscray",13,24,102,"Hawthorn",4,9,33,"Western Oval",69,1950,"Regular",3,"Home","Footscray","Hawthorn",69
4888,1950-05-06,"R3","North Melbourne",12,11,83,"Melbourne",7,17,59,"Arden St",24,1950,"Regular",3,"Home","North Melbourne","Melbourne",24
4889,1950-05-06,"R3","Sydney",11,15,81,"St Kilda",15,13,103,"Lake Oval",-22,1950,"Regular",3,"Away","St Kilda","Sydney",22
4890,1950-05-13,"R4","Carlton",17,15,117,"Richmond",16,10,106,"Princes Park",11,1950,"Regular",4,"Home","Carlton","Richmond",11
4891,1950-05-13,"R4","Hawthorn",6,12,48,"Collingwood",7,25,67,"Glenferrie Oval",-19,1950,"Regular",4,"Away","Collingwood","Hawthorn",19
4892,1950-05-13,"R4","Essendon",21,9,135,"Footscray",9,10,64,"Windy Hill",71,1950,"Regular",4,"Home","Essendon","Footscray",71
4893,1950-05-13,"R4","Fitzroy",16,27,123,"Sydney",8,9,57,"Brunswick St",66,1950,"Regular",4,"Home","Fitzroy","Sydney",66
4894,1950-05-13,"R4","Melbourne",10,7,67,"Geelong",9,16,70,"M.C.G.",-3,1950,"Regular",4,"Away","Geelong","Melbourne",3
4895,1950-05-13,"R4","St Kilda",12,8,80,"North Melbourne",10,18,78,"Junction Oval",2,1950,"Regular",4,"Home","St Kilda","North Melbourne",2
4896,1950-05-20,"R5","St Kilda",10,14,74,"Carlton",8,7,55,"Junction Oval",19,1950,"Regular",5,"Home","St Kilda","Carlton",19
4897,1950-05-20,"R5","Geelong",10,19,79,"Collingwood",12,8,80,"Kardinia Park",-1,1950,"Regular",5,"Away","Collingwood","Geelong",1
4898,1950-05-20,"R5","Richmond",10,18,78,"Essendon",17,8,110,"Punt Rd",-32,1950,"Regular",5,"Away","Essendon","Richmond",32
4899,1950-05-20,"R5","Fitzroy",19,15,129,"Hawthorn",4,24,48,"Brunswick St",81,1950,"Regular",5,"Home","Fitzroy","Hawthorn",81
4900,1950-05-20,"R5","Footscray",13,11,89,"Melbourne",16,9,105,"Western Oval",-16,1950,"Regular",5,"Away","Melbourne","Footscray",16
4901,1950-05-20,"R5","North Melbourne",14,12,96,"Sydney",14,9,93,"Arden St",3,1950,"Regular",5,"Home","North Melbourne","Sydney",3
4902,1950-05-27,"R6","Carlton",16,13,109,"Footscray",16,10,106,"Princes Park",3,1950,"Regular",6,"Home","Carlton","Footscray",3
4903,1950-05-27,"R6","Collingwood",14,14,98,"Richmond",16,11,107,"Victoria Park",-9,1950,"Regular",6,"Away","Richmond","Collingwood",9
4904,1950-05-27,"R6","North Melbourne",13,8,86,"Essendon",11,5,71,"Arden St",15,1950,"Regular",6,"Home","North Melbourne","Essendon",15
4905,1950-05-27,"R6","Melbourne",13,17,95,"Fitzroy",6,8,44,"M.C.G.",51,1950,"Regular",6,"Home","Melbourne","Fitzroy",51
4906,1950-05-27,"R6","Geelong",20,15,135,"St Kilda",5,11,41,"Kardinia Park",94,1950,"Regular",6,"Home","Geelong","St Kilda",94
4907,1950-05-27,"R6","Sydney",20,14,134,"Hawthorn",10,14,74,"Lake Oval",60,1950,"Regular",6,"Home","Sydney","Hawthorn",60
4908,1950-06-03,"R7","Sydney",9,14,68,"Carlton",11,8,74,"Lake Oval",-6,1950,"Regular",7,"Away","Carlton","Sydney",6
4909,1950-06-03,"R7","Footscray",10,7,67,"Collingwood",19,25,139,"Western Oval",-72,1950,"Regular",7,"Away","Collingwood","Footscray",72
4910,1950-06-03,"R7","Essendon",19,13,127,"St Kilda",9,9,63,"Windy Hill",64,1950,"Regular",7,"Home","Essendon","St Kilda",64
4911,1950-06-03,"R7","Fitzroy",7,7,49,"North Melbourne",13,15,93,"Brunswick St",-44,1950,"Regular",7,"Away","North Melbourne","Fitzroy",44
4912,1950-06-03,"R7","Richmond",12,7,79,"Geelong",9,20,74,"Punt Rd",5,1950,"Regular",7,"Home","Richmond","Geelong",5
4913,1950-06-03,"R7","Hawthorn",6,12,48,"Melbourne",14,12,96,"Glenferrie Oval",-48,1950,"Regular",7,"Away","Melbourne","Hawthorn",48
4914,1950-06-10,"R8","Carlton",11,5,71,"Essendon",10,16,76,"Princes Park",-5,1950,"Regular",8,"Away","Essendon","Carlton",5
4915,1950-06-10,"R8","Footscray",19,11,125,"Sydney",9,8,62,"Western Oval",63,1950,"Regular",8,"Home","Footscray","Sydney",63
4916,1950-06-10,"R8","Hawthorn",9,7,61,"Richmond",14,9,93,"Glenferrie Oval",-32,1950,"Regular",8,"Away","Richmond","Hawthorn",32
4917,1950-06-12,"R8","Melbourne",16,9,105,"Collingwood",8,11,59,"M.C.G.",46,1950,"Regular",8,"Home","Melbourne","Collingwood",46
4918,1950-06-12,"R8","St Kilda",14,17,101,"Fitzroy",14,12,96,"Junction Oval",5,1950,"Regular",8,"Home","St Kilda","Fitzroy",5
4919,1950-06-12,"R8","North Melbourne",10,17,77,"Geelong",8,12,60,"Arden St",17,1950,"Regular",8,"Home","North Melbourne","Geelong",17
4920,1950-06-17,"R9","Geelong",13,20,98,"Carlton",15,9,99,"Kardinia Park",-1,1950,"Regular",9,"Away","Carlton","Geelong",1
4921,1950-06-17,"R9","Collingwood",9,12,66,"North Melbourne",14,14,98,"Victoria Park",-32,1950,"Regular",9,"Away","North Melbourne","Collingwood",32
4922,1950-06-17,"R9","Essendon",22,15,147,"Hawthorn",9,7,61,"Windy Hill",86,1950,"Regular",9,"Home","Essendon","Hawthorn",86
4923,1950-06-17,"R9","Fitzroy",11,18,84,"Footscray",6,15,51,"Brunswick St",33,1950,"Regular",9,"Home","Fitzroy","Footscray",33
4924,1950-06-17,"R9","Sydney",8,12,60,"Melbourne",13,16,94,"Lake Oval",-34,1950,"Regular",9,"Away","Melbourne","Sydney",34
4925,1950-06-17,"R9","Richmond",14,13,97,"St Kilda",10,11,71,"Punt Rd",26,1950,"Regular",9,"Home","Richmond","St Kilda",26
4926,1950-06-24,"R10","Hawthorn",16,15,111,"Carlton",16,20,116,"Glenferrie Oval",-5,1950,"Regular",10,"Away","Carlton","Hawthorn",5
4927,1950-06-24,"R10","Collingwood",15,12,102,"St Kilda",9,14,68,"Victoria Park",34,1950,"Regular",10,"Home","Collingwood","St Kilda",34
4928,1950-06-24,"R10","Melbourne",8,15,63,"Essendon",10,12,72,"M.C.G.",-9,1950,"Regular",10,"Away","Essendon","Melbourne",9
4929,1950-06-24,"R10","Fitzroy",7,11,53,"Geelong",9,19,73,"Brunswick St",-20,1950,"Regular",10,"Away","Geelong","Fitzroy",20
4930,1950-06-24,"R10","Footscray",13,12,90,"North Melbourne",12,22,94,"Western Oval",-4,1950,"Regular",10,"Away","North Melbourne","Footscray",4
4931,1950-06-24,"R10","Sydney",14,17,101,"Richmond",13,8,86,"Lake Oval",15,1950,"Regular",10,"Home","Sydney","Richmond",15
4932,1950-07-01,"R11","Carlton",10,13,73,"Fitzroy",15,8,98,"Princes Park",-25,1950,"Regular",11,"Away","Fitzroy","Carlton",25
4933,1950-07-01,"R11","Essendon",12,18,90,"Collingwood",6,12,48,"Windy Hill",42,1950,"Regular",11,"Home","Essendon","Collingwood",42
4934,1950-07-01,"R11","Richmond",15,18,108,"Footscray",8,14,62,"Punt Rd",46,1950,"Regular",11,"Home","Richmond","Footscray",46
4935,1950-07-01,"R11","Geelong",19,21,135,"Sydney",8,7,55,"Kardinia Park",80,1950,"Regular",11,"Home","Geelong","Sydney",80
4936,1950-07-01,"R11","North Melbourne",14,16,100,"Hawthorn",2,13,25,"Arden St",75,1950,"Regular",11,"Home","North Melbourne","Hawthorn",75
4937,1950-07-01,"R11","St Kilda",6,17,53,"Melbourne",9,13,67,"Junction Oval",-14,1950,"Regular",11,"Away","Melbourne","St Kilda",14
4938,1950-07-08,"R12","Carlton",8,15,63,"Melbourne",10,14,74,"Princes Park",-11,1950,"Regular",12,"Away","Melbourne","Carlton",11
4939,1950-07-08,"R12","Collingwood",16,21,117,"Sydney",9,20,74,"Victoria Park",43,1950,"Regular",12,"Home","Collingwood","Sydney",43
4940,1950-07-08,"R12","Essendon",12,17,89,"Fitzroy",9,7,61,"Windy Hill",28,1950,"Regular",12,"Home","Essendon","Fitzroy",28
4941,1950-07-08,"R12","St Kilda",8,11,59,"Footscray",11,10,76,"Junction Oval",-17,1950,"Regular",12,"Away","Footscray","St Kilda",17
4942,1950-07-08,"R12","Geelong",16,15,111,"Hawthorn",4,12,36,"Kardinia Park",75,1950,"Regular",12,"Home","Geelong","Hawthorn",75
4943,1950-07-08,"R12","Richmond",10,10,70,"North Melbourne",8,9,57,"Punt Rd",13,1950,"Regular",12,"Home","Richmond","North Melbourne",13
4944,1950-07-15,"R13","North Melbourne",12,18,90,"Carlton",11,14,80,"Arden St",10,1950,"Regular",13,"Home","North Melbourne","Carlton",10
4945,1950-07-15,"R13","Fitzroy",16,12,108,"Collingwood",12,13,85,"Brunswick St",23,1950,"Regular",13,"Home","Fitzroy","Collingwood",23
4946,1950-07-15,"R13","Sydney",8,9,57,"Essendon",22,17,149,"Lake Oval",-92,1950,"Regular",13,"Away","Essendon","Sydney",92
4947,1950-07-15,"R13","Footscray",11,10,76,"Geelong",10,19,79,"Western Oval",-3,1950,"Regular",13,"Away","Geelong","Footscray",3
4948,1950-07-15,"R13","Hawthorn",10,11,71,"St Kilda",12,12,84,"Glenferrie Oval",-13,1950,"Regular",13,"Away","St Kilda","Hawthorn",13
4949,1950-07-15,"R13","Melbourne",13,16,94,"Richmond",9,10,64,"M.C.G.",30,1950,"Regular",13,"Home","Melbourne","Richmond",30
4950,1950-07-22,"R14","Essendon",8,14,62,"Geelong",6,9,45,"Windy Hill",17,1950,"Regular",14,"Home","Essendon","Geelong",17
4951,1950-07-22,"R14","Fitzroy",6,10,46,"Richmond",5,6,36,"Brunswick St",10,1950,"Regular",14,"Home","Fitzroy","Richmond",10
4952,1950-07-22,"R14","Melbourne",4,8,32,"North Melbourne",7,13,55,"M.C.G.",-23,1950,"Regular",14,"Away","North Melbourne","Melbourne",23
4953,1950-07-29,"R14","Carlton",12,7,79,"Collingwood",17,14,116,"Princes Park",-37,1950,"Regular",14,"Away","Collingwood","Carlton",37
4954,1950-07-29,"R14","Hawthorn",11,12,78,"Footscray",11,14,80,"Glenferrie Oval",-2,1950,"Regular",14,"Away","Footscray","Hawthorn",2
4955,1950-07-29,"R14","St Kilda",10,18,78,"Sydney",13,10,88,"Junction Oval",-10,1950,"Regular",14,"Away","Sydney","St Kilda",10
4956,1950-08-05,"R15","Richmond",14,20,104,"Carlton",9,16,70,"Punt Rd",34,1950,"Regular",15,"Home","Richmond","Carlton",34
4957,1950-08-05,"R15","Collingwood",16,21,117,"Hawthorn",2,8,20,"Victoria Park",97,1950,"Regular",15,"Home","Collingwood","Hawthorn",97
4958,1950-08-05,"R15","Footscray",10,9,69,"Essendon",10,11,71,"Western Oval",-2,1950,"Regular",15,"Away","Essendon","Footscray",2
4959,1950-08-05,"R15","Sydney",11,8,74,"Fitzroy",11,11,77,"Lake Oval",-3,1950,"Regular",15,"Away","Fitzroy","Sydney",3
4960,1950-08-05,"R15","Geelong",13,14,92,"Melbourne",9,12,66,"Kardinia Park",26,1950,"Regular",15,"Home","Geelong","Melbourne",26
4961,1950-08-05,"R15","North Melbourne",15,14,104,"St Kilda",7,5,47,"Arden St",57,1950,"Regular",15,"Home","North Melbourne","St Kilda",57
4962,1950-08-12,"R16","Carlton",12,11,83,"St Kilda",11,17,83,"Princes Park",0,1950,"Regular",16,"Home","Carlton","St Kilda",0
4963,1950-08-12,"R16","Collingwood",10,15,75,"Geelong",11,15,81,"Victoria Park",-6,1950,"Regular",16,"Away","Geelong","Collingwood",6
4964,1950-08-12,"R16","Essendon",20,15,135,"Richmond",11,12,78,"Windy Hill",57,1950,"Regular",16,"Home","Essendon","Richmond",57
4965,1950-08-12,"R16","Hawthorn",11,14,80,"Fitzroy",23,16,154,"Glenferrie Oval",-74,1950,"Regular",16,"Away","Fitzroy","Hawthorn",74
4966,1950-08-12,"R16","Melbourne",15,11,101,"Footscray",14,14,98,"M.C.G.",3,1950,"Regular",16,"Home","Melbourne","Footscray",3
4967,1950-08-12,"R16","Sydney",13,11,89,"North Melbourne",21,14,140,"Lake Oval",-51,1950,"Regular",16,"Away","North Melbourne","Sydney",51
4968,1950-08-19,"R17","Footscray",13,14,92,"Carlton",12,7,79,"Western Oval",13,1950,"Regular",17,"Home","Footscray","Carlton",13
4969,1950-08-19,"R17","Richmond",15,19,109,"Collingwood",15,10,100,"Punt Rd",9,1950,"Regular",17,"Home","Richmond","Collingwood",9
4970,1950-08-19,"R17","Essendon",15,12,102,"North Melbourne",13,16,94,"Windy Hill",8,1950,"Regular",17,"Home","Essendon","North Melbourne",8
4971,1950-08-19,"R17","Fitzroy",7,10,52,"Melbourne",6,11,47,"Brunswick St",5,1950,"Regular",17,"Home","Fitzroy","Melbourne",5
4972,1950-08-19,"R17","St Kilda",8,6,54,"Geelong",6,12,48,"Junction Oval",6,1950,"Regular",17,"Home","St Kilda","Geelong",6
4973,1950-08-19,"R17","Hawthorn",14,10,94,"Sydney",16,7,103,"Glenferrie Oval",-9,1950,"Regular",17,"Away","Sydney","Hawthorn",9
4974,1950-08-26,"R18","Carlton",13,4,82,"Sydney",10,10,70,"Princes Park",12,1950,"Regular",18,"Home","Carlton","Sydney",12
4975,1950-08-26,"R18","Collingwood",9,10,64,"Footscray",8,14,62,"Victoria Park",2,1950,"Regular",18,"Home","Collingwood","Footscray",2
4976,1950-08-26,"R18","St Kilda",8,7,55,"Essendon",21,10,136,"Junction Oval",-81,1950,"Regular",18,"Away","Essendon","St Kilda",81
4977,1950-08-26,"R18","North Melbourne",9,12,66,"Fitzroy",13,12,90,"Arden St",-24,1950,"Regular",18,"Away","Fitzroy","North Melbourne",24
4978,1950-08-26,"R18","Geelong",10,14,74,"Richmond",12,14,86,"Kardinia Park",-12,1950,"Regular",18,"Away","Richmond","Geelong",12
4979,1950-08-26,"R18","Melbourne",23,18,156,"Hawthorn",9,6,60,"M.C.G.",96,1950,"Regular",18,"Home","Melbourne","Hawthorn",96
4980,1950-09-02,"SF","Melbourne",6,8,44,"Geelong",13,10,88,"M.C.G.",-44,1950,"Finals",19,"Away","Geelong","Melbourne",44
4981,1950-09-09,"SF","Essendon",11,14,80,"North Melbourne",11,11,77,"M.C.G.",3,1950,"Finals",19,"Home","Essendon","North Melbourne",3
4982,1950-09-16,"PF","North Melbourne",14,16,100,"Geelong",12,11,83,"M.C.G.",17,1950,"Finals",20,"Home","North Melbourne","Geelong",17
4983,1950-09-23,"GF","Essendon",13,14,92,"North Melbourne",7,12,54,"M.C.G.",38,1950,"Finals",21,"Home","Essendon","North Melbourne",38
4984,1951-04-21,"R1","Carlton",13,9,87,"Hawthorn",7,15,57,"Princes Park",30,1951,"Regular",1,"Home","Carlton","Hawthorn",30
4985,1951-04-21,"R1","Collingwood",20,21,141,"North Melbourne",7,6,48,"Victoria Park",93,1951,"Regular",1,"Home","Collingwood","North Melbourne",93
4986,1951-04-21,"R1","Essendon",13,8,86,"Melbourne",10,16,76,"Windy Hill",10,1951,"Regular",1,"Home","Essendon","Melbourne",10
4987,1951-04-21,"R1","St Kilda",10,18,78,"Fitzroy",16,12,108,"Junction Oval",-30,1951,"Regular",1,"Away","Fitzroy","St Kilda",30
4988,1951-04-21,"R1","Richmond",15,9,99,"Footscray",15,10,100,"Punt Rd",-1,1951,"Regular",1,"Away","Footscray","Richmond",1
4989,1951-04-21,"R1","Geelong",13,17,95,"Sydney",6,5,41,"Kardinia Park",54,1951,"Regular",1,"Home","Geelong","Sydney",54
4990,1951-04-28,"R2","Footscray",5,11,41,"Carlton",4,16,40,"Western Oval",1,1951,"Regular",2,"Home","Footscray","Carlton",1
4991,1951-04-28,"R2","Melbourne",7,15,57,"Collingwood",15,16,106,"M.C.G.",-49,1951,"Regular",2,"Away","Collingwood","Melbourne",49
4992,1951-04-28,"R2","Hawthorn",9,7,61,"Essendon",12,14,86,"Glenferrie Oval",-25,1951,"Regular",2,"Away","Essendon","Hawthorn",25
4993,1951-04-28,"R2","Fitzroy",12,11,83,"Geelong",10,7,67,"Brunswick St",16,1951,"Regular",2,"Home","Fitzroy","Geelong",16
4994,1951-04-28,"R2","North Melbourne",8,14,62,"St Kilda",12,9,81,"Arden St",-19,1951,"Regular",2,"Away","St Kilda","North Melbourne",19
4995,1951-04-28,"R2","Sydney",5,7,37,"Richmond",14,13,97,"Lake Oval",-60,1951,"Regular",2,"Away","Richmond","Sydney",60
4996,1951-05-05,"R3","Carlton",12,12,84,"Richmond",16,12,108,"Princes Park",-24,1951,"Regular",3,"Away","Richmond","Carlton",24
4997,1951-05-05,"R3","Collingwood",14,18,102,"Geelong",7,8,50,"Victoria Park",52,1951,"Regular",3,"Home","Collingwood","Geelong",52
4998,1951-05-05,"R3","Sydney",14,20,104,"Essendon",14,7,91,"Lake Oval",13,1951,"Regular",3,"Home","Sydney","Essendon",13
4999,1951-05-05,"R3","Melbourne",8,12,60,"Fitzroy",12,12,84,"M.C.G.",-24,1951,"Regular",3,"Away","Fitzroy","Melbourne",24
5000,1951-05-05,"R3","Footscray",10,9,69,"North Melbourne",5,13,43,"Western Oval",26,1951,"Regular",3,"Home","Footscray","North Melbourne",26
5001,1951-05-05,"R3","Hawthorn",12,15,87,"St Kilda",9,10,64,"Glenferrie Oval",23,1951,"Regular",3,"Home","Hawthorn","St Kilda",23
5002,1951-05-12,"R4","Geelong",14,7,91,"Carlton",9,13,67,"Kardinia Park",24,1951,"Regular",4,"Home","Geelong","Carlton",24
5003,1951-05-12,"R4","Essendon",12,11,83,"Collingwood",5,14,44,"Windy Hill",39,1951,"Regular",4,"Home","Essendon","Collingwood",39
5004,1951-05-12,"R4","Fitzroy",10,10,70,"Footscray",6,16,52,"Brunswick St",18,1951,"Regular",4,"Home","Fitzroy","Footscray",18
5005,1951-05-12,"R4","Richmond",17,18,120,"Hawthorn",7,14,56,"Punt Rd",64,1951,"Regular",4,"Home","Richmond","Hawthorn",64
5006,1951-05-12,"R4","St Kilda",15,8,98,"Melbourne",14,7,91,"Junction Oval",7,1951,"Regular",4,"Home","St Kilda","Melbourne",7
5007,1951-05-12,"R4","North Melbourne",12,6,78,"Sydney",9,19,73,"Arden St",5,1951,"Regular",4,"Home","North Melbourne","Sydney",5
5008,1951-05-19,"R5","Carlton",19,15,129,"Fitzroy",10,12,72,"Princes Park",57,1951,"Regular",5,"Home","Carlton","Fitzroy",57
5009,1951-05-19,"R5","Richmond",16,20,116,"Collingwood",9,11,65,"Punt Rd",51,1951,"Regular",5,"Home","Richmond","Collingwood",51
5010,1951-05-19,"R5","Geelong",14,12,96,"Essendon",10,8,68,"Kardinia Park",28,1951,"Regular",5,"Home","Geelong","Essendon",28
5011,1951-05-19,"R5","Footscray",11,15,81,"St Kilda",7,11,53,"Western Oval",28,1951,"Regular",5,"Home","Footscray","St Kilda",28
5012,1951-05-19,"R5","Hawthorn",7,18,60,"North Melbourne",14,14,98,"Glenferrie Oval",-38,1951,"Regular",5,"Away","North Melbourne","Hawthorn",38
5013,1951-05-19,"R5","Sydney",15,6,96,"Melbourne",11,12,78,"Lake Oval",18,1951,"Regular",5,"Home","Sydney","Melbourne",18
5014,1951-06-02,"R6","Melbourne",11,12,78,"Carlton",8,10,58,"M.C.G.",20,1951,"Regular",6,"Home","Melbourne","Carlton",20
5015,1951-06-02,"R6","Collingwood",13,15,93,"Sydney",6,10,46,"Victoria Park",47,1951,"Regular",6,"Home","Collingwood","Sydney",47
5016,1951-06-02,"R6","Fitzroy",14,7,91,"Essendon",9,14,68,"Brunswick St",23,1951,"Regular",6,"Home","Fitzroy","Essendon",23
5017,1951-06-02,"R6","Hawthorn",9,16,70,"Footscray",7,17,59,"Glenferrie Oval",11,1951,"Regular",6,"Home","Hawthorn","Footscray",11
5018,1951-06-02,"R6","North Melbourne",11,8,74,"Geelong",12,16,88,"Arden St",-14,1951,"Regular",6,"Away","Geelong","North Melbourne",14
5019,1951-06-02,"R6","St Kilda",18,9,117,"Richmond",19,12,126,"Junction Oval",-9,1951,"Regular",6,"Away","Richmond","St Kilda",9
5020,1951-06-09,"R7","Essendon",11,9,75,"Carlton",13,12,90,"Windy Hill",-15,1951,"Regular",7,"Away","Carlton","Essendon",15
5021,1951-06-09,"R7","Collingwood",13,19,97,"St Kilda",11,12,78,"Victoria Park",19,1951,"Regular",7,"Home","Collingwood","St Kilda",19
5022,1951-06-09,"R7","Geelong",20,13,133,"Hawthorn",8,15,63,"Kardinia Park",70,1951,"Regular",7,"Home","Geelong","Hawthorn",70
5023,1951-06-11,"R7","Fitzroy",6,15,51,"North Melbourne",12,12,84,"Brunswick St",-33,1951,"Regular",7,"Away","North Melbourne","Fitzroy",33
5024,1951-06-11,"R7","Sydney",17,14,116,"Footscray",9,15,69,"Lake Oval",47,1951,"Regular",7,"Home","Sydney","Footscray",47
5025,1951-06-11,"R7","Melbourne",9,13,67,"Richmond",12,9,81,"M.C.G.",-14,1951,"Regular",7,"Away","Richmond","Melbourne",14
5026,1951-06-16,"R8","Carlton",7,11,53,"Collingwood",9,13,67,"Princes Park",-14,1951,"Regular",8,"Away","Collingwood","Carlton",14
5027,1951-06-16,"R8","Essendon",15,13,103,"St Kilda",12,7,79,"Windy Hill",24,1951,"Regular",8,"Home","Essendon","St Kilda",24
5028,1951-06-16,"R8","Richmond",9,12,66,"Fitzroy",12,16,88,"Punt Rd",-22,1951,"Regular",8,"Away","Fitzroy","Richmond",22
5029,1951-06-16,"R8","Footscray",9,5,59,"Geelong",11,11,77,"Western Oval",-18,1951,"Regular",8,"Away","Geelong","Footscray",18
5030,1951-06-16,"R8","Sydney",12,14,86,"Hawthorn",7,11,53,"Lake Oval",33,1951,"Regular",8,"Home","Sydney","Hawthorn",33
5031,1951-06-16,"R8","North Melbourne",14,9,93,"Melbourne",6,12,48,"Arden St",45,1951,"Regular",8,"Home","North Melbourne","Melbourne",45
5032,1951-06-23,"R9","St Kilda",9,11,65,"Carlton",15,15,105,"Junction Oval",-40,1951,"Regular",9,"Away","Carlton","St Kilda",40
5033,1951-06-23,"R9","Hawthorn",8,9,57,"Collingwood",13,7,85,"Glenferrie Oval",-28,1951,"Regular",9,"Away","Collingwood","Hawthorn",28
5034,1951-06-23,"R9","North Melbourne",8,11,59,"Essendon",13,13,91,"Arden St",-32,1951,"Regular",9,"Away","Essendon","North Melbourne",32
5035,1951-06-23,"R9","Fitzroy",12,13,85,"Sydney",12,13,85,"Brunswick St",0,1951,"Regular",9,"Home","Fitzroy","Sydney",0
5036,1951-06-23,"R9","Melbourne",5,19,49,"Footscray",23,14,152,"M.C.G.",-103,1951,"Regular",9,"Away","Footscray","Melbourne",103
5037,1951-06-23,"R9","Geelong",10,14,74,"Richmond",8,8,56,"Kardinia Park",18,1951,"Regular",9,"Home","Geelong","Richmond",18
5038,1951-06-30,"R10","Carlton",14,20,104,"North Melbourne",5,10,40,"Princes Park",64,1951,"Regular",10,"Home","Carlton","North Melbourne",64
5039,1951-06-30,"R10","Collingwood",10,12,72,"Footscray",12,5,77,"Victoria Park",-5,1951,"Regular",10,"Away","Footscray","Collingwood",5
5040,1951-06-30,"R10","St Kilda",7,7,49,"Sydney",13,15,93,"Junction Oval",-44,1951,"Regular",10,"Away","Sydney","St Kilda",44
5041,1951-07-07,"R10","Essendon",10,14,74,"Richmond",10,10,70,"Windy Hill",4,1951,"Regular",10,"Home","Essendon","Richmond",4
5042,1951-07-07,"R10","Fitzroy",10,14,74,"Hawthorn",11,9,75,"Brunswick St",-1,1951,"Regular",10,"Away","Hawthorn","Fitzroy",1
5043,1951-07-07,"R10","Melbourne",7,7,49,"Geelong",12,12,84,"M.C.G.",-35,1951,"Regular",10,"Away","Geelong","Melbourne",35
5044,1951-07-14,"R11","Sydney",7,9,51,"Carlton",7,14,56,"Lake Oval",-5,1951,"Regular",11,"Away","Carlton","Sydney",5
5045,1951-07-14,"R11","Collingwood",15,13,103,"Fitzroy",21,9,135,"Victoria Park",-32,1951,"Regular",11,"Away","Fitzroy","Collingwood",32
5046,1951-07-14,"R11","Footscray",7,14,56,"Essendon",9,10,64,"Western Oval",-8,1951,"Regular",11,"Away","Essendon","Footscray",8
5047,1951-07-14,"R11","Geelong",12,23,95,"St Kilda",10,7,67,"Kardinia Park",28,1951,"Regular",11,"Home","Geelong","St Kilda",28
5048,1951-07-14,"R11","Hawthorn",18,12,120,"Melbourne",13,8,86,"Glenferrie Oval",34,1951,"Regular",11,"Home","Hawthorn","Melbourne",34
5049,1951-07-14,"R11","Richmond",11,13,79,"North Melbourne",11,16,82,"Punt Rd",-3,1951,"Regular",11,"Away","North Melbourne","Richmond",3
5050,1951-07-21,"R12","Hawthorn",5,8,38,"Carlton",7,13,55,"Glenferrie Oval",-17,1951,"Regular",12,"Away","Carlton","Hawthorn",17
5051,1951-07-21,"R12","North Melbourne",6,12,48,"Collingwood",8,8,56,"Arden St",-8,1951,"Regular",12,"Away","Collingwood","North Melbourne",8
5052,1951-07-21,"R12","Melbourne",8,6,54,"Essendon",10,14,74,"M.C.G.",-20,1951,"Regular",12,"Away","Essendon","Melbourne",20
5053,1951-07-21,"R12","Fitzroy",11,10,76,"St Kilda",4,16,40,"Brunswick St",36,1951,"Regular",12,"Home","Fitzroy","St Kilda",36
5054,1951-07-21,"R12","Footscray",9,17,71,"Richmond",6,9,45,"Western Oval",26,1951,"Regular",12,"Home","Footscray","Richmond",26
5055,1951-07-21,"R12","Sydney",9,8,62,"Geelong",18,11,119,"Lake Oval",-57,1951,"Regular",12,"Away","Geelong","Sydney",57
5056,1951-07-28,"R13","Carlton",8,14,62,"Footscray",9,11,65,"Princes Park",-3,1951,"Regular",13,"Away","Footscray","Carlton",3
5057,1951-07-28,"R13","Collingwood",18,21,129,"Melbourne",12,10,82,"Victoria Park",47,1951,"Regular",13,"Home","Collingwood","Melbourne",47
5058,1951-07-28,"R13","Essendon",16,18,114,"Hawthorn",8,11,59,"Windy Hill",55,1951,"Regular",13,"Home","Essendon","Hawthorn",55
5059,1951-07-28,"R13","Geelong",11,10,76,"Fitzroy",4,5,29,"Kardinia Park",47,1951,"Regular",13,"Home","Geelong","Fitzroy",47
5060,1951-07-28,"R13","St Kilda",13,20,98,"North Melbourne",10,10,70,"Junction Oval",28,1951,"Regular",13,"Home","St Kilda","North Melbourne",28
5061,1951-07-28,"R13","Richmond",8,8,56,"Sydney",13,17,95,"Punt Rd",-39,1951,"Regular",13,"Away","Sydney","Richmond",39
5062,1951-08-04,"R14","Richmond",9,12,66,"Carlton",4,9,33,"Punt Rd",33,1951,"Regular",14,"Home","Richmond","Carlton",33
5063,1951-08-04,"R14","Geelong",3,11,29,"Collingwood",4,7,31,"Kardinia Park",-2,1951,"Regular",14,"Away","Collingwood","Geelong",2
5064,1951-08-04,"R14","Essendon",16,10,106,"Sydney",8,12,60,"Windy Hill",46,1951,"Regular",14,"Home","Essendon","Sydney",46
5065,1951-08-04,"R14","Fitzroy",8,21,69,"Melbourne",6,9,45,"Brunswick St",24,1951,"Regular",14,"Home","Fitzroy","Melbourne",24
5066,1951-08-04,"R14","North Melbourne",10,10,70,"Footscray",11,15,81,"Arden St",-11,1951,"Regular",14,"Away","Footscray","North Melbourne",11
5067,1951-08-04,"R14","St Kilda",11,8,74,"Hawthorn",9,14,68,"Junction Oval",6,1951,"Regular",14,"Home","St Kilda","Hawthorn",6
5068,1951-08-11,"R15","Carlton",7,19,61,"Geelong",12,11,83,"Princes Park",-22,1951,"Regular",15,"Away","Geelong","Carlton",22
5069,1951-08-11,"R15","Collingwood",12,9,81,"Essendon",5,7,37,"Victoria Park",44,1951,"Regular",15,"Home","Collingwood","Essendon",44
5070,1951-08-11,"R15","Footscray",4,6,30,"Fitzroy",8,9,57,"Western Oval",-27,1951,"Regular",15,"Away","Fitzroy","Footscray",27
5071,1951-08-11,"R15","Hawthorn",6,15,51,"Richmond",10,13,73,"Glenferrie Oval",-22,1951,"Regular",15,"Away","Richmond","Hawthorn",22
5072,1951-08-11,"R15","Melbourne",6,12,48,"St Kilda",9,6,60,"M.C.G.",-12,1951,"Regular",15,"Away","St Kilda","Melbourne",12
5073,1951-08-11,"R15","Sydney",14,16,100,"North Melbourne",15,9,99,"Lake Oval",1,1951,"Regular",15,"Home","Sydney","North Melbourne",1
5074,1951-08-18,"R16","Fitzroy",13,9,87,"Carlton",13,9,87,"Brunswick St",0,1951,"Regular",16,"Home","Fitzroy","Carlton",0
5075,1951-08-18,"R16","Collingwood",9,12,66,"Richmond",6,8,44,"Victoria Park",22,1951,"Regular",16,"Home","Collingwood","Richmond",22
5076,1951-08-18,"R16","Essendon",18,15,123,"Geelong",8,17,65,"Windy Hill",58,1951,"Regular",16,"Home","Essendon","Geelong",58
5077,1951-08-18,"R16","St Kilda",9,12,66,"Footscray",11,15,81,"Junction Oval",-15,1951,"Regular",16,"Away","Footscray","St Kilda",15
5078,1951-08-18,"R16","North Melbourne",10,11,71,"Hawthorn",8,11,59,"Arden St",12,1951,"Regular",16,"Home","North Melbourne","Hawthorn",12
5079,1951-08-18,"R16","Melbourne",15,16,106,"Sydney",18,17,125,"M.C.G.",-19,1951,"Regular",16,"Away","Sydney","Melbourne",19
5080,1951-08-25,"R17","Carlton",15,16,106,"Melbourne",8,13,61,"Princes Park",45,1951,"Regular",17,"Home","Carlton","Melbourne",45
5081,1951-08-25,"R17","Sydney",12,9,81,"Collingwood",12,10,82,"Lake Oval",-1,1951,"Regular",17,"Away","Collingwood","Sydney",1
5082,1951-08-25,"R17","Essendon",11,13,79,"Fitzroy",7,11,53,"Windy Hill",26,1951,"Regular",17,"Home","Essendon","Fitzroy",26
5083,1951-08-25,"R17","Footscray",11,14,80,"Hawthorn",9,10,64,"Western Oval",16,1951,"Regular",17,"Home","Footscray","Hawthorn",16
5084,1951-08-25,"R17","Geelong",13,15,93,"North Melbourne",3,6,24,"Kardinia Park",69,1951,"Regular",17,"Home","Geelong","North Melbourne",69
5085,1951-08-25,"R17","Richmond",18,17,125,"St Kilda",10,12,72,"Punt Rd",53,1951,"Regular",17,"Home","Richmond","St Kilda",53
5086,1951-09-01,"R18","Carlton",9,10,64,"Essendon",16,12,108,"Princes Park",-44,1951,"Regular",18,"Away","Essendon","Carlton",44
5087,1951-09-01,"R18","St Kilda",9,18,72,"Collingwood",10,19,79,"Junction Oval",-7,1951,"Regular",18,"Away","Collingwood","St Kilda",7
5088,1951-09-01,"R18","North Melbourne",11,15,81,"Fitzroy",8,13,61,"Arden St",20,1951,"Regular",18,"Home","North Melbourne","Fitzroy",20
5089,1951-09-01,"R18","Footscray",13,15,93,"Sydney",6,12,48,"Western Oval",45,1951,"Regular",18,"Home","Footscray","Sydney",45
5090,1951-09-01,"R18","Hawthorn",5,8,38,"Geelong",10,10,70,"Glenferrie Oval",-32,1951,"Regular",18,"Away","Geelong","Hawthorn",32
5091,1951-09-01,"R18","Richmond",18,16,124,"Melbourne",14,11,95,"Punt Rd",29,1951,"Regular",18,"Home","Richmond","Melbourne",29
5092,1951-09-08,"SF","Essendon",8,13,61,"Footscray",8,5,53,"M.C.G.",8,1951,"Finals",19,"Home","Essendon","Footscray",8
5093,1951-09-15,"SF","Geelong",22,20,152,"Collingwood",10,10,70,"M.C.G.",82,1951,"Finals",19,"Home","Geelong","Collingwood",82
5094,1951-09-22,"PF","Collingwood",10,8,68,"Essendon",10,10,70,"M.C.G.",-2,1951,"Finals",20,"Away","Essendon","Collingwood",2
5095,1951-09-29,"GF","Geelong",11,15,81,"Essendon",10,10,70,"M.C.G.",11,1951,"Finals",21,"Home","Geelong","Essendon",11
5096,1952-04-19,"R1","North Melbourne",8,19,67,"Carlton",13,12,90,"Arden St",-23,1952,"Regular",1,"Away","Carlton","North Melbourne",23
5097,1952-04-19,"R1","Hawthorn",2,8,20,"Collingwood",15,16,106,"Glenferrie Oval",-86,1952,"Regular",1,"Away","Collingwood","Hawthorn",86
5098,1952-04-19,"R1","Footscray",6,10,46,"Essendon",6,5,41,"Western Oval",5,1952,"Regular",1,"Home","Footscray","Essendon",5
5099,1952-04-19,"R1","Fitzroy",5,15,45,"Richmond",7,12,54,"Brunswick St",-9,1952,"Regular",1,"Away","Richmond","Fitzroy",9
5100,1952-04-19,"R1","Melbourne",14,13,97,"Geelong",15,13,103,"M.C.G.",-6,1952,"Regular",1,"Away","Geelong","Melbourne",6
5101,1952-04-19,"R1","Sydney",11,16,82,"St Kilda",8,26,74,"Lake Oval",8,1952,"Regular",1,"Home","Sydney","St Kilda",8
5102,1952-04-26,"R2","Carlton",12,12,84,"Sydney",13,11,89,"Princes Park",-5,1952,"Regular",2,"Away","Sydney","Carlton",5
5103,1952-04-26,"R2","Collingwood",13,17,95,"Fitzroy",8,14,62,"Victoria Park",33,1952,"Regular",2,"Home","Collingwood","Fitzroy",33
5104,1952-04-26,"R2","Essendon",14,12,96,"North Melbourne",13,11,89,"Windy Hill",7,1952,"Regular",2,"Home","Essendon","North Melbourne",7
5105,1952-04-26,"R2","Geelong",10,4,64,"Footscray",7,15,57,"Kardinia Park",7,1952,"Regular",2,"Home","Geelong","Footscray",7
5106,1952-04-26,"R2","Richmond",12,10,82,"Hawthorn",8,14,62,"Punt Rd",20,1952,"Regular",2,"Home","Richmond","Hawthorn",20
5107,1952-04-26,"R2","St Kilda",13,11,89,"Melbourne",12,19,91,"Junction Oval",-2,1952,"Regular",2,"Away","Melbourne","St Kilda",2
5108,1952-05-03,"R3","Carlton",10,12,72,"Fitzroy",13,14,92,"Princes Park",-20,1952,"Regular",3,"Away","Fitzroy","Carlton",20
5109,1952-05-03,"R3","Collingwood",9,21,75,"Essendon",7,9,51,"Victoria Park",24,1952,"Regular",3,"Home","Collingwood","Essendon",24
5110,1952-05-03,"R3","North Melbourne",11,11,77,"Footscray",10,6,66,"Arden St",11,1952,"Regular",3,"Home","North Melbourne","Footscray",11
5111,1952-05-03,"R3","Geelong",14,15,99,"St Kilda",5,4,34,"Kardinia Park",65,1952,"Regular",3,"Home","Geelong","St Kilda",65
5112,1952-05-03,"R3","Melbourne",8,12,60,"Hawthorn",10,14,74,"M.C.G.",-14,1952,"Regular",3,"Away","Hawthorn","Melbourne",14
5113,1952-05-03,"R3","Sydney",14,17,101,"Richmond",12,9,81,"Lake Oval",20,1952,"Regular",3,"Home","Sydney","Richmond",20
5114,1952-05-10,"R4","Essendon",13,9,87,"Carlton",13,16,94,"Windy Hill",-7,1952,"Regular",4,"Away","Carlton","Essendon",7
5115,1952-05-10,"R4","St Kilda",8,16,64,"Collingwood",12,12,84,"Junction Oval",-20,1952,"Regular",4,"Away","Collingwood","St Kilda",20
5116,1952-05-10,"R4","Fitzroy",6,15,51,"Geelong",14,16,100,"Brunswick St",-49,1952,"Regular",4,"Away","Geelong","Fitzroy",49
5117,1952-05-10,"R4","Footscray",6,16,52,"Melbourne",10,16,76,"Western Oval",-24,1952,"Regular",4,"Away","Melbourne","Footscray",24
5118,1952-05-10,"R4","Hawthorn",11,3,69,"Sydney",8,12,60,"Glenferrie Oval",9,1952,"Regular",4,"Home","Hawthorn","Sydney",9
5119,1952-05-10,"R4","Richmond",18,13,121,"North Melbourne",16,15,111,"Punt Rd",10,1952,"Regular",4,"Home","Richmond","North Melbourne",10
5120,1952-05-17,"R5","Collingwood",15,16,106,"Carlton",7,14,56,"Victoria Park",50,1952,"Regular",5,"Home","Collingwood","Carlton",50
5121,1952-05-17,"R5","St Kilda",11,10,76,"Essendon",18,8,116,"Junction Oval",-40,1952,"Regular",5,"Away","Essendon","St Kilda",40
5122,1952-05-17,"R5","Fitzroy",6,6,42,"Hawthorn",5,11,41,"Brunswick St",1,1952,"Regular",5,"Home","Fitzroy","Hawthorn",1
5123,1952-05-17,"R5","Footscray",9,6,60,"Richmond",5,6,36,"Western Oval",24,1952,"Regular",5,"Home","Footscray","Richmond",24
5124,1952-05-17,"R5","Geelong",11,16,82,"North Melbourne",6,10,46,"Kardinia Park",36,1952,"Regular",5,"Home","Geelong","North Melbourne",36
5125,1952-05-17,"R5","Melbourne",8,9,57,"Sydney",10,11,71,"M.C.G.",-14,1952,"Regular",5,"Away","Sydney","Melbourne",14
5126,1952-05-31,"R6","Carlton",14,10,94,"St Kilda",10,13,73,"Princes Park",21,1952,"Regular",6,"Home","Carlton","St Kilda",21
5127,1952-05-31,"R6","Collingwood",12,19,91,"Footscray",4,5,29,"Victoria Park",62,1952,"Regular",6,"Home","Collingwood","Footscray",62
5128,1952-05-31,"R6","Hawthorn",5,14,44,"Essendon",15,8,98,"Glenferrie Oval",-54,1952,"Regular",6,"Away","Essendon","Hawthorn",54
5129,1952-05-31,"R6","Sydney",14,12,96,"Fitzroy",9,11,65,"Lake Oval",31,1952,"Regular",6,"Home","Sydney","Fitzroy",31
5130,1952-05-31,"R6","Richmond",8,7,55,"Geelong",11,13,79,"Punt Rd",-24,1952,"Regular",6,"Away","Geelong","Richmond",24
5131,1952-05-31,"R6","North Melbourne",6,13,49,"Melbourne",9,9,63,"Arden St",-14,1952,"Regular",6,"Away","Melbourne","North Melbourne",14
5132,1952-06-07,"R7","Melbourne",12,10,82,"Collingwood",6,14,50,"M.C.G.",32,1952,"Regular",7,"Home","Melbourne","Collingwood",32
5133,1952-06-07,"R7","Fitzroy",8,15,63,"St Kilda",3,6,24,"Brunswick St",39,1952,"Regular",7,"Home","Fitzroy","St Kilda",39
5134,1952-06-07,"R7","North Melbourne",12,8,80,"Hawthorn",7,8,50,"Arden St",30,1952,"Regular",7,"Home","North Melbourne","Hawthorn",30
5135,1952-06-09,"R7","Carlton",18,12,120,"Geelong",13,15,93,"Princes Park",27,1952,"Regular",7,"Home","Carlton","Geelong",27
5136,1952-06-09,"R7","Essendon",7,18,60,"Richmond",10,9,69,"Windy Hill",-9,1952,"Regular",7,"Away","Richmond","Essendon",9
5137,1952-06-09,"R7","Sydney",16,14,110,"Footscray",11,13,79,"Lake Oval",31,1952,"Regular",7,"Home","Sydney","Footscray",31
5138,1952-06-14,"R8","Carlton",17,15,117,"Hawthorn",11,14,80,"Euroa",37,1952,"Regular",8,"Home","Carlton","Hawthorn",37
5139,1952-06-14,"R8","Richmond",5,6,36,"Collingwood",10,12,72,"S.C.G.",-36,1952,"Regular",8,"Away","Collingwood","Richmond",36
5140,1952-06-14,"R8","Fitzroy",13,12,90,"Melbourne",10,10,70,"North Hobart",20,1952,"Regular",8,"Home","Fitzroy","Melbourne",20
5141,1952-06-14,"R8","Footscray",5,4,34,"St Kilda",7,7,49,"Yallourn",-15,1952,"Regular",8,"Away","St Kilda","Footscray",15
5142,1952-06-14,"R8","Sydney",18,10,118,"North Melbourne",14,12,96,"Albury",22,1952,"Regular",8,"Home","Sydney","North Melbourne",22
5143,1952-06-16,"R8","Geelong",12,14,86,"Essendon",23,17,155,"Brisbane Exhibition",-69,1952,"Regular",8,"Away","Essendon","Geelong",69
5144,1952-06-21,"R9","Richmond",5,3,33,"Carlton",5,9,39,"Punt Rd",-6,1952,"Regular",9,"Away","Carlton","Richmond",6
5145,1952-06-21,"R9","Collingwood",6,8,44,"North Melbourne",8,12,60,"Victoria Park",-16,1952,"Regular",9,"Away","North Melbourne","Collingwood",16
5146,1952-06-21,"R9","Essendon",11,8,74,"Melbourne",10,15,75,"Windy Hill",-1,1952,"Regular",9,"Away","Melbourne","Essendon",1
5147,1952-06-21,"R9","Footscray",6,9,45,"Fitzroy",7,8,50,"Western Oval",-5,1952,"Regular",9,"Away","Fitzroy","Footscray",5
5148,1952-06-21,"R9","Geelong",7,13,55,"Sydney",4,11,35,"Kardinia Park",20,1952,"Regular",9,"Home","Geelong","Sydney",20
5149,1952-06-21,"R9","St Kilda",5,11,41,"Hawthorn",7,6,48,"Junction Oval",-7,1952,"Regular",9,"Away","Hawthorn","St Kilda",7
5150,1952-06-28,"R10","Carlton",15,22,112,"Footscray",8,9,57,"Princes Park",55,1952,"Regular",10,"Home","Carlton","Footscray",55
5151,1952-06-28,"R10","Sydney",9,10,64,"Collingwood",12,13,85,"Lake Oval",-21,1952,"Regular",10,"Away","Collingwood","Sydney",21
5152,1952-06-28,"R10","Fitzroy",13,12,90,"Essendon",5,8,38,"Brunswick St",52,1952,"Regular",10,"Home","Fitzroy","Essendon",52
5153,1952-06-28,"R10","Hawthorn",6,8,44,"Geelong",10,10,70,"Glenferrie Oval",-26,1952,"Regular",10,"Away","Geelong","Hawthorn",26
5154,1952-06-28,"R10","Melbourne",12,11,83,"Richmond",6,10,46,"M.C.G.",37,1952,"Regular",10,"Home","Melbourne","Richmond",37
5155,1952-06-28,"R10","North Melbourne",9,10,64,"St Kilda",5,9,39,"Arden St",25,1952,"Regular",10,"Home","North Melbourne","St Kilda",25
5156,1952-07-05,"R11","Hawthorn",5,11,41,"Carlton",9,24,78,"Glenferrie Oval",-37,1952,"Regular",11,"Away","Carlton","Hawthorn",37
5157,1952-07-05,"R11","Collingwood",10,19,79,"Richmond",8,8,56,"Victoria Park",23,1952,"Regular",11,"Home","Collingwood","Richmond",23
5158,1952-07-05,"R11","Essendon",10,16,76,"Geelong",11,10,76,"Windy Hill",0,1952,"Regular",11,"Home","Essendon","Geelong",0
5159,1952-07-05,"R11","Melbourne",11,7,73,"Fitzroy",11,17,83,"M.C.G.",-10,1952,"Regular",11,"Away","Fitzroy","Melbourne",10
5160,1952-07-05,"R11","St Kilda",11,13,79,"Footscray",12,13,85,"Junction Oval",-6,1952,"Regular",11,"Away","Footscray","St Kilda",6
5161,1952-07-05,"R11","North Melbourne",7,4,46,"Sydney",10,17,77,"Arden St",-31,1952,"Regular",11,"Away","Sydney","North Melbourne",31
5162,1952-07-12,"R12","Carlton",6,14,50,"Melbourne",6,14,50,"Princes Park",0,1952,"Regular",12,"Home","Carlton","Melbourne",0
5163,1952-07-12,"R12","Geelong",9,8,62,"Collingwood",4,9,33,"Kardinia Park",29,1952,"Regular",12,"Home","Geelong","Collingwood",29
5164,1952-07-12,"R12","Sydney",8,12,60,"Essendon",9,15,69,"Lake Oval",-9,1952,"Regular",12,"Away","Essendon","Sydney",9
5165,1952-07-12,"R12","Fitzroy",13,11,89,"North Melbourne",10,11,71,"Brunswick St",18,1952,"Regular",12,"Home","Fitzroy","North Melbourne",18
5166,1952-07-12,"R12","Footscray",4,11,35,"Hawthorn",9,4,58,"Western Oval",-23,1952,"Regular",12,"Away","Hawthorn","Footscray",23
5167,1952-07-12,"R12","Richmond",10,17,77,"St Kilda",6,8,44,"Punt Rd",33,1952,"Regular",12,"Home","Richmond","St Kilda",33
5168,1952-07-19,"R13","Carlton",5,23,53,"North Melbourne",5,8,38,"Princes Park",15,1952,"Regular",13,"Home","Carlton","North Melbourne",15
5169,1952-07-19,"R13","Collingwood",12,15,87,"Hawthorn",4,4,28,"Victoria Park",59,1952,"Regular",13,"Home","Collingwood","Hawthorn",59
5170,1952-07-19,"R13","Essendon",5,12,42,"Footscray",7,15,57,"Windy Hill",-15,1952,"Regular",13,"Away","Footscray","Essendon",15
5171,1952-07-19,"R13","Richmond",5,17,47,"Fitzroy",11,10,76,"Punt Rd",-29,1952,"Regular",13,"Away","Fitzroy","Richmond",29
5172,1952-07-19,"R13","Geelong",14,26,110,"Melbourne",8,6,54,"Kardinia Park",56,1952,"Regular",13,"Home","Geelong","Melbourne",56
5173,1952-07-19,"R13","St Kilda",5,8,38,"Sydney",6,8,44,"Junction Oval",-6,1952,"Regular",13,"Away","Sydney","St Kilda",6
5174,1952-07-26,"R14","Sydney",10,16,76,"Carlton",10,16,76,"Lake Oval",0,1952,"Regular",14,"Home","Sydney","Carlton",0
5175,1952-07-26,"R14","Fitzroy",5,6,36,"Collingwood",4,11,35,"Brunswick St",1,1952,"Regular",14,"Home","Fitzroy","Collingwood",1
5176,1952-07-26,"R14","North Melbourne",7,11,53,"Essendon",7,8,50,"Arden St",3,1952,"Regular",14,"Home","North Melbourne","Essendon",3
5177,1952-07-26,"R14","Footscray",8,9,57,"Geelong",9,12,66,"Western Oval",-9,1952,"Regular",14,"Away","Geelong","Footscray",9
5178,1952-07-26,"R14","Hawthorn",8,14,62,"Richmond",14,7,91,"Glenferrie Oval",-29,1952,"Regular",14,"Away","Richmond","Hawthorn",29
5179,1952-07-26,"R14","Melbourne",11,12,78,"St Kilda",8,10,58,"M.C.G.",20,1952,"Regular",14,"Home","Melbourne","St Kilda",20
5180,1952-08-02,"R15","Fitzroy",5,15,45,"Carlton",5,14,44,"Brunswick St",1,1952,"Regular",15,"Home","Fitzroy","Carlton",1
5181,1952-08-02,"R15","Essendon",13,10,88,"Collingwood",12,17,89,"Windy Hill",-1,1952,"Regular",15,"Away","Collingwood","Essendon",1
5182,1952-08-02,"R15","Footscray",7,6,48,"North Melbourne",8,9,57,"Western Oval",-9,1952,"Regular",15,"Away","North Melbourne","Footscray",9
5183,1952-08-02,"R15","St Kilda",7,13,55,"Geelong",9,16,70,"Junction Oval",-15,1952,"Regular",15,"Away","Geelong","St Kilda",15
5184,1952-08-02,"R15","Hawthorn",9,3,57,"Melbourne",12,13,85,"Glenferrie Oval",-28,1952,"Regular",15,"Away","Melbourne","Hawthorn",28
5185,1952-08-02,"R15","Richmond",10,14,74,"Sydney",12,14,86,"Punt Rd",-12,1952,"Regular",15,"Away","Sydney","Richmond",12
5186,1952-08-09,"R16","Carlton",11,16,82,"Essendon",12,11,83,"Princes Park",-1,1952,"Regular",16,"Away","Essendon","Carlton",1
5187,1952-08-09,"R16","Collingwood",20,19,139,"St Kilda",8,7,55,"Victoria Park",84,1952,"Regular",16,"Home","Collingwood","St Kilda",84
5188,1952-08-09,"R16","Geelong",12,16,88,"Fitzroy",5,10,40,"Kardinia Park",48,1952,"Regular",16,"Home","Geelong","Fitzroy",48
5189,1952-08-09,"R16","Melbourne",15,17,107,"Footscray",8,12,60,"M.C.G.",47,1952,"Regular",16,"Home","Melbourne","Footscray",47
5190,1952-08-09,"R16","Sydney",6,14,50,"Hawthorn",9,14,68,"Lake Oval",-18,1952,"Regular",16,"Away","Hawthorn","Sydney",18
5191,1952-08-09,"R16","North Melbourne",14,10,94,"Richmond",9,12,66,"Arden St",28,1952,"Regular",16,"Home","North Melbourne","Richmond",28
5192,1952-08-16,"R17","Carlton",12,16,88,"Collingwood",9,13,67,"Princes Park",21,1952,"Regular",17,"Home","Carlton","Collingwood",21
5193,1952-08-16,"R17","Essendon",22,15,147,"St Kilda",7,9,51,"Windy Hill",96,1952,"Regular",17,"Home","Essendon","St Kilda",96
5194,1952-08-16,"R17","Hawthorn",7,6,48,"Fitzroy",12,12,84,"Glenferrie Oval",-36,1952,"Regular",17,"Away","Fitzroy","Hawthorn",36
5195,1952-08-16,"R17","Richmond",13,11,89,"Footscray",5,14,44,"Punt Rd",45,1952,"Regular",17,"Home","Richmond","Footscray",45
5196,1952-08-16,"R17","North Melbourne",11,9,75,"Geelong",15,13,103,"Arden St",-28,1952,"Regular",17,"Away","Geelong","North Melbourne",28
5197,1952-08-16,"R17","Sydney",10,14,74,"Melbourne",8,18,66,"Lake Oval",8,1952,"Regular",17,"Home","Sydney","Melbourne",8
5198,1952-08-23,"R18","St Kilda",8,8,56,"Carlton",13,14,92,"Junction Oval",-36,1952,"Regular",18,"Away","Carlton","St Kilda",36
5199,1952-08-23,"R18","Footscray",6,14,50,"Collingwood",14,15,99,"Western Oval",-49,1952,"Regular",18,"Away","Collingwood","Footscray",49
5200,1952-08-23,"R18","Essendon",20,12,132,"Hawthorn",11,11,77,"Windy Hill",55,1952,"Regular",18,"Home","Essendon","Hawthorn",55
5201,1952-08-23,"R18","Fitzroy",9,10,64,"Sydney",7,15,57,"Brunswick St",7,1952,"Regular",18,"Home","Fitzroy","Sydney",7
5202,1952-08-23,"R18","Geelong",17,9,111,"Richmond",10,7,67,"Kardinia Park",44,1952,"Regular",18,"Home","Geelong","Richmond",44
5203,1952-08-23,"R18","Melbourne",11,16,82,"North Melbourne",15,7,97,"M.C.G.",-15,1952,"Regular",18,"Away","North Melbourne","Melbourne",15
5204,1952-08-30,"R19","Geelong",10,17,77,"Carlton",3,14,32,"Kardinia Park",45,1952,"Regular",19,"Home","Geelong","Carlton",45
5205,1952-08-30,"R19","Collingwood",13,14,92,"Melbourne",10,11,71,"Victoria Park",21,1952,"Regular",19,"Home","Collingwood","Melbourne",21
5206,1952-08-30,"R19","Richmond",15,11,101,"Essendon",11,10,76,"Punt Rd",25,1952,"Regular",19,"Home","Richmond","Essendon",25
5207,1952-08-30,"R19","St Kilda",10,12,72,"Fitzroy",8,18,66,"Junction Oval",6,1952,"Regular",19,"Home","St Kilda","Fitzroy",6
5208,1952-08-30,"R19","Footscray",13,13,91,"Sydney",8,13,61,"Western Oval",30,1952,"Regular",19,"Home","Footscray","Sydney",30
5209,1952-08-30,"R19","Hawthorn",8,11,59,"North Melbourne",12,10,82,"Glenferrie Oval",-23,1952,"Regular",19,"Away","North Melbourne","Hawthorn",23
5210,1952-09-06,"SF","Fitzroy",10,9,69,"Carlton",8,20,68,"M.C.G.",1,1952,"Finals",20,"Home","Fitzroy","Carlton",1
5211,1952-09-13,"SF","Geelong",14,16,100,"Collingwood",6,10,46,"M.C.G.",54,1952,"Finals",20,"Home","Geelong","Collingwood",54
5212,1952-09-20,"PF","Collingwood",11,15,81,"Fitzroy",9,8,62,"M.C.G.",19,1952,"Finals",21,"Home","Collingwood","Fitzroy",19
5213,1952-09-27,"GF","Geelong",13,8,86,"Collingwood",5,10,40,"M.C.G.",46,1952,"Finals",22,"Home","Geelong","Collingwood",46
5214,1953-04-18,"R1","Carlton",7,18,60,"Footscray",9,11,65,"Princes Park",-5,1953,"Regular",1,"Away","Footscray","Carlton",5
5215,1953-04-18,"R1","Collingwood",17,16,118,"Sydney",11,11,77,"Victoria Park",41,1953,"Regular",1,"Home","Collingwood","Sydney",41
5216,1953-04-18,"R1","Essendon",17,9,111,"Fitzroy",12,16,88,"Windy Hill",23,1953,"Regular",1,"Home","Essendon","Fitzroy",23
5217,1953-04-18,"R1","Geelong",12,15,87,"Hawthorn",5,8,38,"Kardinia Park",49,1953,"Regular",1,"Home","Geelong","Hawthorn",49
5218,1953-04-18,"R1","Richmond",11,7,73,"Melbourne",9,13,67,"Punt Rd",6,1953,"Regular",1,"Home","Richmond","Melbourne",6
5219,1953-04-18,"R1","St Kilda",8,9,57,"North Melbourne",14,21,105,"Junction Oval",-48,1953,"Regular",1,"Away","North Melbourne","St Kilda",48
5220,1953-05-02,"R2","Melbourne",8,11,59,"Carlton",13,12,90,"M.C.G.",-31,1953,"Regular",2,"Away","Carlton","Melbourne",31
5221,1953-05-02,"R2","North Melbourne",18,10,118,"Collingwood",11,9,75,"Arden St",43,1953,"Regular",2,"Home","North Melbourne","Collingwood",43
5222,1953-05-02,"R2","Sydney",13,21,99,"Essendon",13,11,89,"Lake Oval",10,1953,"Regular",2,"Home","Sydney","Essendon",10
5223,1953-05-02,"R2","Fitzroy",12,9,81,"Richmond",11,14,80,"Brunswick St",1,1953,"Regular",2,"Home","Fitzroy","Richmond",1
5224,1953-05-02,"R2","Footscray",8,13,61,"Geelong",15,12,102,"Western Oval",-41,1953,"Regular",2,"Away","Geelong","Footscray",41
5225,1953-05-02,"R2","Hawthorn",8,9,57,"St Kilda",13,14,92,"Glenferrie Oval",-35,1953,"Regular",2,"Away","St Kilda","Hawthorn",35
5226,1953-05-09,"R3","Richmond",15,8,98,"Carlton",16,8,104,"Punt Rd",-6,1953,"Regular",3,"Away","Carlton","Richmond",6
5227,1953-05-09,"R3","Collingwood",9,19,73,"Geelong",14,14,98,"Victoria Park",-25,1953,"Regular",3,"Away","Geelong","Collingwood",25
5228,1953-05-09,"R3","Essendon",17,20,122,"St Kilda",7,16,58,"Windy Hill",64,1953,"Regular",3,"Home","Essendon","St Kilda",64
5229,1953-05-09,"R3","Sydney",10,15,75,"Fitzroy",12,14,86,"Lake Oval",-11,1953,"Regular",3,"Away","Fitzroy","Sydney",11
5230,1953-05-09,"R3","Footscray",16,15,111,"Hawthorn",6,6,42,"Western Oval",69,1953,"Regular",3,"Home","Footscray","Hawthorn",69
5231,1953-05-09,"R3","North Melbourne",12,12,84,"Melbourne",11,17,83,"Arden St",1,1953,"Regular",3,"Home","North Melbourne","Melbourne",1
5232,1953-05-16,"R4","Carlton",14,11,95,"Collingwood",14,19,103,"Princes Park",-8,1953,"Regular",4,"Away","Collingwood","Carlton",8
5233,1953-05-16,"R4","Geelong",12,7,79,"Essendon",9,11,65,"Kardinia Park",14,1953,"Regular",4,"Home","Geelong","Essendon",14
5234,1953-05-16,"R4","Fitzroy",12,14,86,"North Melbourne",10,15,75,"Brunswick St",11,1953,"Regular",4,"Home","Fitzroy","North Melbourne",11
5235,1953-05-16,"R4","Melbourne",4,6,30,"Footscray",9,21,75,"M.C.G.",-45,1953,"Regular",4,"Away","Footscray","Melbourne",45
5236,1953-05-16,"R4","Hawthorn",7,11,53,"Sydney",9,9,63,"Glenferrie Oval",-10,1953,"Regular",4,"Away","Sydney","Hawthorn",10
5237,1953-05-16,"R4","St Kilda",11,17,83,"Richmond",8,17,65,"Junction Oval",18,1953,"Regular",4,"Home","St Kilda","Richmond",18
5238,1953-05-23,"R5","Carlton",7,10,52,"St Kilda",6,7,43,"Princes Park",9,1953,"Regular",5,"Home","Carlton","St Kilda",9
5239,1953-05-23,"R5","Collingwood",13,18,96,"Hawthorn",3,8,26,"Victoria Park",70,1953,"Regular",5,"Home","Collingwood","Hawthorn",70
5240,1953-05-23,"R5","Essendon",6,10,46,"Melbourne",9,3,57,"Windy Hill",-11,1953,"Regular",5,"Away","Melbourne","Essendon",11
5241,1953-05-23,"R5","Footscray",10,6,66,"Fitzroy",1,0,6,"Western Oval",60,1953,"Regular",5,"Home","Footscray","Fitzroy",60
5242,1953-05-23,"R5","Richmond",6,16,52,"Geelong",15,16,106,"Punt Rd",-54,1953,"Regular",5,"Away","Geelong","Richmond",54
5243,1953-05-23,"R5","Sydney",8,10,58,"North Melbourne",9,8,62,"Lake Oval",-4,1953,"Regular",5,"Away","North Melbourne","Sydney",4
5244,1953-05-30,"R6","Hawthorn",10,7,67,"Carlton",6,11,47,"Glenferrie Oval",20,1953,"Regular",6,"Home","Hawthorn","Carlton",20
5245,1953-05-30,"R6","Collingwood",9,8,62,"Richmond",5,9,39,"Victoria Park",23,1953,"Regular",6,"Home","Collingwood","Richmond",23
5246,1953-05-30,"R6","North Melbourne",7,9,51,"Essendon",9,14,68,"Arden St",-17,1953,"Regular",6,"Away","Essendon","North Melbourne",17
5247,1953-05-30,"R6","Melbourne",10,11,71,"Fitzroy",12,9,81,"M.C.G.",-10,1953,"Regular",6,"Away","Fitzroy","Melbourne",10
5248,1953-05-30,"R6","St Kilda",10,9,69,"Footscray",14,9,93,"Junction Oval",-24,1953,"Regular",6,"Away","Footscray","St Kilda",24
5249,1953-05-30,"R6","Geelong",14,16,100,"Sydney",7,5,47,"Kardinia Park",53,1953,"Regular",6,"Home","Geelong","Sydney",53
5250,1953-06-06,"R7","Carlton",14,16,100,"North Melbourne",7,6,48,"Princes Park",52,1953,"Regular",7,"Home","Carlton","North Melbourne",52
5251,1953-06-06,"R7","Footscray",7,9,51,"Collingwood",7,10,52,"Western Oval",-1,1953,"Regular",7,"Away","Collingwood","Footscray",1
5252,1953-06-06,"R7","Essendon",11,18,84,"Richmond",7,6,48,"Windy Hill",36,1953,"Regular",7,"Home","Essendon","Richmond",36
5253,1953-06-06,"R7","Fitzroy",8,12,60,"Hawthorn",5,14,44,"Brunswick St",16,1953,"Regular",7,"Home","Fitzroy","Hawthorn",16
5254,1953-06-06,"R7","Melbourne",8,10,58,"Geelong",11,16,82,"M.C.G.",-24,1953,"Regular",7,"Away","Geelong","Melbourne",24
5255,1953-06-06,"R7","St Kilda",7,11,53,"Sydney",18,16,124,"Junction Oval",-71,1953,"Regular",7,"Away","Sydney","St Kilda",71
5256,1953-06-13,"R8","Essendon",14,14,98,"Carlton",7,11,53,"Windy Hill",45,1953,"Regular",8,"Home","Essendon","Carlton",45
5257,1953-06-13,"R8","Collingwood",19,17,131,"St Kilda",8,8,56,"Victoria Park",75,1953,"Regular",8,"Home","Collingwood","St Kilda",75
5258,1953-06-13,"R8","Geelong",21,10,136,"Fitzroy",7,8,50,"Kardinia Park",86,1953,"Regular",8,"Home","Geelong","Fitzroy",86
5259,1953-06-13,"R8","Richmond",8,11,59,"Footscray",9,14,68,"Punt Rd",-9,1953,"Regular",8,"Away","Footscray","Richmond",9
5260,1953-06-13,"R8","Hawthorn",8,14,62,"North Melbourne",12,8,80,"Glenferrie Oval",-18,1953,"Regular",8,"Away","North Melbourne","Hawthorn",18
5261,1953-06-13,"R8","Sydney",11,11,77,"Melbourne",9,17,71,"Lake Oval",6,1953,"Regular",8,"Home","Sydney","Melbourne",6
5262,1953-06-20,"R9","Fitzroy",7,12,54,"Carlton",7,18,60,"Brunswick St",-6,1953,"Regular",9,"Away","Carlton","Fitzroy",6
5263,1953-06-20,"R9","Melbourne",7,6,48,"Collingwood",9,9,63,"M.C.G.",-15,1953,"Regular",9,"Away","Collingwood","Melbourne",15
5264,1953-06-20,"R9","Hawthorn",9,10,64,"Essendon",12,15,87,"Glenferrie Oval",-23,1953,"Regular",9,"Away","Essendon","Hawthorn",23
5265,1953-06-20,"R9","Footscray",5,13,43,"Sydney",11,6,72,"Western Oval",-29,1953,"Regular",9,"Away","Sydney","Footscray",29
5266,1953-06-20,"R9","St Kilda",6,8,44,"Geelong",9,6,60,"Junction Oval",-16,1953,"Regular",9,"Away","Geelong","St Kilda",16
5267,1953-06-20,"R9","North Melbourne",6,9,45,"Richmond",5,12,42,"Arden St",3,1953,"Regular",9,"Home","North Melbourne","Richmond",3
5268,1953-06-27,"R10","Carlton",8,15,63,"Geelong",10,14,74,"Princes Park",-11,1953,"Regular",10,"Away","Geelong","Carlton",11
5269,1953-06-27,"R10","Essendon",11,14,80,"Collingwood",6,16,52,"Windy Hill",28,1953,"Regular",10,"Home","Essendon","Collingwood",28
5270,1953-06-27,"R10","Fitzroy",11,9,75,"St Kilda",7,10,52,"Brunswick St",23,1953,"Regular",10,"Home","Fitzroy","St Kilda",23
5271,1953-06-27,"R10","North Melbourne",3,7,25,"Footscray",5,12,42,"Arden St",-17,1953,"Regular",10,"Away","Footscray","North Melbourne",17
5272,1953-06-27,"R10","Melbourne",10,14,74,"Hawthorn",16,6,102,"M.C.G.",-28,1953,"Regular",10,"Away","Hawthorn","Melbourne",28
5273,1953-06-27,"R10","Sydney",12,7,79,"Richmond",6,14,50,"Lake Oval",29,1953,"Regular",10,"Home","Sydney","Richmond",29
5274,1953-07-04,"R11","Carlton",14,13,97,"Sydney",10,13,73,"Princes Park",24,1953,"Regular",11,"Home","Carlton","Sydney",24
5275,1953-07-04,"R11","Collingwood",7,19,61,"Fitzroy",9,8,62,"Victoria Park",-1,1953,"Regular",11,"Away","Fitzroy","Collingwood",1
5276,1953-07-04,"R11","Footscray",9,15,69,"Essendon",7,11,53,"Western Oval",16,1953,"Regular",11,"Home","Footscray","Essendon",16
5277,1953-07-04,"R11","Geelong",12,14,86,"North Melbourne",13,7,85,"Kardinia Park",1,1953,"Regular",11,"Home","Geelong","North Melbourne",1
5278,1953-07-04,"R11","Richmond",12,10,82,"Hawthorn",7,6,48,"Punt Rd",34,1953,"Regular",11,"Home","Richmond","Hawthorn",34
5279,1953-07-04,"R11","St Kilda",11,7,73,"Melbourne",8,21,69,"Junction Oval",4,1953,"Regular",11,"Home","St Kilda","Melbourne",4
5280,1953-07-11,"R12","Footscray",13,12,90,"Carlton",8,18,66,"Western Oval",24,1953,"Regular",12,"Home","Footscray","Carlton",24
5281,1953-07-11,"R12","Hawthorn",9,8,62,"Geelong",12,14,86,"Glenferrie Oval",-24,1953,"Regular",12,"Away","Geelong","Hawthorn",24
5282,1953-07-11,"R12","Melbourne",11,9,75,"Richmond",11,9,75,"M.C.G.",0,1953,"Regular",12,"Home","Melbourne","Richmond",0
5283,1953-07-18,"R12","Sydney",12,9,81,"Collingwood",17,17,119,"Lake Oval",-38,1953,"Regular",12,"Away","Collingwood","Sydney",38
5284,1953-07-18,"R12","Fitzroy",7,20,62,"Essendon",14,13,97,"Brunswick St",-35,1953,"Regular",12,"Away","Essendon","Fitzroy",35
5285,1953-07-18,"R12","North Melbourne",20,11,131,"St Kilda",5,16,46,"Arden St",85,1953,"Regular",12,"Home","North Melbourne","St Kilda",85
5286,1953-07-25,"R13","Carlton",12,24,96,"Melbourne",10,10,70,"Princes Park",26,1953,"Regular",13,"Home","Carlton","Melbourne",26
5287,1953-07-25,"R13","Collingwood",13,16,94,"North Melbourne",8,17,65,"Victoria Park",29,1953,"Regular",13,"Home","Collingwood","North Melbourne",29
5288,1953-07-25,"R13","Essendon",12,11,83,"Sydney",8,14,62,"Windy Hill",21,1953,"Regular",13,"Home","Essendon","Sydney",21
5289,1953-07-25,"R13","Richmond",13,7,85,"Fitzroy",13,12,90,"Punt Rd",-5,1953,"Regular",13,"Away","Fitzroy","Richmond",5
5290,1953-07-25,"R13","Geelong",11,12,78,"Footscray",8,10,58,"Kardinia Park",20,1953,"Regular",13,"Home","Geelong","Footscray",20
5291,1953-07-25,"R13","St Kilda",9,13,67,"Hawthorn",4,14,38,"Junction Oval",29,1953,"Regular",13,"Home","St Kilda","Hawthorn",29
5292,1953-08-01,"R14","Carlton",15,16,106,"Richmond",10,19,79,"Princes Park",27,1953,"Regular",14,"Home","Carlton","Richmond",27
5293,1953-08-01,"R14","Geelong",7,13,55,"Collingwood",10,15,75,"Kardinia Park",-20,1953,"Regular",14,"Away","Collingwood","Geelong",20
5294,1953-08-01,"R14","St Kilda",9,10,64,"Essendon",14,15,99,"Junction Oval",-35,1953,"Regular",14,"Away","Essendon","St Kilda",35
5295,1953-08-01,"R14","Fitzroy",12,18,90,"Sydney",7,19,61,"Brunswick St",29,1953,"Regular",14,"Home","Fitzroy","Sydney",29
5296,1953-08-01,"R14","Hawthorn",3,10,28,"Footscray",11,10,76,"Glenferrie Oval",-48,1953,"Regular",14,"Away","Footscray","Hawthorn",48
5297,1953-08-01,"R14","Melbourne",9,13,67,"North Melbourne",8,16,64,"M.C.G.",3,1953,"Regular",14,"Home","Melbourne","North Melbourne",3
5298,1953-08-08,"R15","Collingwood",12,15,87,"Carlton",9,16,70,"Victoria Park",17,1953,"Regular",15,"Home","Collingwood","Carlton",17
5299,1953-08-08,"R15","Essendon",8,13,61,"Geelong",7,8,50,"Windy Hill",11,1953,"Regular",15,"Home","Essendon","Geelong",11
5300,1953-08-08,"R15","North Melbourne",17,19,121,"Fitzroy",7,9,51,"Arden St",70,1953,"Regular",15,"Home","North Melbourne","Fitzroy",70
5301,1953-08-08,"R15","Footscray",14,14,98,"Melbourne",9,7,61,"Western Oval",37,1953,"Regular",15,"Home","Footscray","Melbourne",37
5302,1953-08-08,"R15","Sydney",7,12,54,"Hawthorn",9,8,62,"Lake Oval",-8,1953,"Regular",15,"Away","Hawthorn","Sydney",8
5303,1953-08-08,"R15","Richmond",13,16,94,"St Kilda",11,14,80,"Punt Rd",14,1953,"Regular",15,"Home","Richmond","St Kilda",14
5304,1953-08-15,"R16","St Kilda",8,15,63,"Carlton",7,16,58,"Junction Oval",5,1953,"Regular",16,"Home","St Kilda","Carlton",5
5305,1953-08-15,"R16","Hawthorn",11,6,72,"Collingwood",12,16,88,"Glenferrie Oval",-16,1953,"Regular",16,"Away","Collingwood","Hawthorn",16
5306,1953-08-15,"R16","Melbourne",8,9,57,"Essendon",12,10,82,"M.C.G.",-25,1953,"Regular",16,"Away","Essendon","Melbourne",25
5307,1953-08-15,"R16","Fitzroy",7,11,53,"Footscray",14,14,98,"Brunswick St",-45,1953,"Regular",16,"Away","Footscray","Fitzroy",45
5308,1953-08-15,"R16","Geelong",14,18,102,"Richmond",4,9,33,"Kardinia Park",69,1953,"Regular",16,"Home","Geelong","Richmond",69
5309,1953-08-15,"R16","North Melbourne",8,8,56,"Sydney",11,21,87,"Arden St",-31,1953,"Regular",16,"Away","Sydney","North Melbourne",31
5310,1953-08-22,"R17","Carlton",12,15,87,"Hawthorn",6,9,45,"Princes Park",42,1953,"Regular",17,"Home","Carlton","Hawthorn",42
5311,1953-08-22,"R17","Richmond",12,9,81,"Collingwood",13,17,95,"Punt Rd",-14,1953,"Regular",17,"Away","Collingwood","Richmond",14
5312,1953-08-22,"R17","Essendon",12,6,78,"North Melbourne",12,7,79,"Windy Hill",-1,1953,"Regular",17,"Away","North Melbourne","Essendon",1
5313,1953-08-22,"R17","Fitzroy",6,13,49,"Melbourne",9,10,64,"Brunswick St",-15,1953,"Regular",17,"Away","Melbourne","Fitzroy",15
5314,1953-08-22,"R17","Footscray",12,18,90,"St Kilda",4,5,29,"Western Oval",61,1953,"Regular",17,"Home","Footscray","St Kilda",61
5315,1953-08-22,"R17","Sydney",14,14,98,"Geelong",8,7,55,"Lake Oval",43,1953,"Regular",17,"Home","Sydney","Geelong",43
5316,1953-08-29,"R18","North Melbourne",14,10,94,"Carlton",15,15,105,"Arden St",-11,1953,"Regular",18,"Away","Carlton","North Melbourne",11
5317,1953-08-29,"R18","Collingwood",10,14,74,"Footscray",8,7,55,"Victoria Park",19,1953,"Regular",18,"Home","Collingwood","Footscray",19
5318,1953-08-29,"R18","Richmond",13,7,85,"Essendon",19,12,126,"Punt Rd",-41,1953,"Regular",18,"Away","Essendon","Richmond",41
5319,1953-08-29,"R18","Hawthorn",9,10,64,"Fitzroy",13,6,84,"Glenferrie Oval",-20,1953,"Regular",18,"Away","Fitzroy","Hawthorn",20
5320,1953-08-29,"R18","Geelong",16,14,110,"Melbourne",8,8,56,"Kardinia Park",54,1953,"Regular",18,"Home","Geelong","Melbourne",54
5321,1953-08-29,"R18","Sydney",13,20,98,"St Kilda",4,12,36,"Lake Oval",62,1953,"Regular",18,"Home","Sydney","St Kilda",62
5322,1953-09-05,"SF","Footscray",6,13,49,"Essendon",5,11,41,"M.C.G.",8,1953,"Finals",19,"Home","Footscray","Essendon",8
5323,1953-09-12,"SF","Geelong",8,12,60,"Collingwood",13,12,90,"M.C.G.",-30,1953,"Finals",19,"Away","Collingwood","Geelong",30
5324,1953-09-19,"PF","Geelong",8,15,63,"Footscray",5,7,37,"M.C.G.",26,1953,"Finals",20,"Home","Geelong","Footscray",26
5325,1953-09-26,"GF","Geelong",8,17,65,"Collingwood",11,11,77,"M.C.G.",-12,1953,"Finals",21,"Away","Collingwood","Geelong",12
5326,1954-04-17,"R1","Sydney",11,18,84,"Carlton",11,13,79,"Lake Oval",5,1954,"Regular",1,"Home","Sydney","Carlton",5
5327,1954-04-17,"R1","Fitzroy",7,16,58,"Geelong",19,16,130,"Brunswick St",-72,1954,"Regular",1,"Away","Geelong","Fitzroy",72
5328,1954-04-17,"R1","Footscray",7,11,53,"St Kilda",9,10,64,"Western Oval",-11,1954,"Regular",1,"Away","St Kilda","Footscray",11
5329,1954-04-19,"R1","Melbourne",9,10,64,"Collingwood",15,12,102,"M.C.G.",-38,1954,"Regular",1,"Away","Collingwood","Melbourne",38
5330,1954-04-19,"R1","Hawthorn",8,13,61,"Essendon",14,11,95,"Glenferrie Oval",-34,1954,"Regular",1,"Away","Essendon","Hawthorn",34
5331,1954-04-19,"R1","North Melbourne",15,11,101,"Richmond",13,14,92,"Arden St",9,1954,"Regular",1,"Home","North Melbourne","Richmond",9
5332,1954-04-24,"R2","Carlton",12,10,82,"Melbourne",15,11,101,"Princes Park",-19,1954,"Regular",2,"Away","Melbourne","Carlton",19
5333,1954-04-24,"R2","Collingwood",12,12,84,"Fitzroy",5,8,38,"Victoria Park",46,1954,"Regular",2,"Home","Collingwood","Fitzroy",46
5334,1954-04-24,"R2","Essendon",5,18,48,"Sydney",8,13,61,"Windy Hill",-13,1954,"Regular",2,"Away","Sydney","Essendon",13
5335,1954-04-24,"R2","Richmond",12,19,91,"Footscray",9,19,73,"Punt Rd",18,1954,"Regular",2,"Home","Richmond","Footscray",18
5336,1954-04-24,"R2","Geelong",8,12,60,"North Melbourne",9,15,69,"Kardinia Park",-9,1954,"Regular",2,"Away","North Melbourne","Geelong",9
5337,1954-04-24,"R2","St Kilda",5,9,39,"Hawthorn",10,10,70,"Junction Oval",-31,1954,"Regular",2,"Away","Hawthorn","St Kilda",31
5338,1954-05-01,"R3","Richmond",14,20,104,"Carlton",12,8,80,"Punt Rd",24,1954,"Regular",3,"Home","Richmond","Carlton",24
5339,1954-05-01,"R3","St Kilda",10,10,70,"Collingwood",10,16,76,"Junction Oval",-6,1954,"Regular",3,"Away","Collingwood","St Kilda",6
5340,1954-05-01,"R3","Essendon",15,10,100,"Geelong",16,20,116,"Windy Hill",-16,1954,"Regular",3,"Away","Geelong","Essendon",16
5341,1954-05-01,"R3","Fitzroy",9,10,64,"North Melbourne",13,16,94,"Brunswick St",-30,1954,"Regular",3,"Away","North Melbourne","Fitzroy",30
5342,1954-05-01,"R3","Footscray",17,14,116,"Sydney",3,11,29,"Western Oval",87,1954,"Regular",3,"Home","Footscray","Sydney",87
5343,1954-05-01,"R3","Hawthorn",11,9,75,"Melbourne",9,10,64,"Glenferrie Oval",11,1954,"Regular",3,"Home","Hawthorn","Melbourne",11
5344,1954-05-08,"R4","Carlton",17,21,123,"Footscray",20,14,134,"Princes Park",-11,1954,"Regular",4,"Away","Footscray","Carlton",11
5345,1954-05-08,"R4","Collingwood",10,17,77,"Essendon",9,10,64,"Victoria Park",13,1954,"Regular",4,"Home","Collingwood","Essendon",13
5346,1954-05-08,"R4","Melbourne",14,12,96,"Fitzroy",7,12,54,"M.C.G.",42,1954,"Regular",4,"Home","Melbourne","Fitzroy",42
5347,1954-05-08,"R4","Geelong",13,17,95,"St Kilda",8,5,53,"Kardinia Park",42,1954,"Regular",4,"Home","Geelong","St Kilda",42
5348,1954-05-08,"R4","North Melbourne",11,10,76,"Hawthorn",10,13,73,"Arden St",3,1954,"Regular",4,"Home","North Melbourne","Hawthorn",3
5349,1954-05-08,"R4","Sydney",12,9,81,"Richmond",10,16,76,"Lake Oval",5,1954,"Regular",4,"Home","Sydney","Richmond",5
5350,1954-05-15,"R5","Essendon",8,18,66,"Carlton",9,15,69,"Windy Hill",-3,1954,"Regular",5,"Away","Carlton","Essendon",3
5351,1954-05-15,"R5","Sydney",6,13,49,"Collingwood",14,17,101,"Lake Oval",-52,1954,"Regular",5,"Away","Collingwood","Sydney",52
5352,1954-05-15,"R5","Fitzroy",10,16,76,"St Kilda",11,10,76,"Brunswick St",0,1954,"Regular",5,"Home","Fitzroy","St Kilda",0
5353,1954-05-15,"R5","Footscray",11,7,73,"North Melbourne",5,5,35,"Western Oval",38,1954,"Regular",5,"Home","Footscray","North Melbourne",38
5354,1954-05-15,"R5","Hawthorn",14,13,97,"Geelong",13,14,92,"Glenferrie Oval",5,1954,"Regular",5,"Home","Hawthorn","Geelong",5
5355,1954-05-15,"R5","Melbourne",14,13,97,"Richmond",10,7,67,"M.C.G.",30,1954,"Regular",5,"Home","Melbourne","Richmond",30
5356,1954-05-22,"R6","Fitzroy",8,10,58,"Carlton",15,10,100,"Brunswick St",-42,1954,"Regular",6,"Away","Carlton","Fitzroy",42
5357,1954-05-22,"R6","Geelong",13,17,95,"Collingwood",9,8,62,"Kardinia Park",33,1954,"Regular",6,"Home","Geelong","Collingwood",33
5358,1954-05-22,"R6","Footscray",12,8,80,"Essendon",4,7,31,"Western Oval",49,1954,"Regular",6,"Home","Footscray","Essendon",49
5359,1954-05-22,"R6","Richmond",10,12,72,"Hawthorn",11,12,78,"Punt Rd",-6,1954,"Regular",6,"Away","Hawthorn","Richmond",6
5360,1954-05-22,"R6","St Kilda",14,15,99,"Melbourne",12,6,78,"Junction Oval",21,1954,"Regular",6,"Home","St Kilda","Melbourne",21
5361,1954-05-22,"R6","North Melbourne",8,14,62,"Sydney",12,13,85,"Arden St",-23,1954,"Regular",6,"Away","Sydney","North Melbourne",23
5362,1954-05-29,"R7","Carlton",12,20,92,"Geelong",11,16,82,"Princes Park",10,1954,"Regular",7,"Home","Carlton","Geelong",10
5363,1954-05-29,"R7","Collingwood",11,8,74,"Richmond",14,13,97,"Victoria Park",-23,1954,"Regular",7,"Away","Richmond","Collingwood",23
5364,1954-05-29,"R7","Essendon",22,13,145,"Fitzroy",7,12,54,"Windy Hill",91,1954,"Regular",7,"Home","Essendon","Fitzroy",91
5365,1954-05-29,"R7","Hawthorn",10,9,69,"Footscray",11,12,78,"Glenferrie Oval",-9,1954,"Regular",7,"Away","Footscray","Hawthorn",9
5366,1954-05-29,"R7","Melbourne",15,21,111,"Sydney",14,5,89,"M.C.G.",22,1954,"Regular",7,"Home","Melbourne","Sydney",22
5367,1954-05-29,"R7","St Kilda",10,12,72,"North Melbourne",9,24,78,"Junction Oval",-6,1954,"Regular",7,"Away","North Melbourne","St Kilda",6
5368,1954-06-05,"R8","Collingwood",11,15,81,"Carlton",10,12,72,"Victoria Park",9,1954,"Regular",8,"Home","Collingwood","Carlton",9
5369,1954-06-05,"R8","Essendon",14,14,98,"North Melbourne",10,15,75,"Windy Hill",23,1954,"Regular",8,"Home","Essendon","North Melbourne",23
5370,1954-06-05,"R8","Footscray",13,9,87,"Fitzroy",10,14,74,"Western Oval",13,1954,"Regular",8,"Home","Footscray","Fitzroy",13
5371,1954-06-05,"R8","Geelong",11,5,71,"Melbourne",10,20,80,"Kardinia Park",-9,1954,"Regular",8,"Away","Melbourne","Geelong",9
5372,1954-06-05,"R8","Sydney",6,13,49,"Hawthorn",8,10,58,"Lake Oval",-9,1954,"Regular",8,"Away","Hawthorn","Sydney",9
5373,1954-06-05,"R8","Richmond",17,13,115,"St Kilda",10,6,66,"Punt Rd",49,1954,"Regular",8,"Home","Richmond","St Kilda",49
5374,1954-06-12,"R9","North Melbourne",13,13,91,"Collingwood",10,12,72,"Arden St",19,1954,"Regular",9,"Home","North Melbourne","Collingwood",19
5375,1954-06-12,"R9","Fitzroy",6,17,53,"Richmond",11,13,79,"Brunswick St",-26,1954,"Regular",9,"Away","Richmond","Fitzroy",26
5376,1954-06-12,"R9","St Kilda",2,18,30,"Sydney",13,18,96,"Junction Oval",-66,1954,"Regular",9,"Away","Sydney","St Kilda",66
5377,1954-06-14,"R9","Carlton",5,11,41,"Hawthorn",4,12,36,"Princes Park",5,1954,"Regular",9,"Home","Carlton","Hawthorn",5
5378,1954-06-14,"R9","Melbourne",11,13,79,"Essendon",14,17,101,"M.C.G.",-22,1954,"Regular",9,"Away","Essendon","Melbourne",22
5379,1954-06-14,"R9","Geelong",9,13,67,"Footscray",8,15,63,"Kardinia Park",4,1954,"Regular",9,"Home","Geelong","Footscray",4
5380,1954-06-26,"R10","North Melbourne",9,13,67,"Carlton",9,10,64,"Arden St",3,1954,"Regular",10,"Home","North Melbourne","Carlton",3
5381,1954-06-26,"R10","Hawthorn",11,5,71,"Collingwood",10,15,75,"Glenferrie Oval",-4,1954,"Regular",10,"Away","Collingwood","Hawthorn",4
5382,1954-06-26,"R10","St Kilda",9,12,66,"Essendon",10,19,79,"Junction Oval",-13,1954,"Regular",10,"Away","Essendon","St Kilda",13
5383,1954-06-26,"R10","Fitzroy",11,10,76,"Sydney",10,14,74,"Brunswick St",2,1954,"Regular",10,"Home","Fitzroy","Sydney",2
5384,1954-06-26,"R10","Footscray",10,13,73,"Melbourne",8,9,57,"Western Oval",16,1954,"Regular",10,"Home","Footscray","Melbourne",16
5385,1954-06-26,"R10","Richmond",18,12,120,"Geelong",13,17,95,"Punt Rd",25,1954,"Regular",10,"Home","Richmond","Geelong",25
5386,1954-07-03,"R11","Carlton",9,16,70,"St Kilda",12,10,82,"Princes Park",-12,1954,"Regular",11,"Away","St Kilda","Carlton",12
5387,1954-07-03,"R11","Collingwood",12,10,82,"Footscray",10,12,72,"Victoria Park",10,1954,"Regular",11,"Home","Collingwood","Footscray",10
5388,1954-07-03,"R11","Essendon",13,9,87,"Richmond",13,6,84,"Windy Hill",3,1954,"Regular",11,"Home","Essendon","Richmond",3
5389,1954-07-03,"R11","Hawthorn",11,15,81,"Fitzroy",11,10,76,"Glenferrie Oval",5,1954,"Regular",11,"Home","Hawthorn","Fitzroy",5
5390,1954-07-03,"R11","Sydney",9,10,64,"Geelong",17,12,114,"Lake Oval",-50,1954,"Regular",11,"Away","Geelong","Sydney",50
5391,1954-07-03,"R11","Melbourne",15,15,105,"North Melbourne",11,6,72,"M.C.G.",33,1954,"Regular",11,"Home","Melbourne","North Melbourne",33
5392,1954-07-10,"R12","Carlton",11,10,76,"Sydney",10,10,70,"Princes Park",6,1954,"Regular",12,"Home","Carlton","Sydney",6
5393,1954-07-10,"R12","Collingwood",8,6,54,"Melbourne",5,16,46,"Victoria Park",8,1954,"Regular",12,"Home","Collingwood","Melbourne",8
5394,1954-07-10,"R12","Essendon",13,16,94,"Hawthorn",9,9,63,"Windy Hill",31,1954,"Regular",12,"Home","Essendon","Hawthorn",31
5395,1954-07-10,"R12","Geelong",10,8,68,"Fitzroy",6,6,42,"Kardinia Park",26,1954,"Regular",12,"Home","Geelong","Fitzroy",26
5396,1954-07-10,"R12","St Kilda",9,8,62,"Footscray",13,14,92,"Junction Oval",-30,1954,"Regular",12,"Away","Footscray","St Kilda",30
5397,1954-07-10,"R12","Richmond",14,14,98,"North Melbourne",6,15,51,"Punt Rd",47,1954,"Regular",12,"Home","Richmond","North Melbourne",47
5398,1954-07-17,"R13","Melbourne",10,16,76,"Carlton",6,5,41,"M.C.G.",35,1954,"Regular",13,"Home","Melbourne","Carlton",35
5399,1954-07-17,"R13","North Melbourne",5,13,43,"Geelong",10,2,62,"Arden St",-19,1954,"Regular",13,"Away","Geelong","North Melbourne",19
5400,1954-07-17,"R13","Hawthorn",14,17,101,"St Kilda",5,10,40,"Glenferrie Oval",61,1954,"Regular",13,"Home","Hawthorn","St Kilda",61
5401,1954-07-24,"R13","Fitzroy",12,9,81,"Collingwood",6,13,49,"Brunswick St",32,1954,"Regular",13,"Home","Fitzroy","Collingwood",32
5402,1954-07-24,"R13","Sydney",8,18,66,"Essendon",13,8,86,"Lake Oval",-20,1954,"Regular",13,"Away","Essendon","Sydney",20
5403,1954-07-24,"R13","Footscray",6,9,45,"Richmond",6,13,49,"Western Oval",-4,1954,"Regular",13,"Away","Richmond","Footscray",4
5404,1954-07-31,"R14","Carlton",9,11,65,"Richmond",6,10,46,"Princes Park",19,1954,"Regular",14,"Home","Carlton","Richmond",19
5405,1954-07-31,"R14","Collingwood",12,13,85,"St Kilda",7,15,57,"Victoria Park",28,1954,"Regular",14,"Home","Collingwood","St Kilda",28
5406,1954-07-31,"R14","Geelong",16,14,110,"Essendon",11,10,76,"Kardinia Park",34,1954,"Regular",14,"Home","Geelong","Essendon",34
5407,1954-07-31,"R14","North Melbourne",8,19,67,"Fitzroy",8,6,54,"Arden St",13,1954,"Regular",14,"Home","North Melbourne","Fitzroy",13
5408,1954-07-31,"R14","Sydney",6,5,41,"Footscray",11,12,78,"Lake Oval",-37,1954,"Regular",14,"Away","Footscray","Sydney",37
5409,1954-07-31,"R14","Melbourne",16,14,110,"Hawthorn",5,3,33,"M.C.G.",77,1954,"Regular",14,"Home","Melbourne","Hawthorn",77
5410,1954-08-07,"R15","Footscray",6,7,43,"Carlton",8,12,60,"Western Oval",-17,1954,"Regular",15,"Away","Carlton","Footscray",17
5411,1954-08-07,"R15","Essendon",10,11,71,"Collingwood",6,16,52,"Windy Hill",19,1954,"Regular",15,"Home","Essendon","Collingwood",19
5412,1954-08-07,"R15","Fitzroy",8,11,59,"Melbourne",6,12,48,"Brunswick St",11,1954,"Regular",15,"Home","Fitzroy","Melbourne",11
5413,1954-08-07,"R15","St Kilda",7,17,59,"Geelong",18,13,121,"Junction Oval",-62,1954,"Regular",15,"Away","Geelong","St Kilda",62
5414,1954-08-07,"R15","Hawthorn",9,5,59,"North Melbourne",10,22,82,"Glenferrie Oval",-23,1954,"Regular",15,"Away","North Melbourne","Hawthorn",23
5415,1954-08-07,"R15","Richmond",12,15,87,"Sydney",6,16,52,"Punt Rd",35,1954,"Regular",15,"Home","Richmond","Sydney",35
5416,1954-08-14,"R16","Carlton",10,16,76,"Essendon",11,14,80,"Princes Park",-4,1954,"Regular",16,"Away","Essendon","Carlton",4
5417,1954-08-14,"R16","Collingwood",12,16,88,"Sydney",13,12,90,"Victoria Park",-2,1954,"Regular",16,"Away","Sydney","Collingwood",2
5418,1954-08-14,"R16","St Kilda",13,14,92,"Fitzroy",9,15,69,"Junction Oval",23,1954,"Regular",16,"Home","St Kilda","Fitzroy",23
5419,1954-08-14,"R16","North Melbourne",9,14,68,"Footscray",9,14,68,"Arden St",0,1954,"Regular",16,"Home","North Melbourne","Footscray",0
5420,1954-08-14,"R16","Geelong",13,12,90,"Hawthorn",7,6,48,"Kardinia Park",42,1954,"Regular",16,"Home","Geelong","Hawthorn",42
5421,1954-08-14,"R16","Richmond",10,18,78,"Melbourne",15,4,94,"Punt Rd",-16,1954,"Regular",16,"Away","Melbourne","Richmond",16
5422,1954-08-21,"R17","Carlton",22,11,143,"Fitzroy",14,7,91,"Princes Park",52,1954,"Regular",17,"Home","Carlton","Fitzroy",52
5423,1954-08-21,"R17","Collingwood",6,14,50,"Geelong",10,12,72,"Victoria Park",-22,1954,"Regular",17,"Away","Geelong","Collingwood",22
5424,1954-08-21,"R17","Essendon",7,17,59,"Footscray",11,12,78,"Windy Hill",-19,1954,"Regular",17,"Away","Footscray","Essendon",19
5425,1954-08-21,"R17","Hawthorn",10,10,70,"Richmond",6,11,47,"Glenferrie Oval",23,1954,"Regular",17,"Home","Hawthorn","Richmond",23
5426,1954-08-21,"R17","Melbourne",14,13,97,"St Kilda",5,10,40,"M.C.G.",57,1954,"Regular",17,"Home","Melbourne","St Kilda",57
5427,1954-08-21,"R17","Sydney",11,14,80,"North Melbourne",14,11,95,"Lake Oval",-15,1954,"Regular",17,"Away","North Melbourne","Sydney",15
5428,1954-08-28,"R18","Geelong",13,12,90,"Carlton",6,13,49,"Kardinia Park",41,1954,"Regular",18,"Home","Geelong","Carlton",41
5429,1954-08-28,"R18","Richmond",14,17,101,"Collingwood",6,12,48,"Punt Rd",53,1954,"Regular",18,"Home","Richmond","Collingwood",53
5430,1954-08-28,"R18","Fitzroy",14,13,97,"Essendon",13,13,91,"Brunswick St",6,1954,"Regular",18,"Home","Fitzroy","Essendon",6
5431,1954-08-28,"R18","Footscray",17,15,117,"Hawthorn",5,4,34,"Western Oval",83,1954,"Regular",18,"Home","Footscray","Hawthorn",83
5432,1954-08-28,"R18","Sydney",7,7,49,"Melbourne",14,17,101,"Lake Oval",-52,1954,"Regular",18,"Away","Melbourne","Sydney",52
5433,1954-08-28,"R18","North Melbourne",19,15,129,"St Kilda",12,10,82,"Arden St",47,1954,"Regular",18,"Home","North Melbourne","St Kilda",47
5434,1954-09-04,"SF","North Melbourne",11,14,80,"Melbourne",16,14,110,"M.C.G.",-30,1954,"Finals",19,"Away","Melbourne","North Melbourne",30
5435,1954-09-11,"SF","Geelong",8,14,62,"Footscray",11,19,85,"M.C.G.",-23,1954,"Finals",19,"Away","Footscray","Geelong",23
5436,1954-09-18,"PF","Geelong",7,8,50,"Melbourne",10,7,67,"M.C.G.",-17,1954,"Finals",20,"Away","Melbourne","Geelong",17
5437,1954-09-25,"GF","Footscray",15,12,102,"Melbourne",7,9,51,"M.C.G.",51,1954,"Finals",21,"Home","Footscray","Melbourne",51
5438,1955-04-16,"R1","Carlton",19,20,134,"North Melbourne",10,5,65,"Princes Park",69,1955,"Regular",1,"Home","Carlton","North Melbourne",69
5439,1955-04-16,"R1","Collingwood",6,12,48,"Footscray",15,14,104,"Victoria Park",-56,1955,"Regular",1,"Away","Footscray","Collingwood",56
5440,1955-04-16,"R1","Richmond",9,23,77,"Essendon",13,16,94,"Punt Rd",-17,1955,"Regular",1,"Away","Essendon","Richmond",17
5441,1955-04-16,"R1","Fitzroy",13,15,93,"Hawthorn",7,16,58,"Brunswick St",35,1955,"Regular",1,"Home","Fitzroy","Hawthorn",35
5442,1955-04-16,"R1","Geelong",15,14,104,"Sydney",9,12,66,"Kardinia Park",38,1955,"Regular",1,"Home","Geelong","Sydney",38
5443,1955-04-16,"R1","St Kilda",8,11,59,"Melbourne",17,16,118,"Junction Oval",-59,1955,"Regular",1,"Away","Melbourne","St Kilda",59
5444,1955-04-23,"R2","Hawthorn",12,15,87,"Carlton",9,6,60,"Glenferrie Oval",27,1955,"Regular",2,"Home","Hawthorn","Carlton",27
5445,1955-04-23,"R2","North Melbourne",9,16,70,"Collingwood",21,11,137,"Arden St",-67,1955,"Regular",2,"Away","Collingwood","North Melbourne",67
5446,1955-04-23,"R2","Essendon",16,24,120,"St Kilda",8,7,55,"Windy Hill",65,1955,"Regular",2,"Home","Essendon","St Kilda",65
5447,1955-04-23,"R2","Sydney",16,11,107,"Fitzroy",9,15,69,"Lake Oval",38,1955,"Regular",2,"Home","Sydney","Fitzroy",38
5448,1955-04-23,"R2","Footscray",16,16,112,"Richmond",12,9,81,"Western Oval",31,1955,"Regular",2,"Home","Footscray","Richmond",31
5449,1955-04-23,"R2","Melbourne",16,15,111,"Geelong",8,14,62,"M.C.G.",49,1955,"Regular",2,"Home","Melbourne","Geelong",49
5450,1955-04-30,"R3","Carlton",17,4,106,"Fitzroy",6,13,49,"Princes Park",57,1955,"Regular",3,"Home","Carlton","Fitzroy",57
5451,1955-04-30,"R3","Collingwood",16,20,116,"St Kilda",8,11,59,"Victoria Park",57,1955,"Regular",3,"Home","Collingwood","St Kilda",57
5452,1955-04-30,"R3","Essendon",11,14,80,"North Melbourne",9,15,69,"Windy Hill",11,1955,"Regular",3,"Home","Essendon","North Melbourne",11
5453,1955-04-30,"R3","Melbourne",6,22,58,"Footscray",6,10,46,"M.C.G.",12,1955,"Regular",3,"Home","Melbourne","Footscray",12
5454,1955-04-30,"R3","Geelong",15,13,103,"Richmond",9,11,65,"Kardinia Park",38,1955,"Regular",3,"Home","Geelong","Richmond",38
5455,1955-04-30,"R3","Sydney",7,14,56,"Hawthorn",15,8,98,"Lake Oval",-42,1955,"Regular",3,"Away","Hawthorn","Sydney",42
5456,1955-05-07,"R4","St Kilda",7,22,64,"Carlton",15,9,99,"Junction Oval",-35,1955,"Regular",4,"Away","Carlton","St Kilda",35
5457,1955-05-07,"R4","Hawthorn",12,12,84,"Collingwood",12,3,75,"Glenferrie Oval",9,1955,"Regular",4,"Home","Hawthorn","Collingwood",9
5458,1955-05-07,"R4","Footscray",4,12,36,"Essendon",2,11,23,"Western Oval",13,1955,"Regular",4,"Home","Footscray","Essendon",13
5459,1955-05-07,"R4","Fitzroy",10,13,73,"Geelong",11,17,83,"Brunswick St",-10,1955,"Regular",4,"Away","Geelong","Fitzroy",10
5460,1955-05-07,"R4","North Melbourne",9,7,61,"Melbourne",10,14,74,"Arden St",-13,1955,"Regular",4,"Away","Melbourne","North Melbourne",13
5461,1955-05-07,"R4","Richmond",15,20,110,"Sydney",7,10,52,"Punt Rd",58,1955,"Regular",4,"Home","Richmond","Sydney",58
5462,1955-05-14,"R5","Carlton",12,17,89,"Collingwood",17,12,114,"Princes Park",-25,1955,"Regular",5,"Away","Collingwood","Carlton",25
5463,1955-05-14,"R5","Essendon",8,11,59,"Melbourne",10,13,73,"Windy Hill",-14,1955,"Regular",5,"Away","Melbourne","Essendon",14
5464,1955-05-14,"R5","Richmond",11,11,77,"Fitzroy",15,9,99,"Punt Rd",-22,1955,"Regular",5,"Away","Fitzroy","Richmond",22
5465,1955-05-14,"R5","Geelong",12,12,84,"Footscray",10,12,72,"Kardinia Park",12,1955,"Regular",5,"Home","Geelong","Footscray",12
5466,1955-05-14,"R5","Hawthorn",14,7,91,"North Melbourne",13,15,93,"Glenferrie Oval",-2,1955,"Regular",5,"Away","North Melbourne","Hawthorn",2
5467,1955-05-14,"R5","Sydney",25,16,166,"St Kilda",4,8,32,"Lake Oval",134,1955,"Regular",5,"Home","Sydney","St Kilda",134
5468,1955-05-21,"R6","Carlton",11,9,75,"Sydney",12,11,83,"Princes Park",-8,1955,"Regular",6,"Away","Sydney","Carlton",8
5469,1955-05-21,"R6","Collingwood",15,11,101,"Essendon",6,11,47,"Victoria Park",54,1955,"Regular",6,"Home","Collingwood","Essendon",54
5470,1955-05-21,"R6","Footscray",8,10,58,"Fitzroy",10,6,66,"Western Oval",-8,1955,"Regular",6,"Away","Fitzroy","Footscray",8
5471,1955-05-21,"R6","St Kilda",4,5,29,"Geelong",6,12,48,"Junction Oval",-19,1955,"Regular",6,"Away","Geelong","St Kilda",19
5472,1955-05-21,"R6","Melbourne",11,5,71,"Hawthorn",6,8,44,"M.C.G.",27,1955,"Regular",6,"Home","Melbourne","Hawthorn",27
5473,1955-05-21,"R6","North Melbourne",10,14,74,"Richmond",7,10,52,"Arden St",22,1955,"Regular",6,"Home","North Melbourne","Richmond",22
5474,1955-05-28,"R7","Geelong",12,12,84,"Carlton",10,9,69,"Kardinia Park",15,1955,"Regular",7,"Home","Geelong","Carlton",15
5475,1955-05-28,"R7","Fitzroy",6,9,45,"Collingwood",16,13,109,"Brunswick St",-64,1955,"Regular",7,"Away","Collingwood","Fitzroy",64
5476,1955-05-28,"R7","Essendon",9,11,65,"Hawthorn",10,10,70,"Windy Hill",-5,1955,"Regular",7,"Away","Hawthorn","Essendon",5
5477,1955-05-28,"R7","Footscray",10,9,69,"North Melbourne",8,14,62,"Western Oval",7,1955,"Regular",7,"Home","Footscray","North Melbourne",7
5478,1955-05-28,"R7","Sydney",10,11,71,"Melbourne",11,6,72,"Lake Oval",-1,1955,"Regular",7,"Away","Melbourne","Sydney",1
5479,1955-05-28,"R7","Richmond",17,20,122,"St Kilda",7,14,56,"Punt Rd",66,1955,"Regular",7,"Home","Richmond","St Kilda",66
5480,1955-06-04,"R8","Melbourne",20,15,135,"Carlton",9,16,70,"M.C.G.",65,1955,"Regular",8,"Home","Melbourne","Carlton",65
5481,1955-06-04,"R8","Collingwood",11,11,77,"Geelong",10,7,67,"Victoria Park",10,1955,"Regular",8,"Home","Collingwood","Geelong",10
5482,1955-06-04,"R8","Essendon",13,14,92,"Sydney",7,12,54,"Windy Hill",38,1955,"Regular",8,"Home","Essendon","Sydney",38
5483,1955-06-04,"R8","North Melbourne",11,5,71,"Fitzroy",12,16,88,"Arden St",-17,1955,"Regular",8,"Away","Fitzroy","North Melbourne",17
5484,1955-06-04,"R8","St Kilda",4,10,34,"Footscray",13,7,85,"Junction Oval",-51,1955,"Regular",8,"Away","Footscray","St Kilda",51
5485,1955-06-04,"R8","Hawthorn",9,8,62,"Richmond",8,12,60,"Glenferrie Oval",2,1955,"Regular",8,"Home","Hawthorn","Richmond",2
5486,1955-06-11,"R9","Carlton",4,4,28,"Essendon",11,20,86,"Princes Park",-58,1955,"Regular",9,"Away","Essendon","Carlton",58
5487,1955-06-11,"R9","Sydney",8,15,63,"Collingwood",9,18,72,"Lake Oval",-9,1955,"Regular",9,"Away","Collingwood","Sydney",9
5488,1955-06-11,"R9","Footscray",17,12,114,"Hawthorn",8,11,59,"Western Oval",55,1955,"Regular",9,"Home","Footscray","Hawthorn",55
5489,1955-06-13,"R9","Fitzroy",19,14,128,"St Kilda",7,12,54,"Brunswick St",74,1955,"Regular",9,"Home","Fitzroy","St Kilda",74
5490,1955-06-13,"R9","North Melbourne",12,9,81,"Geelong",13,17,95,"Arden St",-14,1955,"Regular",9,"Away","Geelong","North Melbourne",14
5491,1955-06-13,"R9","Melbourne",13,16,94,"Richmond",11,12,78,"M.C.G.",16,1955,"Regular",9,"Home","Melbourne","Richmond",16
5492,1955-06-25,"R10","Carlton",6,7,43,"Footscray",11,15,81,"Princes Park",-38,1955,"Regular",10,"Away","Footscray","Carlton",38
5493,1955-06-25,"R10","Richmond",6,12,48,"Collingwood",14,14,98,"Punt Rd",-50,1955,"Regular",10,"Away","Collingwood","Richmond",50
5494,1955-06-25,"R10","Geelong",10,5,65,"Essendon",7,10,52,"Kardinia Park",13,1955,"Regular",10,"Home","Geelong","Essendon",13
5495,1955-06-25,"R10","Fitzroy",5,9,39,"Melbourne",10,11,71,"Brunswick St",-32,1955,"Regular",10,"Away","Melbourne","Fitzroy",32
5496,1955-06-25,"R10","Hawthorn",12,9,81,"St Kilda",6,7,43,"Glenferrie Oval",38,1955,"Regular",10,"Home","Hawthorn","St Kilda",38
5497,1955-06-25,"R10","Sydney",10,10,70,"North Melbourne",8,10,58,"Lake Oval",12,1955,"Regular",10,"Home","Sydney","North Melbourne",12
5498,1955-07-02,"R11","Richmond",14,12,96,"Carlton",7,7,49,"Punt Rd",47,1955,"Regular",11,"Home","Richmond","Carlton",47
5499,1955-07-02,"R11","Collingwood",7,6,48,"Melbourne",5,15,45,"Victoria Park",3,1955,"Regular",11,"Home","Collingwood","Melbourne",3
5500,1955-07-02,"R11","Essendon",8,20,68,"Fitzroy",5,12,42,"Windy Hill",26,1955,"Regular",11,"Home","Essendon","Fitzroy",26
5501,1955-07-02,"R11","Footscray",11,16,82,"Sydney",6,13,49,"Western Oval",33,1955,"Regular",11,"Home","Footscray","Sydney",33
5502,1955-07-02,"R11","Geelong",16,13,109,"Hawthorn",7,8,50,"Kardinia Park",59,1955,"Regular",11,"Home","Geelong","Hawthorn",59
5503,1955-07-02,"R11","St Kilda",10,8,68,"North Melbourne",8,13,61,"Junction Oval",7,1955,"Regular",11,"Home","St Kilda","North Melbourne",7
5504,1955-07-09,"R12","North Melbourne",13,10,88,"Carlton",16,9,105,"Arden St",-17,1955,"Regular",12,"Away","Carlton","North Melbourne",17
5505,1955-07-09,"R12","Footscray",5,13,43,"Collingwood",5,7,37,"Western Oval",6,1955,"Regular",12,"Home","Footscray","Collingwood",6
5506,1955-07-09,"R12","Essendon",14,7,91,"Richmond",5,20,50,"Windy Hill",41,1955,"Regular",12,"Home","Essendon","Richmond",41
5507,1955-07-09,"R12","Hawthorn",18,12,120,"Fitzroy",9,5,59,"Glenferrie Oval",61,1955,"Regular",12,"Home","Hawthorn","Fitzroy",61
5508,1955-07-09,"R12","Sydney",13,10,88,"Geelong",15,9,99,"Lake Oval",-11,1955,"Regular",12,"Away","Geelong","Sydney",11
5509,1955-07-09,"R12","Melbourne",17,16,118,"St Kilda",3,3,21,"M.C.G.",97,1955,"Regular",12,"Home","Melbourne","St Kilda",97
5510,1955-07-16,"R13","Carlton",10,19,79,"Hawthorn",9,9,63,"Princes Park",16,1955,"Regular",13,"Home","Carlton","Hawthorn",16
5511,1955-07-16,"R13","Collingwood",15,9,99,"North Melbourne",13,14,92,"Victoria Park",7,1955,"Regular",13,"Home","Collingwood","North Melbourne",7
5512,1955-07-16,"R13","St Kilda",5,7,37,"Essendon",10,22,82,"Junction Oval",-45,1955,"Regular",13,"Away","Essendon","St Kilda",45
5513,1955-07-16,"R13","Fitzroy",14,16,100,"Sydney",6,10,46,"Brunswick St",54,1955,"Regular",13,"Home","Fitzroy","Sydney",54
5514,1955-07-16,"R13","Richmond",8,9,57,"Footscray",6,12,48,"Punt Rd",9,1955,"Regular",13,"Home","Richmond","Footscray",9
5515,1955-07-16,"R13","Geelong",10,11,71,"Melbourne",6,16,52,"Kardinia Park",19,1955,"Regular",13,"Home","Geelong","Melbourne",19
5516,1955-07-23,"R14","Fitzroy",11,14,80,"Carlton",13,16,94,"Brunswick St",-14,1955,"Regular",14,"Away","Carlton","Fitzroy",14
5517,1955-07-23,"R14","St Kilda",10,11,71,"Collingwood",16,20,116,"Junction Oval",-45,1955,"Regular",14,"Away","Collingwood","St Kilda",45
5518,1955-07-23,"R14","North Melbourne",9,7,61,"Essendon",17,23,125,"Arden St",-64,1955,"Regular",14,"Away","Essendon","North Melbourne",64
5519,1955-07-23,"R14","Footscray",11,8,74,"Melbourne",9,19,73,"Western Oval",1,1955,"Regular",14,"Home","Footscray","Melbourne",1
5520,1955-07-23,"R14","Richmond",14,16,100,"Geelong",14,13,97,"Punt Rd",3,1955,"Regular",14,"Home","Richmond","Geelong",3
5521,1955-07-23,"R14","Hawthorn",10,11,71,"Sydney",6,15,51,"Glenferrie Oval",20,1955,"Regular",14,"Home","Hawthorn","Sydney",20
5522,1955-07-30,"R15","Carlton",11,21,87,"St Kilda",3,13,31,"Princes Park",56,1955,"Regular",15,"Home","Carlton","St Kilda",56
5523,1955-07-30,"R15","Collingwood",10,11,71,"Hawthorn",5,6,36,"Victoria Park",35,1955,"Regular",15,"Home","Collingwood","Hawthorn",35
5524,1955-07-30,"R15","Essendon",9,18,72,"Footscray",5,22,52,"Windy Hill",20,1955,"Regular",15,"Home","Essendon","Footscray",20
5525,1955-07-30,"R15","Geelong",12,14,86,"Fitzroy",9,11,65,"Kardinia Park",21,1955,"Regular",15,"Home","Geelong","Fitzroy",21
5526,1955-07-30,"R15","Melbourne",12,18,90,"North Melbourne",8,15,63,"M.C.G.",27,1955,"Regular",15,"Home","Melbourne","North Melbourne",27
5527,1955-07-30,"R15","Sydney",14,9,93,"Richmond",13,16,94,"Lake Oval",-1,1955,"Regular",15,"Away","Richmond","Sydney",1
5528,1955-08-06,"R16","Collingwood",12,17,89,"Carlton",7,10,52,"Victoria Park",37,1955,"Regular",16,"Home","Collingwood","Carlton",37
5529,1955-08-06,"R16","Melbourne",16,23,119,"Essendon",7,12,54,"M.C.G.",65,1955,"Regular",16,"Home","Melbourne","Essendon",65
5530,1955-08-06,"R16","Fitzroy",6,17,53,"Richmond",11,9,75,"Brunswick St",-22,1955,"Regular",16,"Away","Richmond","Fitzroy",22
5531,1955-08-06,"R16","Footscray",10,13,73,"Geelong",10,16,76,"Western Oval",-3,1955,"Regular",16,"Away","Geelong","Footscray",3
5532,1955-08-06,"R16","North Melbourne",8,12,60,"Hawthorn",8,5,53,"Arden St",7,1955,"Regular",16,"Home","North Melbourne","Hawthorn",7
5533,1955-08-06,"R16","St Kilda",8,5,53,"Sydney",11,16,82,"Junction Oval",-29,1955,"Regular",16,"Away","Sydney","St Kilda",29
5534,1955-08-13,"R17","Sydney",6,12,48,"Carlton",12,7,79,"Lake Oval",-31,1955,"Regular",17,"Away","Carlton","Sydney",31
5535,1955-08-13,"R17","Essendon",19,19,133,"Collingwood",8,12,60,"Windy Hill",73,1955,"Regular",17,"Home","Essendon","Collingwood",73
5536,1955-08-13,"R17","Fitzroy",9,7,61,"Footscray",11,13,79,"Brunswick St",-18,1955,"Regular",17,"Away","Footscray","Fitzroy",18
5537,1955-08-13,"R17","Geelong",19,17,131,"St Kilda",7,10,52,"Kardinia Park",79,1955,"Regular",17,"Home","Geelong","St Kilda",79
5538,1955-08-13,"R17","Hawthorn",12,13,85,"Melbourne",13,13,91,"Glenferrie Oval",-6,1955,"Regular",17,"Away","Melbourne","Hawthorn",6
5539,1955-08-13,"R17","Richmond",12,20,92,"North Melbourne",10,9,69,"Punt Rd",23,1955,"Regular",17,"Home","Richmond","North Melbourne",23
5540,1955-08-20,"R18","Carlton",10,6,66,"Geelong",8,12,60,"Princes Park",6,1955,"Regular",18,"Home","Carlton","Geelong",6
5541,1955-08-20,"R18","Collingwood",7,17,59,"Fitzroy",7,7,49,"Victoria Park",10,1955,"Regular",18,"Home","Collingwood","Fitzroy",10
5542,1955-08-20,"R18","Hawthorn",7,8,50,"Essendon",13,14,92,"Glenferrie Oval",-42,1955,"Regular",18,"Away","Essendon","Hawthorn",42
5543,1955-08-20,"R18","North Melbourne",5,5,35,"Footscray",14,11,95,"Arden St",-60,1955,"Regular",18,"Away","Footscray","North Melbourne",60
5544,1955-08-20,"R18","Melbourne",12,22,94,"Sydney",4,7,31,"M.C.G.",63,1955,"Regular",18,"Home","Melbourne","Sydney",63
5545,1955-08-20,"R18","St Kilda",6,7,43,"Richmond",19,23,137,"Junction Oval",-94,1955,"Regular",18,"Away","Richmond","St Kilda",94
5546,1955-08-27,"SF","Geelong",9,7,61,"Essendon",7,11,53,"M.C.G.",8,1955,"Finals",19,"Home","Geelong","Essendon",8
5547,1955-09-03,"SF","Melbourne",8,8,56,"Collingwood",6,9,45,"M.C.G.",11,1955,"Finals",19,"Home","Melbourne","Collingwood",11
5548,1955-09-10,"PF","Collingwood",14,12,96,"Geelong",13,6,84,"M.C.G.",12,1955,"Finals",20,"Home","Collingwood","Geelong",12
5549,1955-09-17,"GF","Melbourne",8,16,64,"Collingwood",5,6,36,"M.C.G.",28,1955,"Finals",21,"Home","Melbourne","Collingwood",28
5550,1956-04-14,"R1","Essendon",9,13,67,"Carlton",5,9,39,"Windy Hill",28,1956,"Regular",1,"Home","Essendon","Carlton",28
5551,1956-04-14,"R1","Hawthorn",8,17,65,"Collingwood",14,13,97,"Glenferrie Oval",-32,1956,"Regular",1,"Away","Collingwood","Hawthorn",32
5552,1956-04-14,"R1","Footscray",14,14,98,"Fitzroy",10,9,69,"Western Oval",29,1956,"Regular",1,"Home","Footscray","Fitzroy",29
5553,1956-04-14,"R1","Sydney",7,8,50,"Geelong",11,11,77,"Lake Oval",-27,1956,"Regular",1,"Away","Geelong","Sydney",27
5554,1956-04-14,"R1","Richmond",8,7,55,"Melbourne",12,16,88,"Punt Rd",-33,1956,"Regular",1,"Away","Melbourne","Richmond",33
5555,1956-04-14,"R1","North Melbourne",15,8,98,"St Kilda",5,11,41,"Arden St",57,1956,"Regular",1,"Home","North Melbourne","St Kilda",57
5556,1956-04-21,"R2","Carlton",6,11,47,"Melbourne",12,18,90,"Princes Park",-43,1956,"Regular",2,"Away","Melbourne","Carlton",43
5557,1956-04-21,"R2","Collingwood",12,18,90,"Sydney",7,11,53,"Victoria Park",37,1956,"Regular",2,"Home","Collingwood","Sydney",37
5558,1956-04-21,"R2","Fitzroy",10,19,79,"Essendon",7,15,57,"Brunswick St",22,1956,"Regular",2,"Home","Fitzroy","Essendon",22
5559,1956-04-21,"R2","St Kilda",7,4,46,"Footscray",10,14,74,"Junction Oval",-28,1956,"Regular",2,"Away","Footscray","St Kilda",28
5560,1956-04-21,"R2","Geelong",16,14,110,"North Melbourne",2,10,22,"Kardinia Park",88,1956,"Regular",2,"Home","Geelong","North Melbourne",88
5561,1956-04-21,"R2","Richmond",12,13,85,"Hawthorn",16,10,106,"Punt Rd",-21,1956,"Regular",2,"Away","Hawthorn","Richmond",21
5562,1956-04-28,"R3","St Kilda",9,11,65,"Carlton",13,9,87,"Junction Oval",-22,1956,"Regular",3,"Away","Carlton","St Kilda",22
5563,1956-04-28,"R3","Richmond",17,12,114,"Collingwood",11,12,78,"Punt Rd",36,1956,"Regular",3,"Home","Richmond","Collingwood",36
5564,1956-04-28,"R3","North Melbourne",9,11,65,"Essendon",15,17,107,"Arden St",-42,1956,"Regular",3,"Away","Essendon","North Melbourne",42
5565,1956-04-28,"R3","Fitzroy",13,16,94,"Sydney",10,13,73,"Brunswick St",21,1956,"Regular",3,"Home","Fitzroy","Sydney",21
5566,1956-04-28,"R3","Footscray",5,11,41,"Melbourne",9,13,67,"Western Oval",-26,1956,"Regular",3,"Away","Melbourne","Footscray",26
5567,1956-04-28,"R3","Hawthorn",15,10,100,"Geelong",16,16,112,"Glenferrie Oval",-12,1956,"Regular",3,"Away","Geelong","Hawthorn",12
5568,1956-05-05,"R4","Carlton",15,12,102,"North Melbourne",13,16,94,"Princes Park",8,1956,"Regular",4,"Home","Carlton","North Melbourne",8
5569,1956-05-05,"R4","Collingwood",12,15,87,"Footscray",11,7,73,"Victoria Park",14,1956,"Regular",4,"Home","Collingwood","Footscray",14
5570,1956-05-05,"R4","Essendon",18,9,117,"St Kilda",9,23,77,"Windy Hill",40,1956,"Regular",4,"Home","Essendon","St Kilda",40
5571,1956-05-05,"R4","Melbourne",10,19,79,"Fitzroy",9,6,60,"Punt Rd",19,1956,"Regular",4,"Home","Melbourne","Fitzroy",19
5572,1956-05-05,"R4","Geelong",15,13,103,"Richmond",10,11,71,"Kardinia Park",32,1956,"Regular",4,"Home","Geelong","Richmond",32
5573,1956-05-05,"R4","Sydney",6,17,53,"Hawthorn",8,11,59,"Lake Oval",-6,1956,"Regular",4,"Away","Hawthorn","Sydney",6
5574,1956-05-12,"R5","Carlton",8,16,64,"Collingwood",3,4,22,"Princes Park",42,1956,"Regular",5,"Home","Carlton","Collingwood",42
5575,1956-05-12,"R5","Essendon",6,22,58,"Richmond",7,10,52,"Windy Hill",6,1956,"Regular",5,"Home","Essendon","Richmond",6
5576,1956-05-12,"R5","Fitzroy",8,15,63,"North Melbourne",7,6,48,"Brunswick St",15,1956,"Regular",5,"Home","Fitzroy","North Melbourne",15
5577,1956-05-12,"R5","Footscray",9,13,67,"Sydney",8,9,57,"Western Oval",10,1956,"Regular",5,"Home","Footscray","Sydney",10
5578,1956-05-12,"R5","Melbourne",6,20,56,"Geelong",6,12,48,"M.C.G.",8,1956,"Regular",5,"Home","Melbourne","Geelong",8
5579,1956-05-12,"R5","St Kilda",3,9,27,"Hawthorn",6,12,48,"Junction Oval",-21,1956,"Regular",5,"Away","Hawthorn","St Kilda",21
5580,1956-05-19,"R6","Richmond",9,14,68,"Carlton",15,17,107,"Punt Rd",-39,1956,"Regular",6,"Away","Carlton","Richmond",39
5581,1956-05-19,"R6","Collingwood",10,7,67,"Geelong",2,14,26,"Victoria Park",41,1956,"Regular",6,"Home","Collingwood","Geelong",41
5582,1956-05-19,"R6","Sydney",15,8,98,"Essendon",11,20,86,"Lake Oval",12,1956,"Regular",6,"Home","Sydney","Essendon",12
5583,1956-05-19,"R6","Fitzroy",11,11,77,"St Kilda",7,11,53,"Brunswick St",24,1956,"Regular",6,"Home","Fitzroy","St Kilda",24
5584,1956-05-19,"R6","Hawthorn",10,14,74,"Footscray",10,11,71,"Glenferrie Oval",3,1956,"Regular",6,"Home","Hawthorn","Footscray",3
5585,1956-05-19,"R6","North Melbourne",6,6,42,"Melbourne",11,18,84,"Arden St",-42,1956,"Regular",6,"Away","Melbourne","North Melbourne",42
5586,1956-05-26,"R7","Footscray",7,13,55,"Carlton",8,8,56,"Western Oval",-1,1956,"Regular",7,"Away","Carlton","Footscray",1
5587,1956-05-26,"R7","Melbourne",11,13,79,"Collingwood",9,7,61,"M.C.G.",18,1956,"Regular",7,"Home","Melbourne","Collingwood",18
5588,1956-05-26,"R7","Geelong",15,17,107,"Essendon",8,9,57,"Kardinia Park",50,1956,"Regular",7,"Home","Geelong","Essendon",50
5589,1956-05-26,"R7","Hawthorn",8,10,58,"Fitzroy",9,13,67,"Glenferrie Oval",-9,1956,"Regular",7,"Away","Fitzroy","Hawthorn",9
5590,1956-05-26,"R7","North Melbourne",15,7,97,"Sydney",7,16,58,"Arden St",39,1956,"Regular",7,"Home","North Melbourne","Sydney",39
5591,1956-05-26,"R7","St Kilda",9,10,64,"Richmond",6,8,44,"Junction Oval",20,1956,"Regular",7,"Home","St Kilda","Richmond",20
5592,1956-06-02,"R8","Carlton",10,13,73,"Hawthorn",5,9,39,"Princes Park",34,1956,"Regular",8,"Home","Carlton","Hawthorn",34
5593,1956-06-02,"R8","Collingwood",9,10,64,"North Melbourne",3,4,22,"Victoria Park",42,1956,"Regular",8,"Home","Collingwood","North Melbourne",42
5594,1956-06-02,"R8","St Kilda",6,11,47,"Melbourne",9,7,61,"Junction Oval",-14,1956,"Regular",8,"Away","Melbourne","St Kilda",14
5595,1956-06-04,"R8","Essendon",12,11,83,"Footscray",14,23,107,"Windy Hill",-24,1956,"Regular",8,"Away","Footscray","Essendon",24
5596,1956-06-04,"R8","Geelong",11,12,78,"Fitzroy",8,8,56,"Kardinia Park",22,1956,"Regular",8,"Home","Geelong","Fitzroy",22
5597,1956-06-04,"R8","Richmond",10,15,75,"Sydney",12,6,78,"Punt Rd",-3,1956,"Regular",8,"Away","Sydney","Richmond",3
5598,1956-06-09,"R9","Carlton",11,13,79,"Geelong",12,8,80,"Princes Park",-1,1956,"Regular",9,"Away","Geelong","Carlton",1
5599,1956-06-09,"R9","Fitzroy",5,7,37,"Collingwood",12,10,82,"Brunswick St",-45,1956,"Regular",9,"Away","Collingwood","Fitzroy",45
5600,1956-06-09,"R9","Melbourne",15,17,107,"Essendon",4,15,39,"M.C.G.",68,1956,"Regular",9,"Home","Melbourne","Essendon",68
5601,1956-06-09,"R9","Footscray",12,14,86,"Richmond",6,8,44,"Western Oval",42,1956,"Regular",9,"Home","Footscray","Richmond",42
5602,1956-06-09,"R9","Hawthorn",7,13,55,"North Melbourne",3,12,30,"Glenferrie Oval",25,1956,"Regular",9,"Home","Hawthorn","North Melbourne",25
5603,1956-06-09,"R9","Sydney",14,5,89,"St Kilda",11,8,74,"Lake Oval",15,1956,"Regular",9,"Home","Sydney","St Kilda",15
5604,1956-06-16,"R10","St Kilda",9,9,63,"Collingwood",8,21,69,"Junction Oval",-6,1956,"Regular",10,"Away","Collingwood","St Kilda",6
5605,1956-06-16,"R10","Footscray",13,12,90,"Geelong",10,8,68,"Western Oval",22,1956,"Regular",10,"Home","Footscray","Geelong",22
5606,1956-06-16,"R10","North Melbourne",10,13,73,"Richmond",12,11,83,"Arden St",-10,1956,"Regular",10,"Away","Richmond","North Melbourne",10
5607,1956-06-23,"R10","Fitzroy",7,11,53,"Carlton",13,11,89,"Brunswick St",-36,1956,"Regular",10,"Away","Carlton","Fitzroy",36
5608,1956-06-23,"R10","Essendon",12,20,92,"Hawthorn",10,11,71,"Windy Hill",21,1956,"Regular",10,"Home","Essendon","Hawthorn",21
5609,1956-06-23,"R10","Melbourne",12,10,82,"Sydney",8,11,59,"M.C.G.",23,1956,"Regular",10,"Home","Melbourne","Sydney",23
5610,1956-06-30,"R11","Sydney",9,19,73,"Carlton",7,12,54,"Lake Oval",19,1956,"Regular",11,"Home","Sydney","Carlton",19
5611,1956-06-30,"R11","Collingwood",15,18,108,"Essendon",7,12,54,"Victoria Park",54,1956,"Regular",11,"Home","Collingwood","Essendon",54
5612,1956-06-30,"R11","Richmond",15,12,102,"Fitzroy",12,14,86,"Punt Rd",16,1956,"Regular",11,"Home","Richmond","Fitzroy",16
5613,1956-06-30,"R11","North Melbourne",5,9,39,"Footscray",6,13,49,"Arden St",-10,1956,"Regular",11,"Away","Footscray","North Melbourne",10
5614,1956-06-30,"R11","Geelong",9,8,62,"St Kilda",8,9,57,"Kardinia Park",5,1956,"Regular",11,"Home","Geelong","St Kilda",5
5615,1956-06-30,"R11","Hawthorn",5,12,42,"Melbourne",11,14,80,"Glenferrie Oval",-38,1956,"Regular",11,"Away","Melbourne","Hawthorn",38
5616,1956-07-07,"R12","Carlton",12,13,85,"Essendon",5,15,45,"Princes Park",40,1956,"Regular",12,"Home","Carlton","Essendon",40
5617,1956-07-07,"R12","Collingwood",11,18,84,"Hawthorn",8,10,58,"Victoria Park",26,1956,"Regular",12,"Home","Collingwood","Hawthorn",26
5618,1956-07-07,"R12","Fitzroy",7,9,51,"Footscray",9,7,61,"Brunswick St",-10,1956,"Regular",12,"Away","Footscray","Fitzroy",10
5619,1956-07-07,"R12","Geelong",10,7,67,"Sydney",3,8,26,"Kardinia Park",41,1956,"Regular",12,"Home","Geelong","Sydney",41
5620,1956-07-07,"R12","Melbourne",11,13,79,"Richmond",7,3,45,"M.C.G.",34,1956,"Regular",12,"Home","Melbourne","Richmond",34
5621,1956-07-07,"R12","St Kilda",20,9,129,"North Melbourne",7,9,51,"Junction Oval",78,1956,"Regular",12,"Home","St Kilda","North Melbourne",78
5622,1956-07-14,"R13","Melbourne",14,10,94,"Carlton",12,7,79,"M.C.G.",15,1956,"Regular",13,"Home","Melbourne","Carlton",15
5623,1956-07-14,"R13","Sydney",10,9,69,"Collingwood",11,9,75,"Lake Oval",-6,1956,"Regular",13,"Away","Collingwood","Sydney",6
5624,1956-07-14,"R13","Essendon",9,13,67,"Fitzroy",8,10,58,"Windy Hill",9,1956,"Regular",13,"Home","Essendon","Fitzroy",9
5625,1956-07-14,"R13","Footscray",11,13,79,"St Kilda",13,2,80,"Western Oval",-1,1956,"Regular",13,"Away","St Kilda","Footscray",1
5626,1956-07-14,"R13","North Melbourne",7,5,47,"Geelong",19,15,129,"Arden St",-82,1956,"Regular",13,"Away","Geelong","North Melbourne",82
5627,1956-07-14,"R13","Hawthorn",3,13,31,"Richmond",8,6,54,"Glenferrie Oval",-23,1956,"Regular",13,"Away","Richmond","Hawthorn",23
5628,1956-07-21,"R14","Carlton",8,18,66,"St Kilda",9,12,66,"Princes Park",0,1956,"Regular",14,"Home","Carlton","St Kilda",0
5629,1956-07-21,"R14","Collingwood",14,16,100,"Richmond",8,5,53,"Victoria Park",47,1956,"Regular",14,"Home","Collingwood","Richmond",47
5630,1956-07-21,"R14","Essendon",10,18,78,"North Melbourne",6,11,47,"Windy Hill",31,1956,"Regular",14,"Home","Essendon","North Melbourne",31
5631,1956-07-21,"R14","Sydney",11,15,81,"Fitzroy",15,15,105,"Lake Oval",-24,1956,"Regular",14,"Away","Fitzroy","Sydney",24
5632,1956-07-21,"R14","Melbourne",7,17,59,"Footscray",10,12,72,"M.C.G.",-13,1956,"Regular",14,"Away","Footscray","Melbourne",13
5633,1956-07-21,"R14","Geelong",12,13,85,"Hawthorn",10,14,74,"Kardinia Park",11,1956,"Regular",14,"Home","Geelong","Hawthorn",11
5634,1956-07-28,"R15","North Melbourne",4,8,32,"Carlton",11,16,82,"Arden St",-50,1956,"Regular",15,"Away","Carlton","North Melbourne",50
5635,1956-07-28,"R15","Footscray",11,6,72,"Collingwood",14,20,104,"Western Oval",-32,1956,"Regular",15,"Away","Collingwood","Footscray",32
5636,1956-07-28,"R15","St Kilda",6,11,47,"Essendon",7,7,49,"Junction Oval",-2,1956,"Regular",15,"Away","Essendon","St Kilda",2
5637,1956-07-28,"R15","Fitzroy",7,11,53,"Melbourne",11,15,81,"Brunswick St",-28,1956,"Regular",15,"Away","Melbourne","Fitzroy",28
5638,1956-07-28,"R15","Richmond",9,11,65,"Geelong",11,13,79,"Punt Rd",-14,1956,"Regular",15,"Away","Geelong","Richmond",14
5639,1956-07-28,"R15","Hawthorn",10,18,78,"Sydney",12,6,78,"Glenferrie Oval",0,1956,"Regular",15,"Home","Hawthorn","Sydney",0
5640,1956-08-04,"R16","Collingwood",9,17,71,"Carlton",12,12,84,"Victoria Park",-13,1956,"Regular",16,"Away","Carlton","Collingwood",13
5641,1956-08-04,"R16","Richmond",13,13,91,"Essendon",11,13,79,"Punt Rd",12,1956,"Regular",16,"Home","Richmond","Essendon",12
5642,1956-08-04,"R16","North Melbourne",14,21,105,"Fitzroy",8,8,56,"Arden St",49,1956,"Regular",16,"Home","North Melbourne","Fitzroy",49
5643,1956-08-04,"R16","Sydney",10,10,70,"Footscray",8,15,63,"Lake Oval",7,1956,"Regular",16,"Home","Sydney","Footscray",7
5644,1956-08-04,"R16","Geelong",8,10,58,"Melbourne",8,8,56,"Kardinia Park",2,1956,"Regular",16,"Home","Geelong","Melbourne",2
5645,1956-08-04,"R16","Hawthorn",15,8,98,"St Kilda",12,9,81,"Glenferrie Oval",17,1956,"Regular",16,"Home","Hawthorn","St Kilda",17
5646,1956-08-11,"R17","Carlton",7,24,66,"Richmond",10,11,71,"Princes Park",-5,1956,"Regular",17,"Away","Richmond","Carlton",5
5647,1956-08-11,"R17","Geelong",10,9,69,"Collingwood",15,11,101,"Kardinia Park",-32,1956,"Regular",17,"Away","Collingwood","Geelong",32
5648,1956-08-11,"R17","Essendon",11,10,76,"Sydney",7,16,58,"Windy Hill",18,1956,"Regular",17,"Home","Essendon","Sydney",18
5649,1956-08-11,"R17","St Kilda",6,7,43,"Fitzroy",8,8,56,"Junction Oval",-13,1956,"Regular",17,"Away","Fitzroy","St Kilda",13
5650,1956-08-11,"R17","Footscray",15,13,103,"Hawthorn",9,6,60,"Western Oval",43,1956,"Regular",17,"Home","Footscray","Hawthorn",43
5651,1956-08-11,"R17","Melbourne",16,18,114,"North Melbourne",11,5,71,"M.C.G.",43,1956,"Regular",17,"Home","Melbourne","North Melbourne",43
5652,1956-08-18,"R18","Carlton",6,9,45,"Footscray",8,14,62,"Princes Park",-17,1956,"Regular",18,"Away","Footscray","Carlton",17
5653,1956-08-18,"R18","Collingwood",9,6,60,"Melbourne",10,13,73,"Victoria Park",-13,1956,"Regular",18,"Away","Melbourne","Collingwood",13
5654,1956-08-18,"R18","Essendon",14,13,97,"Geelong",9,15,69,"Windy Hill",28,1956,"Regular",18,"Home","Essendon","Geelong",28
5655,1956-08-18,"R18","Fitzroy",9,16,70,"Hawthorn",10,17,77,"Brunswick St",-7,1956,"Regular",18,"Away","Hawthorn","Fitzroy",7
5656,1956-08-18,"R18","Sydney",13,9,87,"North Melbourne",7,13,55,"Lake Oval",32,1956,"Regular",18,"Home","Sydney","North Melbourne",32
5657,1956-08-18,"R18","Richmond",16,9,105,"St Kilda",16,14,110,"Punt Rd",-5,1956,"Regular",18,"Away","St Kilda","Richmond",5
5658,1956-08-25,"SF","Geelong",6,5,41,"Footscray",5,13,43,"M.C.G.",-2,1956,"Finals",19,"Away","Footscray","Geelong",2
5659,1956-09-01,"SF","Melbourne",11,14,80,"Collingwood",8,16,64,"M.C.G.",16,1956,"Finals",19,"Home","Melbourne","Collingwood",16
5660,1956-09-08,"PF","Collingwood",15,6,96,"Footscray",7,15,57,"M.C.G.",39,1956,"Finals",20,"Home","Collingwood","Footscray",39
5661,1956-09-15,"GF","Melbourne",17,19,121,"Collingwood",6,12,48,"M.C.G.",73,1956,"Finals",21,"Home","Melbourne","Collingwood",73
5662,1957-04-20,"R1","Carlton",10,6,66,"Hawthorn",15,12,102,"Princes Park",-36,1957,"Regular",1,"Away","Hawthorn","Carlton",36
5663,1957-04-20,"R1","Collingwood",8,10,58,"Essendon",13,15,93,"Victoria Park",-35,1957,"Regular",1,"Away","Essendon","Collingwood",35
5664,1957-04-20,"R1","St Kilda",12,16,88,"Sydney",7,17,59,"Junction Oval",29,1957,"Regular",1,"Home","St Kilda","Sydney",29
5665,1957-04-22,"R1","Fitzroy",7,11,53,"Melbourne",6,14,50,"Brunswick St",3,1957,"Regular",1,"Home","Fitzroy","Melbourne",3
5666,1957-04-22,"R1","Geelong",11,11,77,"Footscray",10,17,77,"Kardinia Park",0,1957,"Regular",1,"Home","Geelong","Footscray",0
5667,1957-04-22,"R1","Richmond",19,14,128,"North Melbourne",15,15,105,"Punt Rd",23,1957,"Regular",1,"Home","Richmond","North Melbourne",23
5668,1957-04-27,"R2","Sydney",6,16,52,"Carlton",10,16,76,"Lake Oval",-24,1957,"Regular",2,"Away","Carlton","Sydney",24
5669,1957-04-27,"R2","Melbourne",10,20,80,"Collingwood",10,12,72,"M.C.G.",8,1957,"Regular",2,"Home","Melbourne","Collingwood",8
5670,1957-04-27,"R2","Essendon",11,8,74,"Fitzroy",8,15,63,"Windy Hill",11,1957,"Regular",2,"Home","Essendon","Fitzroy",11
5671,1957-04-27,"R2","Footscray",12,13,85,"St Kilda",7,11,53,"Western Oval",32,1957,"Regular",2,"Home","Footscray","St Kilda",32
5672,1957-04-27,"R2","North Melbourne",9,13,67,"Geelong",10,13,73,"Arden St",-6,1957,"Regular",2,"Away","Geelong","North Melbourne",6
5673,1957-04-27,"R2","Hawthorn",9,22,76,"Richmond",8,9,57,"Glenferrie Oval",19,1957,"Regular",2,"Home","Hawthorn","Richmond",19
5674,1957-05-04,"R3","Footscray",9,10,64,"Carlton",7,9,51,"Western Oval",13,1957,"Regular",3,"Home","Footscray","Carlton",13
5675,1957-05-04,"R3","Geelong",12,5,77,"Collingwood",12,15,87,"Kardinia Park",-10,1957,"Regular",3,"Away","Collingwood","Geelong",10
5676,1957-05-04,"R3","Melbourne",11,20,86,"Essendon",5,11,41,"M.C.G.",45,1957,"Regular",3,"Home","Melbourne","Essendon",45
5677,1957-05-04,"R3","Fitzroy",12,16,88,"St Kilda",9,11,65,"Brunswick St",23,1957,"Regular",3,"Home","Fitzroy","St Kilda",23
5678,1957-05-04,"R3","North Melbourne",13,9,87,"Hawthorn",11,12,78,"Arden St",9,1957,"Regular",3,"Home","North Melbourne","Hawthorn",9
5679,1957-05-04,"R3","Sydney",19,16,130,"Richmond",13,9,87,"Lake Oval",43,1957,"Regular",3,"Home","Sydney","Richmond",43
5680,1957-05-11,"R4","Carlton",15,12,102,"Geelong",13,11,89,"Princes Park",13,1957,"Regular",4,"Home","Carlton","Geelong",13
5681,1957-05-11,"R4","Collingwood",14,9,93,"Sydney",11,17,83,"Victoria Park",10,1957,"Regular",4,"Home","Collingwood","Sydney",10
5682,1957-05-11,"R4","Essendon",11,14,80,"Footscray",4,14,38,"Windy Hill",42,1957,"Regular",4,"Home","Essendon","Footscray",42
5683,1957-05-11,"R4","Richmond",16,10,106,"Fitzroy",10,31,91,"Punt Rd",15,1957,"Regular",4,"Home","Richmond","Fitzroy",15
5684,1957-05-11,"R4","Hawthorn",6,15,51,"Melbourne",4,9,33,"Glenferrie Oval",18,1957,"Regular",4,"Home","Hawthorn","Melbourne",18
5685,1957-05-11,"R4","St Kilda",16,5,101,"North Melbourne",12,12,84,"Junction Oval",17,1957,"Regular",4,"Home","St Kilda","North Melbourne",17
5686,1957-05-18,"R5","Carlton",16,22,118,"Richmond",13,16,94,"Princes Park",24,1957,"Regular",5,"Home","Carlton","Richmond",24
5687,1957-05-18,"R5","Collingwood",12,12,84,"Fitzroy",13,4,82,"Victoria Park",2,1957,"Regular",5,"Home","Collingwood","Fitzroy",2
5688,1957-05-18,"R5","Sydney",7,16,58,"Essendon",14,16,100,"Lake Oval",-42,1957,"Regular",5,"Away","Essendon","Sydney",42
5689,1957-05-18,"R5","North Melbourne",9,16,70,"Footscray",9,14,68,"Arden St",2,1957,"Regular",5,"Home","North Melbourne","Footscray",2
5690,1957-05-18,"R5","Geelong",9,10,64,"Hawthorn",3,19,37,"Kardinia Park",27,1957,"Regular",5,"Home","Geelong","Hawthorn",27
5691,1957-05-18,"R5","Melbourne",17,17,119,"St Kilda",13,12,90,"M.C.G.",29,1957,"Regular",5,"Home","Melbourne","St Kilda",29
5692,1957-05-25,"R6","Fitzroy",12,10,82,"Carlton",14,12,96,"Brunswick St",-14,1957,"Regular",6,"Away","Carlton","Fitzroy",14
5693,1957-05-25,"R6","North Melbourne",13,13,91,"Collingwood",10,16,76,"Arden St",15,1957,"Regular",6,"Home","North Melbourne","Collingwood",15
5694,1957-05-25,"R6","Essendon",9,12,66,"Hawthorn",11,8,74,"Windy Hill",-8,1957,"Regular",6,"Away","Hawthorn","Essendon",8
5695,1957-05-25,"R6","Footscray",14,14,98,"Richmond",10,19,79,"Western Oval",19,1957,"Regular",6,"Home","Footscray","Richmond",19
5696,1957-05-25,"R6","St Kilda",10,13,73,"Geelong",13,5,83,"Junction Oval",-10,1957,"Regular",6,"Away","Geelong","St Kilda",10
5697,1957-05-25,"R6","Melbourne",17,12,114,"Sydney",6,15,51,"M.C.G.",63,1957,"Regular",6,"Home","Melbourne","Sydney",63
5698,1957-06-01,"R7","Carlton",13,9,87,"Essendon",7,20,62,"Princes Park",25,1957,"Regular",7,"Home","Carlton","Essendon",25
5699,1957-06-01,"R7","Collingwood",12,16,88,"St Kilda",8,9,57,"Victoria Park",31,1957,"Regular",7,"Home","Collingwood","St Kilda",31
5700,1957-06-01,"R7","Geelong",14,15,99,"Fitzroy",17,11,113,"Kardinia Park",-14,1957,"Regular",7,"Away","Fitzroy","Geelong",14
5701,1957-06-01,"R7","Hawthorn",11,11,77,"Footscray",7,8,50,"Glenferrie Oval",27,1957,"Regular",7,"Home","Hawthorn","Footscray",27
5702,1957-06-01,"R7","Richmond",7,10,52,"Melbourne",6,14,50,"Punt Rd",2,1957,"Regular",7,"Home","Richmond","Melbourne",2
5703,1957-06-01,"R7","Sydney",11,9,75,"North Melbourne",11,13,79,"Lake Oval",-4,1957,"Regular",7,"Away","North Melbourne","Sydney",4
5704,1957-06-08,"R8","Carlton",10,11,71,"Melbourne",14,15,99,"Princes Park",-28,1957,"Regular",8,"Away","Melbourne","Carlton",28
5705,1957-06-08,"R8","Footscray",12,17,89,"Collingwood",6,4,40,"Western Oval",49,1957,"Regular",8,"Home","Footscray","Collingwood",49
5706,1957-06-08,"R8","Essendon",21,12,138,"Geelong",15,12,102,"Windy Hill",36,1957,"Regular",8,"Home","Essendon","Geelong",36
5707,1957-06-08,"R8","Fitzroy",10,11,71,"North Melbourne",10,17,77,"Brunswick St",-6,1957,"Regular",8,"Away","North Melbourne","Fitzroy",6
5708,1957-06-08,"R8","Sydney",9,14,68,"Hawthorn",13,11,89,"Lake Oval",-21,1957,"Regular",8,"Away","Hawthorn","Sydney",21
5709,1957-06-08,"R8","Richmond",11,15,81,"St Kilda",10,19,79,"Punt Rd",2,1957,"Regular",8,"Home","Richmond","St Kilda",2
5710,1957-06-15,"R9","North Melbourne",7,14,56,"Carlton",8,15,63,"Arden St",-7,1957,"Regular",9,"Away","Carlton","North Melbourne",7
5711,1957-06-15,"R9","Collingwood",12,13,85,"Richmond",13,14,92,"Victoria Park",-7,1957,"Regular",9,"Away","Richmond","Collingwood",7
5712,1957-06-15,"R9","St Kilda",3,12,30,"Essendon",9,21,75,"Junction Oval",-45,1957,"Regular",9,"Away","Essendon","St Kilda",45
5713,1957-06-17,"R9","Hawthorn",15,14,104,"Fitzroy",7,14,56,"Glenferrie Oval",48,1957,"Regular",9,"Home","Hawthorn","Fitzroy",48
5714,1957-06-17,"R9","Footscray",12,15,87,"Sydney",8,12,60,"Western Oval",27,1957,"Regular",9,"Home","Footscray","Sydney",27
5715,1957-06-17,"R9","Melbourne",23,16,154,"Geelong",14,10,94,"M.C.G.",60,1957,"Regular",9,"Home","Melbourne","Geelong",60
5716,1957-06-22,"R10","Collingwood",14,16,100,"Carlton",9,9,63,"Victoria Park",37,1957,"Regular",10,"Home","Collingwood","Carlton",37
5717,1957-06-22,"R10","Richmond",13,10,88,"Essendon",7,19,61,"Punt Rd",27,1957,"Regular",10,"Home","Richmond","Essendon",27
5718,1957-06-22,"R10","Fitzroy",9,14,68,"Footscray",14,14,98,"Brunswick St",-30,1957,"Regular",10,"Away","Footscray","Fitzroy",30
5719,1957-06-22,"R10","Geelong",10,8,68,"Sydney",10,10,70,"Kardinia Park",-2,1957,"Regular",10,"Away","Sydney","Geelong",2
5720,1957-06-22,"R10","St Kilda",10,15,75,"Hawthorn",8,11,59,"Junction Oval",16,1957,"Regular",10,"Home","St Kilda","Hawthorn",16
5721,1957-06-22,"R10","North Melbourne",11,12,78,"Melbourne",16,13,109,"Arden St",-31,1957,"Regular",10,"Away","Melbourne","North Melbourne",31
5722,1957-06-29,"R11","Carlton",13,14,92,"St Kilda",7,13,55,"Princes Park",37,1957,"Regular",11,"Home","Carlton","St Kilda",37
5723,1957-06-29,"R11","Hawthorn",10,14,74,"Collingwood",13,15,93,"Glenferrie Oval",-19,1957,"Regular",11,"Away","Collingwood","Hawthorn",19
5724,1957-06-29,"R11","Essendon",11,14,80,"North Melbourne",13,11,89,"Windy Hill",-9,1957,"Regular",11,"Away","North Melbourne","Essendon",9
5725,1957-06-29,"R11","Sydney",15,19,109,"Fitzroy",14,12,96,"Lake Oval",13,1957,"Regular",11,"Home","Sydney","Fitzroy",13
5726,1957-06-29,"R11","Melbourne",12,15,87,"Footscray",7,9,51,"M.C.G.",36,1957,"Regular",11,"Home","Melbourne","Footscray",36
5727,1957-06-29,"R11","Geelong",10,9,69,"Richmond",14,8,92,"Kardinia Park",-23,1957,"Regular",11,"Away","Richmond","Geelong",23
5728,1957-07-06,"R12","Hawthorn",7,10,52,"Carlton",8,13,61,"Glenferrie Oval",-9,1957,"Regular",12,"Away","Carlton","Hawthorn",9
5729,1957-07-06,"R12","Essendon",12,16,88,"Collingwood",10,13,73,"Windy Hill",15,1957,"Regular",12,"Home","Essendon","Collingwood",15
5730,1957-07-06,"R12","Melbourne",24,14,158,"Fitzroy",10,14,74,"M.C.G.",84,1957,"Regular",12,"Home","Melbourne","Fitzroy",84
5731,1957-07-06,"R12","Footscray",9,11,65,"Geelong",9,10,64,"Western Oval",1,1957,"Regular",12,"Home","Footscray","Geelong",1
5732,1957-07-06,"R12","North Melbourne",17,15,117,"Richmond",10,13,73,"Arden St",44,1957,"Regular",12,"Home","North Melbourne","Richmond",44
5733,1957-07-06,"R12","Sydney",11,15,81,"St Kilda",9,17,71,"Lake Oval",10,1957,"Regular",12,"Home","Sydney","St Kilda",10
5734,1957-07-13,"R13","Carlton",11,15,81,"Sydney",10,5,65,"Princes Park",16,1957,"Regular",13,"Home","Carlton","Sydney",16
5735,1957-07-13,"R13","Collingwood",7,7,49,"Melbourne",6,13,49,"Victoria Park",0,1957,"Regular",13,"Home","Collingwood","Melbourne",0
5736,1957-07-13,"R13","Fitzroy",7,10,52,"Essendon",9,18,72,"Brunswick St",-20,1957,"Regular",13,"Away","Essendon","Fitzroy",20
5737,1957-07-13,"R13","St Kilda",14,16,100,"Footscray",14,8,92,"Junction Oval",8,1957,"Regular",13,"Home","St Kilda","Footscray",8
5738,1957-07-13,"R13","Geelong",12,15,87,"North Melbourne",8,13,61,"Kardinia Park",26,1957,"Regular",13,"Home","Geelong","North Melbourne",26
5739,1957-07-13,"R13","Richmond",11,12,78,"Hawthorn",10,15,75,"Punt Rd",3,1957,"Regular",13,"Home","Richmond","Hawthorn",3
5740,1957-07-27,"R14","Carlton",11,13,79,"Footscray",7,10,52,"Princes Park",27,1957,"Regular",14,"Home","Carlton","Footscray",27
5741,1957-07-27,"R14","Collingwood",13,14,92,"Geelong",6,8,44,"Victoria Park",48,1957,"Regular",14,"Home","Collingwood","Geelong",48
5742,1957-07-27,"R14","Essendon",9,18,72,"Melbourne",11,7,73,"Windy Hill",-1,1957,"Regular",14,"Away","Melbourne","Essendon",1
5743,1957-07-27,"R14","St Kilda",15,18,108,"Fitzroy",8,8,56,"Junction Oval",52,1957,"Regular",14,"Home","St Kilda","Fitzroy",52
5744,1957-07-27,"R14","Hawthorn",7,13,55,"North Melbourne",5,4,34,"Glenferrie Oval",21,1957,"Regular",14,"Home","Hawthorn","North Melbourne",21
5745,1957-07-27,"R14","Richmond",10,13,73,"Sydney",11,12,78,"Punt Rd",-5,1957,"Regular",14,"Away","Sydney","Richmond",5
5746,1957-08-03,"R15","Geelong",11,19,85,"Carlton",6,7,43,"Kardinia Park",42,1957,"Regular",15,"Home","Geelong","Carlton",42
5747,1957-08-03,"R15","Sydney",9,13,67,"Collingwood",12,19,91,"Lake Oval",-24,1957,"Regular",15,"Away","Collingwood","Sydney",24
5748,1957-08-03,"R15","Footscray",7,8,50,"Essendon",12,11,83,"Western Oval",-33,1957,"Regular",15,"Away","Essendon","Footscray",33
5749,1957-08-03,"R15","Fitzroy",15,13,103,"Richmond",13,13,91,"Brunswick St",12,1957,"Regular",15,"Home","Fitzroy","Richmond",12
5750,1957-08-03,"R15","Melbourne",8,18,66,"Hawthorn",10,13,73,"M.C.G.",-7,1957,"Regular",15,"Away","Hawthorn","Melbourne",7
5751,1957-08-03,"R15","North Melbourne",13,11,89,"St Kilda",14,9,93,"Arden St",-4,1957,"Regular",15,"Away","St Kilda","North Melbourne",4
5752,1957-08-10,"R16","Richmond",11,9,75,"Carlton",7,9,51,"Punt Rd",24,1957,"Regular",16,"Home","Richmond","Carlton",24
5753,1957-08-10,"R16","Fitzroy",8,14,62,"Collingwood",8,13,61,"Brunswick St",1,1957,"Regular",16,"Home","Fitzroy","Collingwood",1
5754,1957-08-10,"R16","Essendon",10,15,75,"Sydney",7,13,55,"Windy Hill",20,1957,"Regular",16,"Home","Essendon","Sydney",20
5755,1957-08-10,"R16","Footscray",6,6,42,"North Melbourne",8,13,61,"Western Oval",-19,1957,"Regular",16,"Away","North Melbourne","Footscray",19
5756,1957-08-10,"R16","Hawthorn",14,19,103,"Geelong",8,7,55,"Glenferrie Oval",48,1957,"Regular",16,"Home","Hawthorn","Geelong",48
5757,1957-08-10,"R16","St Kilda",1,5,11,"Melbourne",6,13,49,"Junction Oval",-38,1957,"Regular",16,"Away","Melbourne","St Kilda",38
5758,1957-08-17,"R17","Carlton",11,13,79,"Fitzroy",5,11,41,"Princes Park",38,1957,"Regular",17,"Home","Carlton","Fitzroy",38
5759,1957-08-17,"R17","Collingwood",13,14,92,"North Melbourne",11,13,79,"Victoria Park",13,1957,"Regular",17,"Home","Collingwood","North Melbourne",13
5760,1957-08-17,"R17","Hawthorn",13,7,85,"Essendon",9,10,64,"Glenferrie Oval",21,1957,"Regular",17,"Home","Hawthorn","Essendon",21
5761,1957-08-17,"R17","Richmond",13,11,89,"Footscray",14,14,98,"Punt Rd",-9,1957,"Regular",17,"Away","Footscray","Richmond",9
5762,1957-08-17,"R17","Geelong",8,10,58,"St Kilda",10,13,73,"Kardinia Park",-15,1957,"Regular",17,"Away","St Kilda","Geelong",15
5763,1957-08-17,"R17","Sydney",11,9,75,"Melbourne",9,17,71,"Lake Oval",4,1957,"Regular",17,"Home","Sydney","Melbourne",4
5764,1957-08-24,"R18","Essendon",17,21,123,"Carlton",9,8,62,"Windy Hill",61,1957,"Regular",18,"Home","Essendon","Carlton",61
5765,1957-08-24,"R18","St Kilda",14,12,96,"Collingwood",7,14,56,"Junction Oval",40,1957,"Regular",18,"Home","St Kilda","Collingwood",40
5766,1957-08-24,"R18","Fitzroy",15,14,104,"Geelong",10,20,80,"Brunswick St",24,1957,"Regular",18,"Home","Fitzroy","Geelong",24
5767,1957-08-24,"R18","Footscray",8,11,59,"Hawthorn",7,15,57,"Western Oval",2,1957,"Regular",18,"Home","Footscray","Hawthorn",2
5768,1957-08-24,"R18","Melbourne",18,12,120,"Richmond",10,11,71,"M.C.G.",49,1957,"Regular",18,"Home","Melbourne","Richmond",49
5769,1957-08-24,"R18","North Melbourne",10,20,80,"Sydney",17,11,113,"Arden St",-33,1957,"Regular",18,"Away","Sydney","North Melbourne",33
5770,1957-08-31,"SF","Hawthorn",10,11,71,"Carlton",6,12,48,"M.C.G.",23,1957,"Finals",19,"Home","Hawthorn","Carlton",23
5771,1957-09-07,"SF","Melbourne",8,19,67,"Essendon",12,11,83,"M.C.G.",-16,1957,"Finals",19,"Away","Essendon","Melbourne",16
5772,1957-09-14,"PF","Melbourne",22,12,144,"Hawthorn",11,10,76,"M.C.G.",68,1957,"Finals",20,"Home","Melbourne","Hawthorn",68
5773,1957-09-21,"GF","Melbourne",17,14,116,"Essendon",7,13,55,"M.C.G.",61,1957,"Finals",21,"Home","Melbourne","Essendon",61
5774,1958-04-12,"R1","Melbourne",11,13,79,"Carlton",9,11,65,"M.C.G.",14,1958,"Regular",1,"Home","Melbourne","Carlton",14
5775,1958-04-12,"R1","Footscray",4,5,29,"Collingwood",12,11,83,"Western Oval",-54,1958,"Regular",1,"Away","Collingwood","Footscray",54
5776,1958-04-12,"R1","Essendon",13,17,95,"Geelong",8,10,58,"Windy Hill",37,1958,"Regular",1,"Home","Essendon","Geelong",37
5777,1958-04-12,"R1","North Melbourne",5,9,39,"Fitzroy",23,21,159,"Arden St",-120,1958,"Regular",1,"Away","Fitzroy","North Melbourne",120
5778,1958-04-12,"R1","Hawthorn",11,14,80,"St Kilda",11,13,79,"Glenferrie Oval",1,1958,"Regular",1,"Home","Hawthorn","St Kilda",1
5779,1958-04-12,"R1","Sydney",12,23,95,"Richmond",17,18,120,"Lake Oval",-25,1958,"Regular",1,"Away","Richmond","Sydney",25
5780,1958-04-19,"R2","Carlton",9,13,67,"North Melbourne",11,7,73,"Princes Park",-6,1958,"Regular",2,"Away","North Melbourne","Carlton",6
5781,1958-04-19,"R2","Collingwood",11,9,75,"Hawthorn",10,8,68,"Victoria Park",7,1958,"Regular",2,"Home","Collingwood","Hawthorn",7
5782,1958-04-19,"R2","St Kilda",17,18,120,"Essendon",11,16,82,"Junction Oval",38,1958,"Regular",2,"Home","St Kilda","Essendon",38
5783,1958-04-19,"R2","Fitzroy",11,18,84,"Sydney",10,15,75,"Brunswick St",9,1958,"Regular",2,"Home","Fitzroy","Sydney",9
5784,1958-04-19,"R2","Richmond",21,12,138,"Footscray",14,12,96,"Punt Rd",42,1958,"Regular",2,"Home","Richmond","Footscray",42
5785,1958-04-19,"R2","Geelong",6,6,42,"Melbourne",17,8,110,"Kardinia Park",-68,1958,"Regular",2,"Away","Melbourne","Geelong",68
5786,1958-04-26,"R3","Carlton",18,7,115,"Geelong",9,11,65,"Princes Park",50,1958,"Regular",3,"Home","Carlton","Geelong",50
5787,1958-04-26,"R3","Collingwood",7,15,57,"Fitzroy",7,10,52,"Victoria Park",5,1958,"Regular",3,"Home","Collingwood","Fitzroy",5
5788,1958-04-26,"R3","Hawthorn",10,14,74,"Essendon",7,6,48,"Glenferrie Oval",26,1958,"Regular",3,"Home","Hawthorn","Essendon",26
5789,1958-04-26,"R3","Sydney",13,18,96,"Footscray",24,13,157,"Lake Oval",-61,1958,"Regular",3,"Away","Footscray","Sydney",61
5790,1958-04-26,"R3","North Melbourne",7,9,51,"Melbourne",12,18,90,"Arden St",-39,1958,"Regular",3,"Away","Melbourne","North Melbourne",39
5791,1958-04-26,"R3","Richmond",11,17,83,"St Kilda",9,14,68,"Punt Rd",15,1958,"Regular",3,"Home","Richmond","St Kilda",15
5792,1958-05-03,"R4","St Kilda",12,21,93,"Carlton",8,7,55,"Junction Oval",38,1958,"Regular",4,"Home","St Kilda","Carlton",38
5793,1958-05-03,"R4","Essendon",13,9,87,"Collingwood",9,15,69,"Windy Hill",18,1958,"Regular",4,"Home","Essendon","Collingwood",18
5794,1958-05-03,"R4","Fitzroy",16,17,113,"Richmond",8,8,56,"Brunswick St",57,1958,"Regular",4,"Home","Fitzroy","Richmond",57
5795,1958-05-03,"R4","Footscray",7,12,54,"North Melbourne",6,4,40,"Western Oval",14,1958,"Regular",4,"Home","Footscray","North Melbourne",14
5796,1958-05-03,"R4","Geelong",8,11,59,"Sydney",8,12,60,"Kardinia Park",-1,1958,"Regular",4,"Away","Sydney","Geelong",1
5797,1958-05-03,"R4","Melbourne",11,10,76,"Hawthorn",9,14,68,"M.C.G.",8,1958,"Regular",4,"Home","Melbourne","Hawthorn",8
5798,1958-05-10,"R5","Collingwood",16,10,106,"Carlton",3,15,33,"Victoria Park",73,1958,"Regular",5,"Home","Collingwood","Carlton",73
5799,1958-05-10,"R5","Melbourne",15,12,102,"Essendon",12,15,87,"M.C.G.",15,1958,"Regular",5,"Home","Melbourne","Essendon",15
5800,1958-05-10,"R5","Fitzroy",16,14,110,"Footscray",7,12,54,"Brunswick St",56,1958,"Regular",5,"Home","Fitzroy","Footscray",56
5801,1958-05-10,"R5","Geelong",11,15,81,"Richmond",14,13,97,"Kardinia Park",-16,1958,"Regular",5,"Away","Richmond","Geelong",16
5802,1958-05-10,"R5","Hawthorn",17,18,120,"North Melbourne",9,4,58,"Glenferrie Oval",62,1958,"Regular",5,"Home","Hawthorn","North Melbourne",62
5803,1958-05-10,"R5","Sydney",14,8,92,"St Kilda",13,15,93,"Lake Oval",-1,1958,"Regular",5,"Away","St Kilda","Sydney",1
5804,1958-05-17,"R6","Carlton",4,16,40,"Fitzroy",8,11,59,"Princes Park",-19,1958,"Regular",6,"Away","Fitzroy","Carlton",19
5805,1958-05-17,"R6","Richmond",8,8,56,"Collingwood",13,17,95,"Punt Rd",-39,1958,"Regular",6,"Away","Collingwood","Richmond",39
5806,1958-05-17,"R6","North Melbourne",9,10,64,"Essendon",7,13,55,"Arden St",9,1958,"Regular",6,"Home","North Melbourne","Essendon",9
5807,1958-05-17,"R6","Footscray",6,22,58,"Geelong",10,15,75,"Western Oval",-17,1958,"Regular",6,"Away","Geelong","Footscray",17
5808,1958-05-17,"R6","Hawthorn",11,15,81,"Sydney",8,16,64,"Glenferrie Oval",17,1958,"Regular",6,"Home","Hawthorn","Sydney",17
5809,1958-05-17,"R6","St Kilda",12,7,79,"Melbourne",11,12,78,"Junction Oval",1,1958,"Regular",6,"Home","St Kilda","Melbourne",1
5810,1958-05-24,"R7","Sydney",10,19,79,"Carlton",7,15,57,"Lake Oval",22,1958,"Regular",7,"Home","Sydney","Carlton",22
5811,1958-05-24,"R7","North Melbourne",9,8,62,"Collingwood",7,17,59,"Arden St",3,1958,"Regular",7,"Home","North Melbourne","Collingwood",3
5812,1958-05-24,"R7","Essendon",11,16,82,"Richmond",9,14,68,"Windy Hill",14,1958,"Regular",7,"Home","Essendon","Richmond",14
5813,1958-05-24,"R7","Fitzroy",12,15,87,"Hawthorn",8,15,63,"Brunswick St",24,1958,"Regular",7,"Home","Fitzroy","Hawthorn",24
5814,1958-05-24,"R7","Melbourne",11,19,85,"Footscray",9,8,62,"M.C.G.",23,1958,"Regular",7,"Home","Melbourne","Footscray",23
5815,1958-05-24,"R7","Geelong",9,16,70,"St Kilda",6,8,44,"Kardinia Park",26,1958,"Regular",7,"Home","Geelong","St Kilda",26
5816,1958-05-31,"R8","Carlton",9,14,68,"Hawthorn",9,6,60,"Princes Park",8,1958,"Regular",8,"Home","Carlton","Hawthorn",8
5817,1958-05-31,"R8","Collingwood",20,20,140,"Sydney",9,12,66,"Victoria Park",74,1958,"Regular",8,"Home","Collingwood","Sydney",74
5818,1958-05-31,"R8","Footscray",16,11,107,"Essendon",13,14,92,"Western Oval",15,1958,"Regular",8,"Home","Footscray","Essendon",15
5819,1958-05-31,"R8","St Kilda",12,17,89,"Fitzroy",6,14,50,"Junction Oval",39,1958,"Regular",8,"Home","St Kilda","Fitzroy",39
5820,1958-05-31,"R8","Geelong",4,11,35,"North Melbourne",14,18,102,"Kardinia Park",-67,1958,"Regular",8,"Away","North Melbourne","Geelong",67
5821,1958-05-31,"R8","Melbourne",12,18,90,"Richmond",12,11,83,"M.C.G.",7,1958,"Regular",8,"Home","Melbourne","Richmond",7
5822,1958-06-07,"R9","Essendon",5,19,49,"Carlton",7,8,50,"Windy Hill",-1,1958,"Regular",9,"Away","Carlton","Essendon",1
5823,1958-06-07,"R9","Collingwood",12,23,95,"St Kilda",5,9,39,"Victoria Park",56,1958,"Regular",9,"Home","Collingwood","St Kilda",56
5824,1958-06-07,"R9","Fitzroy",8,18,66,"Geelong",6,15,51,"Brunswick St",15,1958,"Regular",9,"Home","Fitzroy","Geelong",15
5825,1958-06-07,"R9","Hawthorn",11,14,80,"Footscray",8,10,58,"Glenferrie Oval",22,1958,"Regular",9,"Home","Hawthorn","Footscray",22
5826,1958-06-07,"R9","Sydney",11,10,76,"Melbourne",16,12,108,"Lake Oval",-32,1958,"Regular",9,"Away","Melbourne","Sydney",32
5827,1958-06-07,"R9","Richmond",12,11,83,"North Melbourne",14,10,94,"Punt Rd",-11,1958,"Regular",9,"Away","North Melbourne","Richmond",11
5828,1958-06-14,"R10","Carlton",6,15,51,"Richmond",2,9,21,"Princes Park",30,1958,"Regular",10,"Home","Carlton","Richmond",30
5829,1958-06-14,"R10","Essendon",16,11,107,"Fitzroy",8,8,56,"Windy Hill",51,1958,"Regular",10,"Home","Essendon","Fitzroy",51
5830,1958-06-14,"R10","St Kilda",8,15,63,"Footscray",11,16,82,"Junction Oval",-19,1958,"Regular",10,"Away","Footscray","St Kilda",19
5831,1958-06-16,"R10","Melbourne",12,12,84,"Collingwood",10,13,73,"M.C.G.",11,1958,"Regular",10,"Home","Melbourne","Collingwood",11
5832,1958-06-16,"R10","Hawthorn",14,19,103,"Geelong",8,6,54,"Glenferrie Oval",49,1958,"Regular",10,"Home","Hawthorn","Geelong",49
5833,1958-06-16,"R10","North Melbourne",12,15,87,"Sydney",8,9,57,"Arden St",30,1958,"Regular",10,"Home","North Melbourne","Sydney",30
5834,1958-06-21,"R11","Footscray",11,8,74,"Carlton",10,24,84,"Western Oval",-10,1958,"Regular",11,"Away","Carlton","Footscray",10
5835,1958-06-21,"R11","Geelong",9,12,66,"Collingwood",14,15,99,"Kardinia Park",-33,1958,"Regular",11,"Away","Collingwood","Geelong",33
5836,1958-06-21,"R11","Sydney",8,13,61,"Essendon",15,13,103,"Lake Oval",-42,1958,"Regular",11,"Away","Essendon","Sydney",42
5837,1958-06-21,"R11","Fitzroy",12,16,88,"Melbourne",6,11,47,"Brunswick St",41,1958,"Regular",11,"Home","Fitzroy","Melbourne",41
5838,1958-06-21,"R11","Richmond",15,11,101,"Hawthorn",13,9,87,"Punt Rd",14,1958,"Regular",11,"Home","Richmond","Hawthorn",14
5839,1958-06-21,"R11","North Melbourne",8,12,60,"St Kilda",5,5,35,"Arden St",25,1958,"Regular",11,"Home","North Melbourne","St Kilda",25
5840,1958-06-28,"R12","Carlton",9,14,68,"Melbourne",12,12,84,"Princes Park",-16,1958,"Regular",12,"Away","Melbourne","Carlton",16
5841,1958-06-28,"R12","Collingwood",12,13,85,"Footscray",10,14,74,"Victoria Park",11,1958,"Regular",12,"Home","Collingwood","Footscray",11
5842,1958-06-28,"R12","Geelong",15,9,99,"Essendon",12,12,84,"Kardinia Park",15,1958,"Regular",12,"Home","Geelong","Essendon",15
5843,1958-06-28,"R12","Fitzroy",12,17,89,"North Melbourne",7,16,58,"Brunswick St",31,1958,"Regular",12,"Home","Fitzroy","North Melbourne",31
5844,1958-06-28,"R12","St Kilda",11,14,80,"Hawthorn",14,14,98,"Junction Oval",-18,1958,"Regular",12,"Away","Hawthorn","St Kilda",18
5845,1958-06-28,"R12","Richmond",12,13,85,"Sydney",11,8,74,"Punt Rd",11,1958,"Regular",12,"Home","Richmond","Sydney",11
5846,1958-07-19,"R13","North Melbourne",8,9,57,"Carlton",6,9,45,"Arden St",12,1958,"Regular",13,"Home","North Melbourne","Carlton",12
5847,1958-07-19,"R13","Hawthorn",12,14,86,"Collingwood",14,9,93,"Glenferrie Oval",-7,1958,"Regular",13,"Away","Collingwood","Hawthorn",7
5848,1958-07-19,"R13","Essendon",17,30,132,"St Kilda",8,9,57,"Windy Hill",75,1958,"Regular",13,"Home","Essendon","St Kilda",75
5849,1958-07-19,"R13","Sydney",19,6,120,"Fitzroy",11,22,88,"Lake Oval",32,1958,"Regular",13,"Home","Sydney","Fitzroy",32
5850,1958-07-19,"R13","Footscray",14,12,96,"Richmond",2,11,23,"Western Oval",73,1958,"Regular",13,"Home","Footscray","Richmond",73
5851,1958-07-19,"R13","Melbourne",16,22,118,"Geelong",12,12,84,"M.C.G.",34,1958,"Regular",13,"Home","Melbourne","Geelong",34
5852,1958-07-26,"R14","Geelong",7,11,53,"Carlton",8,21,69,"Kardinia Park",-16,1958,"Regular",14,"Away","Carlton","Geelong",16
5853,1958-07-26,"R14","Fitzroy",15,15,105,"Collingwood",8,9,57,"Brunswick St",48,1958,"Regular",14,"Home","Fitzroy","Collingwood",48
5854,1958-07-26,"R14","Essendon",11,15,81,"Hawthorn",7,7,49,"Windy Hill",32,1958,"Regular",14,"Home","Essendon","Hawthorn",32
5855,1958-07-26,"R14","Footscray",8,15,63,"Sydney",14,12,96,"Western Oval",-33,1958,"Regular",14,"Away","Sydney","Footscray",33
5856,1958-07-26,"R14","Melbourne",10,12,72,"North Melbourne",8,15,63,"M.C.G.",9,1958,"Regular",14,"Home","Melbourne","North Melbourne",9
5857,1958-07-26,"R14","St Kilda",10,12,72,"Richmond",9,10,64,"Junction Oval",8,1958,"Regular",14,"Home","St Kilda","Richmond",8
5858,1958-08-02,"R15","Carlton",8,11,59,"St Kilda",7,12,54,"Princes Park",5,1958,"Regular",15,"Home","Carlton","St Kilda",5
5859,1958-08-02,"R15","Collingwood",11,9,75,"Essendon",12,14,86,"Victoria Park",-11,1958,"Regular",15,"Away","Essendon","Collingwood",11
5860,1958-08-02,"R15","Richmond",10,8,68,"Fitzroy",19,18,132,"Punt Rd",-64,1958,"Regular",15,"Away","Fitzroy","Richmond",64
5861,1958-08-02,"R15","North Melbourne",11,13,79,"Footscray",9,8,62,"Arden St",17,1958,"Regular",15,"Home","North Melbourne","Footscray",17
5862,1958-08-02,"R15","Sydney",16,13,109,"Geelong",14,17,101,"Lake Oval",8,1958,"Regular",15,"Home","Sydney","Geelong",8
5863,1958-08-02,"R15","Hawthorn",12,15,87,"Melbourne",14,11,95,"Glenferrie Oval",-8,1958,"Regular",15,"Away","Melbourne","Hawthorn",8
5864,1958-08-09,"R16","Carlton",7,11,53,"Collingwood",10,12,72,"Princes Park",-19,1958,"Regular",16,"Away","Collingwood","Carlton",19
5865,1958-08-09,"R16","Essendon",11,12,78,"Melbourne",10,15,75,"Windy Hill",3,1958,"Regular",16,"Home","Essendon","Melbourne",3
5866,1958-08-09,"R16","Footscray",20,11,131,"Fitzroy",5,11,41,"Western Oval",90,1958,"Regular",16,"Home","Footscray","Fitzroy",90
5867,1958-08-09,"R16","Richmond",12,18,90,"Geelong",9,15,69,"Punt Rd",21,1958,"Regular",16,"Home","Richmond","Geelong",21
5868,1958-08-09,"R16","North Melbourne",7,18,60,"Hawthorn",13,14,92,"Arden St",-32,1958,"Regular",16,"Away","Hawthorn","North Melbourne",32
5869,1958-08-09,"R16","St Kilda",9,23,77,"Sydney",15,9,99,"Junction Oval",-22,1958,"Regular",16,"Away","Sydney","St Kilda",22
5870,1958-08-16,"R17","Fitzroy",15,11,101,"Carlton",13,18,96,"Brunswick St",5,1958,"Regular",17,"Home","Fitzroy","Carlton",5
5871,1958-08-16,"R17","Collingwood",16,11,107,"Richmond",13,10,88,"Victoria Park",19,1958,"Regular",17,"Home","Collingwood","Richmond",19
5872,1958-08-16,"R17","Essendon",8,14,62,"North Melbourne",11,14,80,"Windy Hill",-18,1958,"Regular",17,"Away","North Melbourne","Essendon",18
5873,1958-08-16,"R17","Geelong",13,14,92,"Footscray",12,13,85,"Kardinia Park",7,1958,"Regular",17,"Home","Geelong","Footscray",7
5874,1958-08-16,"R17","Sydney",6,14,50,"Hawthorn",6,12,48,"Lake Oval",2,1958,"Regular",17,"Home","Sydney","Hawthorn",2
5875,1958-08-16,"R17","Melbourne",21,11,137,"St Kilda",13,9,87,"M.C.G.",50,1958,"Regular",17,"Home","Melbourne","St Kilda",50
5876,1958-08-23,"R18","Carlton",12,11,83,"Sydney",10,21,81,"Princes Park",2,1958,"Regular",18,"Home","Carlton","Sydney",2
5877,1958-08-23,"R18","Collingwood",12,16,88,"North Melbourne",14,17,101,"Victoria Park",-13,1958,"Regular",18,"Away","North Melbourne","Collingwood",13
5878,1958-08-23,"R18","Richmond",15,11,101,"Essendon",16,13,109,"Punt Rd",-8,1958,"Regular",18,"Away","Essendon","Richmond",8
5879,1958-08-23,"R18","Hawthorn",11,9,75,"Fitzroy",10,11,71,"Glenferrie Oval",4,1958,"Regular",18,"Home","Hawthorn","Fitzroy",4
5880,1958-08-23,"R18","Footscray",8,11,59,"Melbourne",10,18,78,"Western Oval",-19,1958,"Regular",18,"Away","Melbourne","Footscray",19
5881,1958-08-23,"R18","St Kilda",16,15,111,"Geelong",5,8,38,"Junction Oval",73,1958,"Regular",18,"Home","St Kilda","Geelong",73
5882,1958-08-30,"SF","Fitzroy",9,12,66,"North Melbourne",10,10,70,"M.C.G.",-4,1958,"Finals",19,"Away","North Melbourne","Fitzroy",4
5883,1958-09-06,"SF","Melbourne",11,12,78,"Collingwood",4,9,33,"M.C.G.",45,1958,"Finals",19,"Home","Melbourne","Collingwood",45
5884,1958-09-13,"PF","Collingwood",14,12,96,"North Melbourne",10,16,76,"M.C.G.",20,1958,"Finals",20,"Home","Collingwood","North Melbourne",20
5885,1958-09-20,"GF","Melbourne",9,10,64,"Collingwood",12,10,82,"M.C.G.",-18,1958,"Finals",21,"Away","Collingwood","Melbourne",18
5886,1959-04-18,"R1","Carlton",13,20,98,"Essendon",11,18,84,"Princes Park",14,1959,"Regular",1,"Home","Carlton","Essendon",14
5887,1959-04-18,"R1","Collingwood",7,18,60,"Sydney",14,17,101,"Victoria Park",-41,1959,"Regular",1,"Away","Sydney","Collingwood",41
5888,1959-04-18,"R1","Fitzroy",19,17,131,"Hawthorn",17,18,120,"Brunswick St",11,1959,"Regular",1,"Home","Fitzroy","Hawthorn",11
5889,1959-04-18,"R1","St Kilda",9,15,69,"Footscray",6,13,49,"Junction Oval",20,1959,"Regular",1,"Home","St Kilda","Footscray",20
5890,1959-04-18,"R1","Geelong",8,15,63,"North Melbourne",12,14,86,"Kardinia Park",-23,1959,"Regular",1,"Away","North Melbourne","Geelong",23
5891,1959-04-18,"R1","Richmond",10,10,70,"Melbourne",16,21,117,"Punt Rd",-47,1959,"Regular",1,"Away","Melbourne","Richmond",47
5892,1959-05-02,"R2","Footscray",8,7,55,"Carlton",15,14,104,"Western Oval",-49,1959,"Regular",2,"Away","Carlton","Footscray",49
5893,1959-05-02,"R2","Melbourne",13,14,92,"Collingwood",12,7,79,"M.C.G.",13,1959,"Regular",2,"Home","Melbourne","Collingwood",13
5894,1959-05-02,"R2","Essendon",18,15,123,"St Kilda",12,15,87,"Windy Hill",36,1959,"Regular",2,"Home","Essendon","St Kilda",36
5895,1959-05-02,"R2","Sydney",13,21,99,"Fitzroy",12,11,83,"Lake Oval",16,1959,"Regular",2,"Home","Sydney","Fitzroy",16
5896,1959-05-02,"R2","Hawthorn",18,15,123,"Geelong",12,12,84,"Glenferrie Oval",39,1959,"Regular",2,"Home","Hawthorn","Geelong",39
5897,1959-05-02,"R2","North Melbourne",16,12,108,"Richmond",10,20,80,"Arden St",28,1959,"Regular",2,"Home","North Melbourne","Richmond",28
5898,1959-05-09,"R3","Collingwood",9,8,62,"Carlton",14,10,94,"Victoria Park",-32,1959,"Regular",3,"Away","Carlton","Collingwood",32
5899,1959-05-09,"R3","Sydney",9,11,65,"Essendon",7,10,52,"Lake Oval",13,1959,"Regular",3,"Home","Sydney","Essendon",13
5900,1959-05-09,"R3","Fitzroy",13,9,87,"Melbourne",11,8,74,"Brunswick St",13,1959,"Regular",3,"Home","Fitzroy","Melbourne",13
5901,1959-05-09,"R3","Footscray",8,10,58,"Hawthorn",15,12,102,"Western Oval",-44,1959,"Regular",3,"Away","Hawthorn","Footscray",44
5902,1959-05-09,"R3","Richmond",10,11,71,"Geelong",14,12,96,"Punt Rd",-25,1959,"Regular",3,"Away","Geelong","Richmond",25
5903,1959-05-09,"R3","North Melbourne",9,9,63,"St Kilda",8,10,58,"Arden St",5,1959,"Regular",3,"Home","North Melbourne","St Kilda",5
5904,1959-05-16,"R4","Carlton",14,17,101,"Richmond",9,7,61,"Princes Park",40,1959,"Regular",4,"Home","Carlton","Richmond",40
5905,1959-05-16,"R4","St Kilda",12,19,91,"Collingwood",8,16,64,"Junction Oval",27,1959,"Regular",4,"Home","St Kilda","Collingwood",27
5906,1959-05-16,"R4","Essendon",8,14,62,"North Melbourne",11,11,77,"Windy Hill",-15,1959,"Regular",4,"Away","North Melbourne","Essendon",15
5907,1959-05-16,"R4","Geelong",13,12,90,"Fitzroy",12,8,80,"Kardinia Park",10,1959,"Regular",4,"Home","Geelong","Fitzroy",10
5908,1959-05-16,"R4","Melbourne",19,17,131,"Footscray",9,12,66,"M.C.G.",65,1959,"Regular",4,"Home","Melbourne","Footscray",65
5909,1959-05-16,"R4","Hawthorn",19,14,128,"Sydney",13,19,97,"Glenferrie Oval",31,1959,"Regular",4,"Home","Hawthorn","Sydney",31
5910,1959-05-23,"R5","Carlton",10,13,73,"Melbourne",9,7,61,"Princes Park",12,1959,"Regular",5,"Home","Carlton","Melbourne",12
5911,1959-05-23,"R5","Richmond",13,20,98,"Collingwood",11,13,79,"Punt Rd",19,1959,"Regular",5,"Home","Richmond","Collingwood",19
5912,1959-05-23,"R5","Essendon",11,18,84,"Geelong",7,12,54,"Windy Hill",30,1959,"Regular",5,"Home","Essendon","Geelong",30
5913,1959-05-23,"R5","North Melbourne",11,10,76,"Fitzroy",9,19,73,"Arden St",3,1959,"Regular",5,"Home","North Melbourne","Fitzroy",3
5914,1959-05-23,"R5","Footscray",17,11,113,"Sydney",13,8,86,"Western Oval",27,1959,"Regular",5,"Home","Footscray","Sydney",27
5915,1959-05-23,"R5","St Kilda",10,21,81,"Hawthorn",11,11,77,"Junction Oval",4,1959,"Regular",5,"Home","St Kilda","Hawthorn",4
5916,1959-05-30,"R6","Hawthorn",11,9,75,"Carlton",12,11,83,"Glenferrie Oval",-8,1959,"Regular",6,"Away","Carlton","Hawthorn",8
5917,1959-05-30,"R6","Collingwood",16,16,112,"Footscray",10,11,71,"Victoria Park",41,1959,"Regular",6,"Home","Collingwood","Footscray",41
5918,1959-05-30,"R6","Fitzroy",11,9,75,"Essendon",12,22,94,"Brunswick St",-19,1959,"Regular",6,"Away","Essendon","Fitzroy",19
5919,1959-05-30,"R6","Geelong",11,10,76,"Melbourne",19,15,129,"Kardinia Park",-53,1959,"Regular",6,"Away","Melbourne","Geelong",53
5920,1959-05-30,"R6","Sydney",8,18,66,"North Melbourne",13,18,96,"Lake Oval",-30,1959,"Regular",6,"Away","North Melbourne","Sydney",30
5921,1959-05-30,"R6","Richmond",11,17,83,"St Kilda",16,10,106,"Punt Rd",-23,1959,"Regular",6,"Away","St Kilda","Richmond",23
5922,1959-06-06,"R7","Carlton",14,15,99,"North Melbourne",10,11,71,"Princes Park",28,1959,"Regular",7,"Home","Carlton","North Melbourne",28
5923,1959-06-06,"R7","Collingwood",12,22,94,"Geelong",9,7,61,"Victoria Park",33,1959,"Regular",7,"Home","Collingwood","Geelong",33
5924,1959-06-06,"R7","Essendon",15,11,101,"Footscray",12,13,85,"Windy Hill",16,1959,"Regular",7,"Home","Essendon","Footscray",16
5925,1959-06-06,"R7","St Kilda",13,9,87,"Fitzroy",9,26,80,"Junction Oval",7,1959,"Regular",7,"Home","St Kilda","Fitzroy",7
5926,1959-06-06,"R7","Hawthorn",14,9,93,"Richmond",8,15,63,"Glenferrie Oval",30,1959,"Regular",7,"Home","Hawthorn","Richmond",30
5927,1959-06-06,"R7","Melbourne",14,17,101,"Sydney",8,8,56,"M.C.G.",45,1959,"Regular",7,"Home","Melbourne","Sydney",45
5928,1959-06-13,"R8","Fitzroy",5,10,40,"Collingwood",3,12,30,"Brunswick St",10,1959,"Regular",8,"Home","Fitzroy","Collingwood",10
5929,1959-06-13,"R8","Footscray",4,13,37,"Richmond",9,9,63,"Western Oval",-26,1959,"Regular",8,"Away","Richmond","Footscray",26
5930,1959-06-13,"R8","North Melbourne",12,12,84,"Hawthorn",8,6,54,"Arden St",30,1959,"Regular",8,"Home","North Melbourne","Hawthorn",30
5931,1959-06-15,"R8","Geelong",11,13,79,"Carlton",12,16,88,"Kardinia Park",-9,1959,"Regular",8,"Away","Carlton","Geelong",9
5932,1959-06-15,"R8","Melbourne",19,15,129,"Essendon",8,8,56,"M.C.G.",73,1959,"Regular",8,"Home","Melbourne","Essendon",73
5933,1959-06-15,"R8","Sydney",16,13,109,"St Kilda",7,11,53,"Lake Oval",56,1959,"Regular",8,"Home","Sydney","St Kilda",56
5934,1959-06-27,"R9","Carlton",14,11,95,"Sydney",14,21,105,"Princes Park",-10,1959,"Regular",9,"Away","Sydney","Carlton",10
5935,1959-06-27,"R9","Essendon",8,11,59,"Collingwood",14,12,96,"Windy Hill",-37,1959,"Regular",9,"Away","Collingwood","Essendon",37
5936,1959-06-27,"R9","Richmond",13,8,86,"Fitzroy",10,21,81,"Punt Rd",5,1959,"Regular",9,"Home","Richmond","Fitzroy",5
5937,1959-06-27,"R9","North Melbourne",13,18,96,"Footscray",9,14,68,"Arden St",28,1959,"Regular",9,"Home","North Melbourne","Footscray",28
5938,1959-06-27,"R9","St Kilda",14,11,95,"Geelong",6,22,58,"Junction Oval",37,1959,"Regular",9,"Home","St Kilda","Geelong",37
5939,1959-06-27,"R9","Hawthorn",6,16,52,"Melbourne",11,11,77,"Glenferrie Oval",-25,1959,"Regular",9,"Away","Melbourne","Hawthorn",25
5940,1959-07-04,"R10","Fitzroy",21,13,139,"Carlton",10,13,73,"Brunswick St",66,1959,"Regular",10,"Home","Fitzroy","Carlton",66
5941,1959-07-04,"R10","Collingwood",11,18,84,"North Melbourne",9,9,63,"Victoria Park",21,1959,"Regular",10,"Home","Collingwood","North Melbourne",21
5942,1959-07-04,"R10","Hawthorn",14,13,97,"Essendon",12,20,92,"Glenferrie Oval",5,1959,"Regular",10,"Home","Hawthorn","Essendon",5
5943,1959-07-04,"R10","Geelong",13,15,93,"Footscray",10,15,75,"Kardinia Park",18,1959,"Regular",10,"Home","Geelong","Footscray",18
5944,1959-07-04,"R10","St Kilda",11,10,76,"Melbourne",9,23,77,"Junction Oval",-1,1959,"Regular",10,"Away","Melbourne","St Kilda",1
5945,1959-07-04,"R10","Richmond",10,13,73,"Sydney",15,16,106,"Punt Rd",-33,1959,"Regular",10,"Away","Sydney","Richmond",33
5946,1959-07-11,"R11","Carlton",15,21,111,"St Kilda",8,18,66,"Princes Park",45,1959,"Regular",11,"Home","Carlton","St Kilda",45
5947,1959-07-11,"R11","Collingwood",10,15,75,"Hawthorn",10,14,74,"Victoria Park",1,1959,"Regular",11,"Home","Collingwood","Hawthorn",1
5948,1959-07-11,"R11","Essendon",19,20,134,"Richmond",10,9,69,"Windy Hill",65,1959,"Regular",11,"Home","Essendon","Richmond",65
5949,1959-07-11,"R11","Footscray",6,17,53,"Fitzroy",10,13,73,"Western Oval",-20,1959,"Regular",11,"Away","Fitzroy","Footscray",20
5950,1959-07-11,"R11","Sydney",17,16,118,"Geelong",12,12,84,"Lake Oval",34,1959,"Regular",11,"Home","Sydney","Geelong",34
5951,1959-07-11,"R11","Melbourne",20,8,128,"North Melbourne",6,10,46,"M.C.G.",82,1959,"Regular",11,"Home","Melbourne","North Melbourne",82
5952,1959-07-18,"R12","Essendon",15,10,100,"Carlton",7,18,60,"Windy Hill",40,1959,"Regular",12,"Home","Essendon","Carlton",40
5953,1959-07-18,"R12","Sydney",6,9,45,"Collingwood",12,13,85,"Lake Oval",-40,1959,"Regular",12,"Away","Collingwood","Sydney",40
5954,1959-07-18,"R12","Hawthorn",8,13,61,"Fitzroy",8,19,67,"Glenferrie Oval",-6,1959,"Regular",12,"Away","Fitzroy","Hawthorn",6
5955,1959-07-18,"R12","Footscray",10,15,75,"St Kilda",12,14,86,"Western Oval",-11,1959,"Regular",12,"Away","St Kilda","Footscray",11
5956,1959-07-18,"R12","North Melbourne",11,10,76,"Geelong",8,15,63,"Arden St",13,1959,"Regular",12,"Home","North Melbourne","Geelong",13
5957,1959-07-18,"R12","Melbourne",13,10,88,"Richmond",7,9,51,"M.C.G.",37,1959,"Regular",12,"Home","Melbourne","Richmond",37
5958,1959-07-25,"R13","Carlton",9,9,63,"Footscray",6,11,47,"Princes Park",16,1959,"Regular",13,"Home","Carlton","Footscray",16
5959,1959-07-25,"R13","Collingwood",14,10,94,"Melbourne",14,7,91,"Victoria Park",3,1959,"Regular",13,"Home","Collingwood","Melbourne",3
5960,1959-07-25,"R13","St Kilda",12,13,85,"Essendon",11,5,71,"Junction Oval",14,1959,"Regular",13,"Home","St Kilda","Essendon",14
5961,1959-07-25,"R13","Fitzroy",13,19,97,"Sydney",10,7,67,"Brunswick St",30,1959,"Regular",13,"Home","Fitzroy","Sydney",30
5962,1959-07-25,"R13","Geelong",14,16,100,"Hawthorn",13,13,91,"Kardinia Park",9,1959,"Regular",13,"Home","Geelong","Hawthorn",9
5963,1959-07-25,"R13","Richmond",16,8,104,"North Melbourne",10,16,76,"Punt Rd",28,1959,"Regular",13,"Home","Richmond","North Melbourne",28
5964,1959-08-01,"R14","Carlton",8,9,57,"Collingwood",9,14,68,"Princes Park",-11,1959,"Regular",14,"Away","Collingwood","Carlton",11
5965,1959-08-01,"R14","Essendon",10,19,79,"Sydney",8,14,62,"Windy Hill",17,1959,"Regular",14,"Home","Essendon","Sydney",17
5966,1959-08-01,"R14","Melbourne",11,11,77,"Fitzroy",11,11,77,"M.C.G.",0,1959,"Regular",14,"Home","Melbourne","Fitzroy",0
5967,1959-08-01,"R14","Hawthorn",14,15,99,"Footscray",7,10,52,"Glenferrie Oval",47,1959,"Regular",14,"Home","Hawthorn","Footscray",47
5968,1959-08-01,"R14","Geelong",12,15,87,"Richmond",6,7,43,"Kardinia Park",44,1959,"Regular",14,"Home","Geelong","Richmond",44
5969,1959-08-01,"R14","St Kilda",10,15,75,"North Melbourne",13,7,85,"Junction Oval",-10,1959,"Regular",14,"Away","North Melbourne","St Kilda",10
5970,1959-08-08,"R15","Richmond",13,6,84,"Carlton",14,20,104,"Punt Rd",-20,1959,"Regular",15,"Away","Carlton","Richmond",20
5971,1959-08-08,"R15","Collingwood",12,18,90,"St Kilda",9,11,65,"Victoria Park",25,1959,"Regular",15,"Home","Collingwood","St Kilda",25
5972,1959-08-08,"R15","North Melbourne",11,8,74,"Essendon",16,14,110,"Arden St",-36,1959,"Regular",15,"Away","Essendon","North Melbourne",36
5973,1959-08-08,"R15","Fitzroy",11,15,81,"Geelong",6,11,47,"Brunswick St",34,1959,"Regular",15,"Home","Fitzroy","Geelong",34
5974,1959-08-08,"R15","Footscray",12,8,80,"Melbourne",10,11,71,"Western Oval",9,1959,"Regular",15,"Home","Footscray","Melbourne",9
5975,1959-08-08,"R15","Sydney",8,14,62,"Hawthorn",10,3,63,"Lake Oval",-1,1959,"Regular",15,"Away","Hawthorn","Sydney",1
5976,1959-08-15,"R16","Melbourne",13,14,92,"Carlton",7,5,47,"M.C.G.",45,1959,"Regular",16,"Home","Melbourne","Carlton",45
5977,1959-08-15,"R16","Collingwood",17,17,119,"Richmond",5,10,40,"Victoria Park",79,1959,"Regular",16,"Home","Collingwood","Richmond",79
5978,1959-08-15,"R16","Geelong",12,9,81,"Essendon",15,16,106,"Kardinia Park",-25,1959,"Regular",16,"Away","Essendon","Geelong",25
5979,1959-08-15,"R16","Fitzroy",10,23,83,"North Melbourne",7,11,53,"Brunswick St",30,1959,"Regular",16,"Home","Fitzroy","North Melbourne",30
5980,1959-08-15,"R16","Sydney",11,10,76,"Footscray",12,13,85,"Lake Oval",-9,1959,"Regular",16,"Away","Footscray","Sydney",9
5981,1959-08-15,"R16","Hawthorn",10,11,71,"St Kilda",5,5,35,"Glenferrie Oval",36,1959,"Regular",16,"Home","Hawthorn","St Kilda",36
5982,1959-08-22,"R17","Carlton",13,20,98,"Hawthorn",14,12,96,"Princes Park",2,1959,"Regular",17,"Home","Carlton","Hawthorn",2
5983,1959-08-22,"R17","Footscray",5,5,35,"Collingwood",8,17,65,"Western Oval",-30,1959,"Regular",17,"Away","Collingwood","Footscray",30
5984,1959-08-22,"R17","Essendon",11,8,74,"Fitzroy",7,12,54,"Windy Hill",20,1959,"Regular",17,"Home","Essendon","Fitzroy",20
5985,1959-08-22,"R17","Melbourne",17,18,120,"Geelong",9,12,66,"M.C.G.",54,1959,"Regular",17,"Home","Melbourne","Geelong",54
5986,1959-08-22,"R17","North Melbourne",6,6,42,"Sydney",19,20,134,"Arden St",-92,1959,"Regular",17,"Away","Sydney","North Melbourne",92
5987,1959-08-22,"R17","St Kilda",18,15,123,"Richmond",13,19,97,"Junction Oval",26,1959,"Regular",17,"Home","St Kilda","Richmond",26
5988,1959-08-29,"R18","North Melbourne",8,11,59,"Carlton",12,14,86,"Arden St",-27,1959,"Regular",18,"Away","Carlton","North Melbourne",27
5989,1959-08-29,"R18","Geelong",5,8,38,"Collingwood",17,19,121,"Kardinia Park",-83,1959,"Regular",18,"Away","Collingwood","Geelong",83
5990,1959-08-29,"R18","Footscray",10,14,74,"Essendon",17,15,117,"Western Oval",-43,1959,"Regular",18,"Away","Essendon","Footscray",43
5991,1959-08-29,"R18","Fitzroy",20,12,132,"St Kilda",13,12,90,"Brunswick St",42,1959,"Regular",18,"Home","Fitzroy","St Kilda",42
5992,1959-08-29,"R18","Richmond",10,13,73,"Hawthorn",17,14,116,"Punt Rd",-43,1959,"Regular",18,"Away","Hawthorn","Richmond",43
5993,1959-08-29,"R18","Sydney",8,13,61,"Melbourne",10,16,76,"Lake Oval",-15,1959,"Regular",18,"Away","Melbourne","Sydney",15
5994,1959-09-05,"SF","Collingwood",8,14,62,"Essendon",14,16,100,"M.C.G.",-38,1959,"Finals",19,"Away","Essendon","Collingwood",38
5995,1959-09-12,"SF","Melbourne",11,15,81,"Carlton",4,13,37,"M.C.G.",44,1959,"Finals",19,"Home","Melbourne","Carlton",44
5996,1959-09-19,"PF","Carlton",7,8,50,"Essendon",8,9,57,"M.C.G.",-7,1959,"Finals",20,"Away","Essendon","Carlton",7
5997,1959-09-26,"GF","Melbourne",17,13,115,"Essendon",11,12,78,"M.C.G.",37,1959,"Finals",21,"Home","Melbourne","Essendon",37
5998,1960-04-16,"R1","Collingwood",11,14,80,"Fitzroy",3,7,25,"Victoria Park",55,1960,"Regular",1,"Home","Collingwood","Fitzroy",55
5999,1960-04-16,"R1","Essendon",12,21,93,"Hawthorn",9,12,66,"Windy Hill",27,1960,"Regular",1,"Home","Essendon","Hawthorn",27
6000,1960-04-16,"R1","Sydney",17,12,114,"St Kilda",8,15,63,"Lake Oval",51,1960,"Regular",1,"Home","Sydney","St Kilda",51
6001,1960-04-18,"R1","Carlton",14,14,98,"Richmond",14,14,98,"Princes Park",0,1960,"Regular",1,"Home","Carlton","Richmond",0
6002,1960-04-18,"R1","Footscray",15,7,97,"Geelong",10,6,66,"Western Oval",31,1960,"Regular",1,"Home","Footscray","Geelong",31
6003,1960-04-18,"R1","Melbourne",14,15,99,"North Melbourne",5,14,44,"M.C.G.",55,1960,"Regular",1,"Home","Melbourne","North Melbourne",55
6004,1960-04-25,"R2","Fitzroy",9,17,71,"Carlton",9,10,64,"Brunswick St",7,1960,"Regular",2,"Home","Fitzroy","Carlton",7
6005,1960-04-25,"R2","St Kilda",5,18,48,"Melbourne",10,12,72,"Junction Oval",-24,1960,"Regular",2,"Away","Melbourne","St Kilda",24
6006,1960-04-30,"R2","Hawthorn",6,16,52,"Collingwood",7,13,55,"Glenferrie Oval",-3,1960,"Regular",2,"Away","Collingwood","Hawthorn",3
6007,1960-04-30,"R2","Richmond",5,15,45,"Essendon",25,20,170,"Punt Rd",-125,1960,"Regular",2,"Away","Essendon","Richmond",125
6008,1960-04-30,"R2","North Melbourne",6,17,53,"Footscray",14,15,99,"Arden St",-46,1960,"Regular",2,"Away","Footscray","North Melbourne",46
6009,1960-04-30,"R2","Geelong",20,14,134,"Sydney",14,6,90,"Kardinia Park",44,1960,"Regular",2,"Home","Geelong","Sydney",44
6010,1960-05-07,"R3","St Kilda",5,11,41,"Carlton",7,3,45,"Junction Oval",-4,1960,"Regular",3,"Away","Carlton","St Kilda",4
6011,1960-05-07,"R3","Essendon",11,10,76,"Collingwood",11,8,74,"Windy Hill",2,1960,"Regular",3,"Home","Essendon","Collingwood",2
6012,1960-05-07,"R3","Fitzroy",5,11,41,"Geelong",8,7,55,"Brunswick St",-14,1960,"Regular",3,"Away","Geelong","Fitzroy",14
6013,1960-05-07,"R3","Hawthorn",6,9,45,"Footscray",6,17,53,"Glenferrie Oval",-8,1960,"Regular",3,"Away","Footscray","Hawthorn",8
6014,1960-05-07,"R3","Melbourne",16,14,110,"Sydney",6,10,46,"M.C.G.",64,1960,"Regular",3,"Home","Melbourne","Sydney",64
6015,1960-05-07,"R3","North Melbourne",5,12,42,"Richmond",3,8,26,"Arden St",16,1960,"Regular",3,"Home","North Melbourne","Richmond",16
6016,1960-05-14,"R4","Carlton",5,18,48,"Hawthorn",5,7,37,"Princes Park",11,1960,"Regular",4,"Home","Carlton","Hawthorn",11
6017,1960-05-14,"R4","Collingwood",7,13,55,"Melbourne",2,7,19,"Victoria Park",36,1960,"Regular",4,"Home","Collingwood","Melbourne",36
6018,1960-05-14,"R4","Footscray",4,2,26,"Essendon",4,11,35,"Western Oval",-9,1960,"Regular",4,"Away","Essendon","Footscray",9
6019,1960-05-14,"R4","Richmond",5,6,36,"Fitzroy",6,11,47,"Punt Rd",-11,1960,"Regular",4,"Away","Fitzroy","Richmond",11
6020,1960-05-14,"R4","Geelong",4,14,38,"St Kilda",9,5,59,"Kardinia Park",-21,1960,"Regular",4,"Away","St Kilda","Geelong",21
6021,1960-05-14,"R4","Sydney",11,12,78,"North Melbourne",5,8,38,"Lake Oval",40,1960,"Regular",4,"Home","Sydney","North Melbourne",40
6022,1960-05-21,"R5","Essendon",17,13,115,"Carlton",11,14,80,"Windy Hill",35,1960,"Regular",5,"Home","Essendon","Carlton",35
6023,1960-05-21,"R5","St Kilda",5,9,39,"Collingwood",4,13,37,"Junction Oval",2,1960,"Regular",5,"Home","St Kilda","Collingwood",2
6024,1960-05-21,"R5","Fitzroy",11,9,75,"Footscray",5,6,36,"Brunswick St",39,1960,"Regular",5,"Home","Fitzroy","Footscray",39
6025,1960-05-21,"R5","North Melbourne",10,6,66,"Geelong",7,9,51,"Arden St",15,1960,"Regular",5,"Home","North Melbourne","Geelong",15
6026,1960-05-21,"R5","Hawthorn",5,7,37,"Melbourne",7,15,57,"Glenferrie Oval",-20,1960,"Regular",5,"Away","Melbourne","Hawthorn",20
6027,1960-05-21,"R5","Richmond",7,5,47,"Sydney",4,7,31,"Punt Rd",16,1960,"Regular",5,"Home","Richmond","Sydney",16
6028,1960-05-28,"R6","Geelong",17,17,119,"Carlton",10,14,74,"Kardinia Park",45,1960,"Regular",6,"Home","Geelong","Carlton",45
6029,1960-05-28,"R6","Sydney",12,8,80,"Collingwood",11,12,78,"Lake Oval",2,1960,"Regular",6,"Home","Sydney","Collingwood",2
6030,1960-05-28,"R6","Fitzroy",8,7,55,"Essendon",6,14,50,"Brunswick St",5,1960,"Regular",6,"Home","Fitzroy","Essendon",5
6031,1960-05-28,"R6","Footscray",6,11,47,"St Kilda",10,5,65,"Western Oval",-18,1960,"Regular",6,"Away","St Kilda","Footscray",18
6032,1960-05-28,"R6","North Melbourne",7,6,48,"Hawthorn",9,8,62,"Arden St",-14,1960,"Regular",6,"Away","Hawthorn","North Melbourne",14
6033,1960-05-28,"R6","Melbourne",17,22,124,"Richmond",4,8,32,"M.C.G.",92,1960,"Regular",6,"Home","Melbourne","Richmond",92
6034,1960-06-04,"R7","Carlton",11,13,79,"Sydney",13,13,91,"Princes Park",-12,1960,"Regular",7,"Away","Sydney","Carlton",12
6035,1960-06-04,"R7","Collingwood",12,16,88,"North Melbourne",16,8,104,"Victoria Park",-16,1960,"Regular",7,"Away","North Melbourne","Collingwood",16
6036,1960-06-04,"R7","Essendon",9,15,69,"Melbourne",10,11,71,"Windy Hill",-2,1960,"Regular",7,"Away","Melbourne","Essendon",2
6037,1960-06-04,"R7","St Kilda",13,12,90,"Fitzroy",9,12,66,"Junction Oval",24,1960,"Regular",7,"Home","St Kilda","Fitzroy",24
6038,1960-06-04,"R7","Richmond",6,13,49,"Footscray",11,15,81,"Punt Rd",-32,1960,"Regular",7,"Away","Footscray","Richmond",32
6039,1960-06-04,"R7","Hawthorn",14,15,99,"Geelong",14,13,97,"Glenferrie Oval",2,1960,"Regular",7,"Home","Hawthorn","Geelong",2
6040,1960-06-11,"R8","Collingwood",16,14,110,"Carlton",10,13,73,"Victoria Park",37,1960,"Regular",8,"Home","Collingwood","Carlton",37
6041,1960-06-11,"R8","Geelong",11,17,83,"Essendon",14,10,94,"Kardinia Park",-11,1960,"Regular",8,"Away","Essendon","Geelong",11
6042,1960-06-11,"R8","Sydney",13,12,90,"Fitzroy",13,13,91,"Lake Oval",-1,1960,"Regular",8,"Away","Fitzroy","Sydney",1
6043,1960-06-11,"R8","Melbourne",10,15,75,"Footscray",6,8,44,"M.C.G.",31,1960,"Regular",8,"Home","Melbourne","Footscray",31
6044,1960-06-11,"R8","Hawthorn",13,18,96,"Richmond",11,15,81,"Glenferrie Oval",15,1960,"Regular",8,"Home","Hawthorn","Richmond",15
6045,1960-06-11,"R8","North Melbourne",13,12,90,"St Kilda",13,14,92,"Arden St",-2,1960,"Regular",8,"Away","St Kilda","North Melbourne",2
6046,1960-06-18,"R9","Carlton",18,12,120,"North Melbourne",8,15,63,"Princes Park",57,1960,"Regular",9,"Home","Carlton","North Melbourne",57
6047,1960-06-18,"R9","Footscray",8,19,67,"Collingwood",10,14,74,"Western Oval",-7,1960,"Regular",9,"Away","Collingwood","Footscray",7
6048,1960-06-18,"R9","Essendon",13,10,88,"Sydney",12,15,87,"Windy Hill",1,1960,"Regular",9,"Home","Essendon","Sydney",1
6049,1960-06-18,"R9","Fitzroy",10,8,68,"Melbourne",16,14,110,"Brunswick St",-42,1960,"Regular",9,"Away","Melbourne","Fitzroy",42
6050,1960-06-18,"R9","Richmond",11,17,83,"Geelong",12,11,83,"Punt Rd",0,1960,"Regular",9,"Home","Richmond","Geelong",0
6051,1960-06-18,"R9","St Kilda",7,13,55,"Hawthorn",8,19,67,"Junction Oval",-12,1960,"Regular",9,"Away","Hawthorn","St Kilda",12
6052,1960-06-25,"R10","Carlton",11,14,80,"Footscray",7,8,50,"Princes Park",30,1960,"Regular",10,"Home","Carlton","Footscray",30
6053,1960-06-25,"R10","Geelong",6,5,41,"Melbourne",12,11,83,"Kardinia Park",-42,1960,"Regular",10,"Away","Melbourne","Geelong",42
6054,1960-06-25,"R10","Sydney",11,7,73,"Hawthorn",13,6,84,"Lake Oval",-11,1960,"Regular",10,"Away","Hawthorn","Sydney",11
6055,1960-07-02,"R10","Richmond",12,12,84,"Collingwood",14,13,97,"Punt Rd",-13,1960,"Regular",10,"Away","Collingwood","Richmond",13
6056,1960-07-02,"R10","Essendon",12,4,76,"St Kilda",10,14,74,"Windy Hill",2,1960,"Regular",10,"Home","Essendon","St Kilda",2
6057,1960-07-02,"R10","Fitzroy",20,10,130,"North Melbourne",15,18,108,"Brunswick St",22,1960,"Regular",10,"Home","Fitzroy","North Melbourne",22
6058,1960-07-09,"R11","Melbourne",9,17,71,"Carlton",6,22,58,"M.C.G.",13,1960,"Regular",11,"Home","Melbourne","Carlton",13
6059,1960-07-09,"R11","Collingwood",13,16,94,"Geelong",10,13,73,"Victoria Park",21,1960,"Regular",11,"Home","Collingwood","Geelong",21
6060,1960-07-09,"R11","North Melbourne",12,11,83,"Essendon",14,14,98,"Arden St",-15,1960,"Regular",11,"Away","Essendon","North Melbourne",15
6061,1960-07-09,"R11","Hawthorn",10,9,69,"Fitzroy",12,14,86,"Glenferrie Oval",-17,1960,"Regular",11,"Away","Fitzroy","Hawthorn",17
6062,1960-07-09,"R11","Footscray",7,12,54,"Sydney",8,9,57,"Western Oval",-3,1960,"Regular",11,"Away","Sydney","Footscray",3
6063,1960-07-09,"R11","St Kilda",14,15,99,"Richmond",4,18,42,"Junction Oval",57,1960,"Regular",11,"Home","St Kilda","Richmond",57
6064,1960-07-16,"R12","Richmond",8,8,56,"Carlton",15,20,110,"Punt Rd",-54,1960,"Regular",12,"Away","Carlton","Richmond",54
6065,1960-07-16,"R12","Fitzroy",17,10,112,"Collingwood",13,18,96,"Brunswick St",16,1960,"Regular",12,"Home","Fitzroy","Collingwood",16
6066,1960-07-16,"R12","Hawthorn",10,13,73,"Essendon",16,11,107,"Glenferrie Oval",-34,1960,"Regular",12,"Away","Essendon","Hawthorn",34
6067,1960-07-16,"R12","Geelong",11,13,79,"Footscray",8,4,52,"Kardinia Park",27,1960,"Regular",12,"Home","Geelong","Footscray",27
6068,1960-07-16,"R12","North Melbourne",9,19,73,"Melbourne",15,13,103,"Arden St",-30,1960,"Regular",12,"Away","Melbourne","North Melbourne",30
6069,1960-07-16,"R12","St Kilda",11,13,79,"Sydney",9,3,57,"Junction Oval",22,1960,"Regular",12,"Home","St Kilda","Sydney",22
6070,1960-07-23,"R13","Carlton",5,10,40,"Fitzroy",12,12,84,"Princes Park",-44,1960,"Regular",13,"Away","Fitzroy","Carlton",44
6071,1960-07-23,"R13","Collingwood",7,15,57,"Hawthorn",7,16,58,"Victoria Park",-1,1960,"Regular",13,"Away","Hawthorn","Collingwood",1
6072,1960-07-23,"R13","Essendon",16,16,112,"Richmond",10,10,70,"Windy Hill",42,1960,"Regular",13,"Home","Essendon","Richmond",42
6073,1960-07-23,"R13","Footscray",9,10,64,"North Melbourne",9,8,62,"Western Oval",2,1960,"Regular",13,"Home","Footscray","North Melbourne",2
6074,1960-07-23,"R13","Sydney",10,20,80,"Geelong",11,13,79,"Lake Oval",1,1960,"Regular",13,"Home","Sydney","Geelong",1
6075,1960-07-23,"R13","Melbourne",6,13,49,"St Kilda",6,9,45,"M.C.G.",4,1960,"Regular",13,"Home","Melbourne","St Kilda",4
6076,1960-07-30,"R14","Carlton",10,12,72,"St Kilda",11,17,83,"Princes Park",-11,1960,"Regular",14,"Away","St Kilda","Carlton",11
6077,1960-07-30,"R14","Collingwood",9,11,65,"Essendon",6,9,45,"Victoria Park",20,1960,"Regular",14,"Home","Collingwood","Essendon",20
6078,1960-07-30,"R14","Geelong",7,11,53,"Fitzroy",14,11,95,"Kardinia Park",-42,1960,"Regular",14,"Away","Fitzroy","Geelong",42
6079,1960-07-30,"R14","Footscray",5,9,39,"Hawthorn",9,21,75,"Western Oval",-36,1960,"Regular",14,"Away","Hawthorn","Footscray",36
6080,1960-07-30,"R14","Sydney",10,10,70,"Melbourne",16,13,109,"Lake Oval",-39,1960,"Regular",14,"Away","Melbourne","Sydney",39
6081,1960-07-30,"R14","Richmond",9,13,67,"North Melbourne",12,7,79,"Punt Rd",-12,1960,"Regular",14,"Away","North Melbourne","Richmond",12
6082,1960-08-06,"R15","Hawthorn",13,10,88,"Carlton",9,7,61,"Glenferrie Oval",27,1960,"Regular",15,"Home","Hawthorn","Carlton",27
6083,1960-08-06,"R15","Melbourne",16,15,111,"Collingwood",9,11,65,"M.C.G.",46,1960,"Regular",15,"Home","Melbourne","Collingwood",46
6084,1960-08-06,"R15","Essendon",14,11,95,"Footscray",8,10,58,"Windy Hill",37,1960,"Regular",15,"Home","Essendon","Footscray",37
6085,1960-08-06,"R15","Fitzroy",13,13,91,"Richmond",10,11,71,"Brunswick St",20,1960,"Regular",15,"Home","Fitzroy","Richmond",20
6086,1960-08-06,"R15","St Kilda",9,16,70,"Geelong",13,9,87,"Junction Oval",-17,1960,"Regular",15,"Away","Geelong","St Kilda",17
6087,1960-08-06,"R15","North Melbourne",14,16,100,"Sydney",9,20,74,"Arden St",26,1960,"Regular",15,"Home","North Melbourne","Sydney",26
6088,1960-08-13,"R16","Carlton",7,15,57,"Essendon",6,8,44,"Princes Park",13,1960,"Regular",16,"Home","Carlton","Essendon",13
6089,1960-08-13,"R16","Collingwood",8,12,60,"St Kilda",7,7,49,"Victoria Park",11,1960,"Regular",16,"Home","Collingwood","St Kilda",11
6090,1960-08-13,"R16","Footscray",4,6,30,"Fitzroy",7,11,53,"Western Oval",-23,1960,"Regular",16,"Away","Fitzroy","Footscray",23
6091,1960-08-13,"R16","Geelong",10,14,74,"North Melbourne",4,10,34,"Kardinia Park",40,1960,"Regular",16,"Home","Geelong","North Melbourne",40
6092,1960-08-13,"R16","Melbourne",9,13,67,"Hawthorn",11,10,76,"M.C.G.",-9,1960,"Regular",16,"Away","Hawthorn","Melbourne",9
6093,1960-08-13,"R16","Sydney",13,13,91,"Richmond",7,12,54,"Lake Oval",37,1960,"Regular",16,"Home","Sydney","Richmond",37
6094,1960-08-20,"R17","Carlton",9,12,66,"Geelong",5,6,36,"Princes Park",30,1960,"Regular",17,"Home","Carlton","Geelong",30
6095,1960-08-20,"R17","Collingwood",8,3,51,"Sydney",5,9,39,"Victoria Park",12,1960,"Regular",17,"Home","Collingwood","Sydney",12
6096,1960-08-20,"R17","Essendon",9,7,61,"Fitzroy",10,12,72,"Windy Hill",-11,1960,"Regular",17,"Away","Fitzroy","Essendon",11
6097,1960-08-20,"R17","St Kilda",9,9,63,"Footscray",6,15,51,"Junction Oval",12,1960,"Regular",17,"Home","St Kilda","Footscray",12
6098,1960-08-20,"R17","Hawthorn",9,17,71,"North Melbourne",8,4,52,"Glenferrie Oval",19,1960,"Regular",17,"Home","Hawthorn","North Melbourne",19
6099,1960-08-20,"R17","Richmond",9,14,68,"Melbourne",8,12,60,"Punt Rd",8,1960,"Regular",17,"Home","Richmond","Melbourne",8
6100,1960-08-27,"R18","Sydney",8,8,56,"Carlton",11,9,75,"Lake Oval",-19,1960,"Regular",18,"Away","Carlton","Sydney",19
6101,1960-08-27,"R18","North Melbourne",6,8,44,"Collingwood",11,12,78,"Arden St",-34,1960,"Regular",18,"Away","Collingwood","North Melbourne",34
6102,1960-08-27,"R18","Melbourne",10,5,65,"Essendon",10,18,78,"M.C.G.",-13,1960,"Regular",18,"Away","Essendon","Melbourne",13
6103,1960-08-27,"R18","Fitzroy",9,16,70,"St Kilda",6,9,45,"Brunswick St",25,1960,"Regular",18,"Home","Fitzroy","St Kilda",25
6104,1960-08-27,"R18","Footscray",18,9,117,"Richmond",11,11,77,"Western Oval",40,1960,"Regular",18,"Home","Footscray","Richmond",40
6105,1960-08-27,"R18","Geelong",9,9,63,"Hawthorn",14,12,96,"Kardinia Park",-33,1960,"Regular",18,"Away","Hawthorn","Geelong",33
6106,1960-09-03,"SF","Essendon",7,15,57,"Collingwood",9,12,66,"M.C.G.",-9,1960,"Finals",19,"Away","Collingwood","Essendon",9
6107,1960-09-10,"SF","Melbourne",14,18,102,"Fitzroy",4,16,40,"M.C.G.",62,1960,"Finals",19,"Home","Melbourne","Fitzroy",62
6108,1960-09-17,"PF","Fitzroy",8,12,60,"Collingwood",9,11,65,"M.C.G.",-5,1960,"Finals",20,"Away","Collingwood","Fitzroy",5
6109,1960-09-24,"GF","Melbourne",8,14,62,"Collingwood",2,2,14,"M.C.G.",48,1960,"Finals",21,"Home","Melbourne","Collingwood",48
6110,1961-04-15,"R1","St Kilda",5,8,38,"Carlton",6,12,48,"Junction Oval",-10,1961,"Regular",1,"Away","Carlton","St Kilda",10
6111,1961-04-15,"R1","Geelong",13,18,96,"Collingwood",8,9,57,"Kardinia Park",39,1961,"Regular",1,"Home","Geelong","Collingwood",39
6112,1961-04-15,"R1","North Melbourne",8,10,58,"Essendon",6,13,49,"Arden St",9,1961,"Regular",1,"Home","North Melbourne","Essendon",9
6113,1961-04-15,"R1","Fitzroy",6,10,46,"Melbourne",10,15,75,"Brunswick St",-29,1961,"Regular",1,"Away","Melbourne","Fitzroy",29
6114,1961-04-15,"R1","Richmond",11,8,74,"Footscray",15,12,102,"Punt Rd",-28,1961,"Regular",1,"Away","Footscray","Richmond",28
6115,1961-04-15,"R1","Hawthorn",7,14,56,"Sydney",11,15,81,"Glenferrie Oval",-25,1961,"Regular",1,"Away","Sydney","Hawthorn",25
6116,1961-04-22,"R2","Carlton",9,5,59,"Fitzroy",6,18,54,"Princes Park",5,1961,"Regular",2,"Home","Carlton","Fitzroy",5
6117,1961-04-22,"R2","Collingwood",3,16,34,"Richmond",7,15,57,"Victoria Park",-23,1961,"Regular",2,"Away","Richmond","Collingwood",23
6118,1961-04-22,"R2","Essendon",13,7,85,"St Kilda",9,15,69,"Windy Hill",16,1961,"Regular",2,"Home","Essendon","St Kilda",16
6119,1961-04-22,"R2","Footscray",13,19,97,"North Melbourne",8,4,52,"Western Oval",45,1961,"Regular",2,"Home","Footscray","North Melbourne",45
6120,1961-04-22,"R2","Sydney",12,8,80,"Geelong",12,12,84,"Lake Oval",-4,1961,"Regular",2,"Away","Geelong","Sydney",4
6121,1961-04-22,"R2","Melbourne",5,14,44,"Hawthorn",11,10,76,"M.C.G.",-32,1961,"Regular",2,"Away","Hawthorn","Melbourne",32
6122,1961-04-25,"R3","Essendon",8,9,57,"Melbourne",11,16,82,"Windy Hill",-25,1961,"Regular",3,"Away","Melbourne","Essendon",25
6123,1961-04-25,"R3","Richmond",6,9,45,"Sydney",12,17,89,"Punt Rd",-44,1961,"Regular",3,"Away","Sydney","Richmond",44
6124,1961-04-29,"R3","Carlton",11,6,72,"Footscray",11,15,81,"Princes Park",-9,1961,"Regular",3,"Away","Footscray","Carlton",9
6125,1961-04-29,"R3","Collingwood",12,16,88,"North Melbourne",9,8,62,"Victoria Park",26,1961,"Regular",3,"Home","Collingwood","North Melbourne",26
6126,1961-04-29,"R3","Hawthorn",13,17,95,"Fitzroy",10,9,69,"Glenferrie Oval",26,1961,"Regular",3,"Home","Hawthorn","Fitzroy",26
6127,1961-04-29,"R3","St Kilda",12,11,83,"Geelong",6,14,50,"Junction Oval",33,1961,"Regular",3,"Home","St Kilda","Geelong",33
6128,1961-05-06,"R4","Sydney",7,14,56,"Carlton",11,6,72,"Lake Oval",-16,1961,"Regular",4,"Away","Carlton","Sydney",16
6129,1961-05-06,"R4","Footscray",10,13,73,"Collingwood",10,4,64,"Western Oval",9,1961,"Regular",4,"Home","Footscray","Collingwood",9
6130,1961-05-06,"R4","Geelong",7,19,61,"Essendon",22,11,143,"Kardinia Park",-82,1961,"Regular",4,"Away","Essendon","Geelong",82
6131,1961-05-06,"R4","Fitzroy",13,17,95,"Richmond",16,12,108,"Brunswick St",-13,1961,"Regular",4,"Away","Richmond","Fitzroy",13
6132,1961-05-06,"R4","North Melbourne",8,7,55,"Hawthorn",12,13,85,"Arden St",-30,1961,"Regular",4,"Away","Hawthorn","North Melbourne",30
6133,1961-05-06,"R4","Melbourne",12,9,81,"St Kilda",12,12,84,"M.C.G.",-3,1961,"Regular",4,"Away","St Kilda","Melbourne",3
6134,1961-05-13,"R5","North Melbourne",11,17,83,"Carlton",17,7,109,"Arden St",-26,1961,"Regular",5,"Away","Carlton","North Melbourne",26
6135,1961-05-13,"R5","Collingwood",8,7,55,"Fitzroy",16,20,116,"Victoria Park",-61,1961,"Regular",5,"Away","Fitzroy","Collingwood",61
6136,1961-05-13,"R5","Hawthorn",9,21,75,"Essendon",12,4,76,"Glenferrie Oval",-1,1961,"Regular",5,"Away","Essendon","Hawthorn",1
6137,1961-05-13,"R5","Sydney",12,12,84,"Footscray",12,10,82,"Lake Oval",2,1961,"Regular",5,"Home","Sydney","Footscray",2
6138,1961-05-13,"R5","Geelong",7,13,55,"Melbourne",17,18,120,"Kardinia Park",-65,1961,"Regular",5,"Away","Melbourne","Geelong",65
6139,1961-05-13,"R5","Richmond",13,7,85,"St Kilda",11,20,86,"Punt Rd",-1,1961,"Regular",5,"Away","St Kilda","Richmond",1
6140,1961-05-20,"R6","Essendon",20,13,133,"Sydney",6,18,54,"Windy Hill",79,1961,"Regular",6,"Home","Essendon","Sydney",79
6141,1961-05-20,"R6","Fitzroy",14,13,97,"North Melbourne",11,13,79,"Brunswick St",18,1961,"Regular",6,"Home","Fitzroy","North Melbourne",18
6142,1961-05-20,"R6","Richmond",9,14,68,"Geelong",16,16,112,"Punt Rd",-44,1961,"Regular",6,"Away","Geelong","Richmond",44
6143,1961-05-27,"R6","Carlton",9,11,65,"Collingwood",7,12,54,"Princes Park",11,1961,"Regular",6,"Home","Carlton","Collingwood",11
6144,1961-05-27,"R6","Footscray",9,8,62,"Melbourne",13,9,87,"Western Oval",-25,1961,"Regular",6,"Away","Melbourne","Footscray",25
6145,1961-05-27,"R6","St Kilda",14,16,100,"Hawthorn",12,9,81,"Junction Oval",19,1961,"Regular",6,"Home","St Kilda","Hawthorn",19
6146,1961-06-03,"R7","Melbourne",15,14,104,"Carlton",11,13,79,"M.C.G.",25,1961,"Regular",7,"Home","Melbourne","Carlton",25
6147,1961-06-03,"R7","Collingwood",18,11,119,"Essendon",8,10,58,"Victoria Park",61,1961,"Regular",7,"Home","Collingwood","Essendon",61
6148,1961-06-03,"R7","Sydney",7,8,50,"Fitzroy",17,15,117,"Lake Oval",-67,1961,"Regular",7,"Away","Fitzroy","Sydney",67
6149,1961-06-03,"R7","Geelong",13,13,91,"Footscray",4,14,38,"Kardinia Park",53,1961,"Regular",7,"Home","Geelong","Footscray",53
6150,1961-06-03,"R7","Hawthorn",10,13,73,"Richmond",8,12,60,"Glenferrie Oval",13,1961,"Regular",7,"Home","Hawthorn","Richmond",13
6151,1961-06-03,"R7","North Melbourne",9,14,68,"St Kilda",11,16,82,"Arden St",-14,1961,"Regular",7,"Away","St Kilda","North Melbourne",14
6152,1961-06-10,"R8","Fitzroy",10,14,74,"Essendon",6,18,54,"Brunswick St",20,1961,"Regular",8,"Home","Fitzroy","Essendon",20
6153,1961-06-10,"R8","North Melbourne",11,13,79,"Geelong",11,13,79,"Arden St",0,1961,"Regular",8,"Home","North Melbourne","Geelong",0
6154,1961-06-10,"R8","St Kilda",16,14,110,"Sydney",5,16,46,"Junction Oval",64,1961,"Regular",8,"Home","St Kilda","Sydney",64
6155,1961-06-12,"R8","Carlton",7,7,49,"Richmond",13,11,89,"Princes Park",-40,1961,"Regular",8,"Away","Richmond","Carlton",40
6156,1961-06-12,"R8","Melbourne",17,19,121,"Collingwood",7,10,52,"M.C.G.",69,1961,"Regular",8,"Home","Melbourne","Collingwood",69
6157,1961-06-12,"R8","Footscray",14,19,103,"Hawthorn",13,13,91,"Western Oval",12,1961,"Regular",8,"Home","Footscray","Hawthorn",12
6158,1961-06-17,"R9","Essendon",12,17,89,"Carlton",7,12,54,"Windy Hill",35,1961,"Regular",9,"Home","Essendon","Carlton",35
6159,1961-06-17,"R9","Collingwood",14,10,94,"St Kilda",12,12,84,"Victoria Park",10,1961,"Regular",9,"Home","Collingwood","St Kilda",10
6160,1961-06-17,"R9","Footscray",9,5,59,"Fitzroy",9,9,63,"Western Oval",-4,1961,"Regular",9,"Away","Fitzroy","Footscray",4
6161,1961-06-17,"R9","Geelong",9,7,61,"Hawthorn",10,10,70,"Kardinia Park",-9,1961,"Regular",9,"Away","Hawthorn","Geelong",9
6162,1961-06-17,"R9","Sydney",8,14,62,"Melbourne",14,14,98,"Lake Oval",-36,1961,"Regular",9,"Away","Melbourne","Sydney",36
6163,1961-06-17,"R9","Richmond",12,10,82,"North Melbourne",10,16,76,"Punt Rd",6,1961,"Regular",9,"Home","Richmond","North Melbourne",6
6164,1961-06-24,"R10","Hawthorn",12,6,78,"Carlton",6,10,46,"Glenferrie Oval",32,1961,"Regular",10,"Home","Hawthorn","Carlton",32
6165,1961-06-24,"R10","Collingwood",12,12,84,"Sydney",6,8,44,"Victoria Park",40,1961,"Regular",10,"Home","Collingwood","Sydney",40
6166,1961-06-24,"R10","Richmond",12,20,92,"Essendon",10,14,74,"Punt Rd",18,1961,"Regular",10,"Home","Richmond","Essendon",18
6167,1961-06-24,"R10","Geelong",9,10,64,"Fitzroy",8,9,57,"Kardinia Park",7,1961,"Regular",10,"Home","Geelong","Fitzroy",7
6168,1961-06-24,"R10","St Kilda",8,11,59,"Footscray",4,13,37,"Junction Oval",22,1961,"Regular",10,"Home","St Kilda","Footscray",22
6169,1961-06-24,"R10","North Melbourne",5,14,44,"Melbourne",14,9,93,"Arden St",-49,1961,"Regular",10,"Away","Melbourne","North Melbourne",49
6170,1961-07-01,"R11","Carlton",10,18,78,"Geelong",17,16,118,"Princes Park",-40,1961,"Regular",11,"Away","Geelong","Carlton",40
6171,1961-07-01,"R11","Hawthorn",13,12,90,"Collingwood",4,12,36,"Glenferrie Oval",54,1961,"Regular",11,"Home","Hawthorn","Collingwood",54
6172,1961-07-01,"R11","Essendon",12,11,83,"Footscray",13,14,92,"Windy Hill",-9,1961,"Regular",11,"Away","Footscray","Essendon",9
6173,1961-07-01,"R11","Fitzroy",9,9,63,"St Kilda",9,8,62,"Brunswick St",1,1961,"Regular",11,"Home","Fitzroy","St Kilda",1
6174,1961-07-01,"R11","Melbourne",17,18,120,"Richmond",7,12,54,"M.C.G.",66,1961,"Regular",11,"Home","Melbourne","Richmond",66
6175,1961-07-01,"R11","Sydney",9,14,68,"North Melbourne",7,8,50,"Lake Oval",18,1961,"Regular",11,"Home","Sydney","North Melbourne",18
6176,1961-07-08,"R12","Carlton",9,8,62,"St Kilda",3,12,30,"Princes Park",32,1961,"Regular",12,"Home","Carlton","St Kilda",32
6177,1961-07-08,"R12","Collingwood",5,11,41,"Geelong",8,10,58,"Victoria Park",-17,1961,"Regular",12,"Away","Geelong","Collingwood",17
6178,1961-07-08,"R12","Essendon",9,9,63,"North Melbourne",3,10,28,"Windy Hill",35,1961,"Regular",12,"Home","Essendon","North Melbourne",35
6179,1961-07-08,"R12","Melbourne",6,8,44,"Fitzroy",6,8,44,"M.C.G.",0,1961,"Regular",12,"Home","Melbourne","Fitzroy",0
6180,1961-07-08,"R12","Footscray",6,6,42,"Richmond",4,9,33,"Western Oval",9,1961,"Regular",12,"Home","Footscray","Richmond",9
6181,1961-07-08,"R12","Sydney",7,7,49,"Hawthorn",9,11,65,"Lake Oval",-16,1961,"Regular",12,"Away","Hawthorn","Sydney",16
6182,1961-07-15,"R13","Richmond",5,8,38,"Collingwood",6,18,54,"Punt Rd",-16,1961,"Regular",13,"Away","Collingwood","Richmond",16
6183,1961-07-15,"R13","North Melbourne",10,15,75,"Footscray",11,6,72,"Arden St",3,1961,"Regular",13,"Home","North Melbourne","Footscray",3
6184,1961-07-15,"R13","Hawthorn",8,10,58,"Melbourne",5,10,40,"Glenferrie Oval",18,1961,"Regular",13,"Home","Hawthorn","Melbourne",18
6185,1961-07-22,"R13","Fitzroy",12,13,85,"Carlton",9,22,76,"Brunswick St",9,1961,"Regular",13,"Home","Fitzroy","Carlton",9
6186,1961-07-22,"R13","St Kilda",13,20,98,"Essendon",7,8,50,"Junction Oval",48,1961,"Regular",13,"Home","St Kilda","Essendon",48
6187,1961-07-22,"R13","Geelong",11,16,82,"Sydney",9,13,67,"Kardinia Park",15,1961,"Regular",13,"Home","Geelong","Sydney",15
6188,1961-07-29,"R14","Footscray",12,11,83,"Carlton",7,9,51,"Western Oval",32,1961,"Regular",14,"Home","Footscray","Carlton",32
6189,1961-07-29,"R14","North Melbourne",9,13,67,"Collingwood",9,10,64,"Arden St",3,1961,"Regular",14,"Home","North Melbourne","Collingwood",3
6190,1961-07-29,"R14","Melbourne",10,18,78,"Essendon",13,9,87,"M.C.G.",-9,1961,"Regular",14,"Away","Essendon","Melbourne",9
6191,1961-07-29,"R14","Fitzroy",12,15,87,"Hawthorn",13,16,94,"Brunswick St",-7,1961,"Regular",14,"Away","Hawthorn","Fitzroy",7
6192,1961-07-29,"R14","Geelong",11,7,73,"St Kilda",10,8,68,"Kardinia Park",5,1961,"Regular",14,"Home","Geelong","St Kilda",5
6193,1961-07-29,"R14","Sydney",16,9,105,"Richmond",9,14,68,"Lake Oval",37,1961,"Regular",14,"Home","Sydney","Richmond",37
6194,1961-08-05,"R15","Carlton",17,9,111,"Sydney",7,10,52,"Princes Park",59,1961,"Regular",15,"Home","Carlton","Sydney",59
6195,1961-08-05,"R15","Collingwood",5,10,40,"Footscray",11,12,78,"Victoria Park",-38,1961,"Regular",15,"Away","Footscray","Collingwood",38
6196,1961-08-05,"R15","Essendon",13,16,94,"Geelong",7,14,56,"Windy Hill",38,1961,"Regular",15,"Home","Essendon","Geelong",38
6197,1961-08-05,"R15","Richmond",9,9,63,"Fitzroy",9,14,68,"Punt Rd",-5,1961,"Regular",15,"Away","Fitzroy","Richmond",5
6198,1961-08-05,"R15","Hawthorn",15,10,100,"North Melbourne",6,11,47,"Glenferrie Oval",53,1961,"Regular",15,"Home","Hawthorn","North Melbourne",53
6199,1961-08-05,"R15","St Kilda",9,12,66,"Melbourne",7,13,55,"Junction Oval",11,1961,"Regular",15,"Home","St Kilda","Melbourne",11
6200,1961-08-12,"R16","Carlton",9,16,70,"North Melbourne",10,8,68,"Princes Park",2,1961,"Regular",16,"Home","Carlton","North Melbourne",2
6201,1961-08-12,"R16","Fitzroy",12,20,92,"Collingwood",10,10,70,"Brunswick St",22,1961,"Regular",16,"Home","Fitzroy","Collingwood",22
6202,1961-08-12,"R16","Essendon",10,12,72,"Hawthorn",11,13,79,"Windy Hill",-7,1961,"Regular",16,"Away","Hawthorn","Essendon",7
6203,1961-08-12,"R16","Footscray",14,17,101,"Sydney",5,16,46,"Western Oval",55,1961,"Regular",16,"Home","Footscray","Sydney",55
6204,1961-08-12,"R16","Melbourne",12,17,89,"Geelong",12,15,87,"M.C.G.",2,1961,"Regular",16,"Home","Melbourne","Geelong",2
6205,1961-08-12,"R16","St Kilda",12,19,91,"Richmond",0,8,8,"Junction Oval",83,1961,"Regular",16,"Home","St Kilda","Richmond",83
6206,1961-08-19,"R17","Collingwood",10,12,72,"Carlton",13,10,88,"Victoria Park",-16,1961,"Regular",17,"Away","Carlton","Collingwood",16
6207,1961-08-19,"R17","Sydney",11,12,78,"Essendon",16,11,107,"Lake Oval",-29,1961,"Regular",17,"Away","Essendon","Sydney",29
6208,1961-08-19,"R17","North Melbourne",10,15,75,"Fitzroy",8,15,63,"Arden St",12,1961,"Regular",17,"Home","North Melbourne","Fitzroy",12
6209,1961-08-19,"R17","Melbourne",11,22,88,"Footscray",7,6,48,"M.C.G.",40,1961,"Regular",17,"Home","Melbourne","Footscray",40
6210,1961-08-19,"R17","Geelong",11,11,77,"Richmond",6,10,46,"Kardinia Park",31,1961,"Regular",17,"Home","Geelong","Richmond",31
6211,1961-08-19,"R17","Hawthorn",19,6,120,"St Kilda",14,7,91,"Glenferrie Oval",29,1961,"Regular",17,"Home","Hawthorn","St Kilda",29
6212,1961-08-26,"R18","Essendon",12,16,88,"Collingwood",13,10,88,"Windy Hill",0,1961,"Regular",18,"Home","Essendon","Collingwood",0
6213,1961-08-26,"R18","Footscray",12,12,84,"Geelong",8,15,63,"Western Oval",21,1961,"Regular",18,"Home","Footscray","Geelong",21
6214,1961-08-26,"R18","Richmond",8,8,56,"Hawthorn",11,15,81,"Punt Rd",-25,1961,"Regular",18,"Away","Hawthorn","Richmond",25
6215,1961-08-26,"R18","Carlton",13,12,90,"Melbourne",13,13,91,"Princes Park",-1,1961,"Regular",18,"Away","Melbourne","Carlton",1
6216,1961-08-26,"R18","St Kilda",10,12,72,"North Melbourne",9,13,67,"Junction Oval",5,1961,"Regular",18,"Home","St Kilda","North Melbourne",5
6217,1961-08-26,"R18","Fitzroy",25,29,179,"Sydney",11,10,76,"Brunswick St",103,1961,"Regular",18,"Home","Fitzroy","Sydney",103
6218,1961-09-02,"SF","St Kilda",8,12,60,"Footscray",9,15,69,"M.C.G.",-9,1961,"Finals",19,"Away","Footscray","St Kilda",9
6219,1961-09-09,"SF","Hawthorn",12,8,80,"Melbourne",11,7,73,"M.C.G.",7,1961,"Finals",19,"Home","Hawthorn","Melbourne",7
6220,1961-09-16,"PF","Melbourne",8,10,58,"Footscray",13,7,85,"M.C.G.",-27,1961,"Finals",20,"Away","Footscray","Melbourne",27
6221,1961-09-23,"GF","Hawthorn",13,16,94,"Footscray",7,9,51,"M.C.G.",43,1961,"Finals",21,"Home","Hawthorn","Footscray",43
6222,1962-04-21,"R1","Carlton",13,10,88,"Geelong",19,13,127,"Princes Park",-39,1962,"Regular",1,"Away","Geelong","Carlton",39
6223,1962-04-21,"R1","Footscray",12,8,80,"Hawthorn",6,11,47,"Western Oval",33,1962,"Regular",1,"Home","Footscray","Hawthorn",33
6224,1962-04-21,"R1","Melbourne",11,13,79,"Richmond",6,15,51,"M.C.G.",28,1962,"Regular",1,"Home","Melbourne","Richmond",28
6225,1962-04-23,"R1","Collingwood",5,8,38,"St Kilda",9,9,63,"Victoria Park",-25,1962,"Regular",1,"Away","St Kilda","Collingwood",25
6226,1962-04-23,"R1","Essendon",12,13,85,"Fitzroy",7,6,48,"Windy Hill",37,1962,"Regular",1,"Home","Essendon","Fitzroy",37
6227,1962-04-23,"R1","Sydney",14,13,97,"North Melbourne",13,13,91,"Lake Oval",6,1962,"Regular",1,"Home","Sydney","North Melbourne",6
6228,1962-04-28,"R2","Richmond",9,11,65,"Carlton",11,9,75,"Punt Rd",-10,1962,"Regular",2,"Away","Carlton","Richmond",10
6229,1962-04-28,"R2","Hawthorn",13,9,87,"Collingwood",10,15,75,"Glenferrie Oval",12,1962,"Regular",2,"Home","Hawthorn","Collingwood",12
6230,1962-04-28,"R2","North Melbourne",7,9,51,"Essendon",10,8,68,"Arden St",-17,1962,"Regular",2,"Away","Essendon","North Melbourne",17
6231,1962-04-28,"R2","Fitzroy",6,7,43,"Footscray",16,15,111,"Brunswick St",-68,1962,"Regular",2,"Away","Footscray","Fitzroy",68
6232,1962-04-28,"R2","Geelong",7,7,49,"Melbourne",8,8,56,"Kardinia Park",-7,1962,"Regular",2,"Away","Melbourne","Geelong",7
6233,1962-04-28,"R2","St Kilda",10,13,73,"Sydney",13,7,85,"Junction Oval",-12,1962,"Regular",2,"Away","Sydney","St Kilda",12
6234,1962-05-05,"R3","Carlton",16,14,110,"North Melbourne",7,6,48,"Princes Park",62,1962,"Regular",3,"Home","Carlton","North Melbourne",62
6235,1962-05-05,"R3","Sydney",7,14,56,"Collingwood",15,10,100,"Lake Oval",-44,1962,"Regular",3,"Away","Collingwood","Sydney",44
6236,1962-05-05,"R3","Essendon",12,22,94,"Richmond",9,13,67,"Windy Hill",27,1962,"Regular",3,"Home","Essendon","Richmond",27
6237,1962-05-05,"R3","Fitzroy",9,11,65,"St Kilda",16,7,103,"Brunswick St",-38,1962,"Regular",3,"Away","St Kilda","Fitzroy",38
6238,1962-05-05,"R3","Melbourne",14,10,94,"Footscray",4,11,35,"M.C.G.",59,1962,"Regular",3,"Home","Melbourne","Footscray",59
6239,1962-05-05,"R3","Geelong",18,10,118,"Hawthorn",12,7,79,"Kardinia Park",39,1962,"Regular",3,"Home","Geelong","Hawthorn",39
6240,1962-05-12,"R4","Hawthorn",12,6,78,"Carlton",12,19,91,"Glenferrie Oval",-13,1962,"Regular",4,"Away","Carlton","Hawthorn",13
6241,1962-05-12,"R4","Collingwood",6,15,51,"Melbourne",12,11,83,"Victoria Park",-32,1962,"Regular",4,"Away","Melbourne","Collingwood",32
6242,1962-05-12,"R4","St Kilda",10,15,75,"Essendon",11,13,79,"Junction Oval",-4,1962,"Regular",4,"Away","Essendon","St Kilda",4
6243,1962-05-12,"R4","North Melbourne",7,14,56,"Fitzroy",18,13,121,"Arden St",-65,1962,"Regular",4,"Away","Fitzroy","North Melbourne",65
6244,1962-05-12,"R4","Footscray",17,17,119,"Sydney",10,11,71,"Western Oval",48,1962,"Regular",4,"Home","Footscray","Sydney",48
6245,1962-05-12,"R4","Richmond",13,15,93,"Geelong",18,10,118,"Punt Rd",-25,1962,"Regular",4,"Away","Geelong","Richmond",25
6246,1962-05-19,"R5","Carlton",11,7,73,"Essendon",17,16,118,"Princes Park",-45,1962,"Regular",5,"Away","Essendon","Carlton",45
6247,1962-05-19,"R5","Geelong",11,9,75,"Collingwood",13,9,87,"Kardinia Park",-12,1962,"Regular",5,"Away","Collingwood","Geelong",12
6248,1962-05-19,"R5","Sydney",10,13,73,"Fitzroy",13,16,94,"Lake Oval",-21,1962,"Regular",5,"Away","Fitzroy","Sydney",21
6249,1962-05-19,"R5","Footscray",13,12,90,"St Kilda",9,19,73,"Western Oval",17,1962,"Regular",5,"Home","Footscray","St Kilda",17
6250,1962-05-19,"R5","Hawthorn",11,8,74,"Richmond",9,16,70,"Glenferrie Oval",4,1962,"Regular",5,"Home","Hawthorn","Richmond",4
6251,1962-05-19,"R5","Melbourne",16,8,104,"North Melbourne",13,5,83,"M.C.G.",21,1962,"Regular",5,"Home","Melbourne","North Melbourne",21
6252,1962-05-26,"R6","Collingwood",12,8,80,"Carlton",10,4,64,"Victoria Park",16,1962,"Regular",6,"Home","Collingwood","Carlton",16
6253,1962-05-26,"R6","Essendon",14,9,93,"Footscray",13,9,87,"Windy Hill",6,1962,"Regular",6,"Home","Essendon","Footscray",6
6254,1962-05-26,"R6","Fitzroy",11,13,79,"Hawthorn",8,8,56,"Brunswick St",23,1962,"Regular",6,"Home","Fitzroy","Hawthorn",23
6255,1962-05-26,"R6","North Melbourne",6,14,50,"Geelong",19,15,129,"Arden St",-79,1962,"Regular",6,"Away","Geelong","North Melbourne",79
6256,1962-05-26,"R6","Melbourne",8,15,63,"Sydney",1,11,17,"M.C.G.",46,1962,"Regular",6,"Home","Melbourne","Sydney",46
6257,1962-05-26,"R6","St Kilda",13,10,88,"Richmond",12,8,80,"Junction Oval",8,1962,"Regular",6,"Home","St Kilda","Richmond",8
6258,1962-06-02,"R7","Footscray",9,9,63,"Collingwood",4,4,28,"Western Oval",35,1962,"Regular",7,"Home","Footscray","Collingwood",35
6259,1962-06-02,"R7","Sydney",7,11,53,"Essendon",16,15,111,"Lake Oval",-58,1962,"Regular",7,"Away","Essendon","Sydney",58
6260,1962-06-02,"R7","Richmond",14,7,91,"North Melbourne",6,12,48,"Punt Rd",43,1962,"Regular",7,"Home","Richmond","North Melbourne",43
6261,1962-06-04,"R7","Carlton",10,10,70,"Melbourne",7,12,54,"Princes Park",16,1962,"Regular",7,"Home","Carlton","Melbourne",16
6262,1962-06-04,"R7","Geelong",13,22,100,"Fitzroy",9,8,62,"Kardinia Park",38,1962,"Regular",7,"Home","Geelong","Fitzroy",38
6263,1962-06-04,"R7","Hawthorn",9,8,62,"St Kilda",12,22,94,"Glenferrie Oval",-32,1962,"Regular",7,"Away","St Kilda","Hawthorn",32
6264,1962-06-09,"R8","St Kilda",5,13,43,"Carlton",6,10,46,"Junction Oval",-3,1962,"Regular",8,"Away","Carlton","St Kilda",3
6265,1962-06-09,"R8","North Melbourne",7,10,52,"Collingwood",15,19,109,"Arden St",-57,1962,"Regular",8,"Away","Collingwood","North Melbourne",57
6266,1962-06-09,"R8","Hawthorn",9,15,69,"Essendon",7,10,52,"Glenferrie Oval",17,1962,"Regular",8,"Home","Hawthorn","Essendon",17
6267,1962-06-09,"R8","Fitzroy",12,4,76,"Melbourne",9,20,74,"Brunswick St",2,1962,"Regular",8,"Home","Fitzroy","Melbourne",2
6268,1962-06-09,"R8","Richmond",9,10,64,"Footscray",11,11,77,"Punt Rd",-13,1962,"Regular",8,"Away","Footscray","Richmond",13
6269,1962-06-09,"R8","Geelong",9,10,64,"Sydney",6,8,44,"Kardinia Park",20,1962,"Regular",8,"Home","Geelong","Sydney",20
6270,1962-06-23,"R9","Carlton",12,9,81,"Footscray",9,10,64,"Princes Park",17,1962,"Regular",9,"Home","Carlton","Footscray",17
6271,1962-06-23,"R9","Collingwood",10,14,74,"Fitzroy",9,11,65,"Victoria Park",9,1962,"Regular",9,"Home","Collingwood","Fitzroy",9
6272,1962-06-23,"R9","Essendon",15,17,107,"Geelong",10,7,67,"Windy Hill",40,1962,"Regular",9,"Home","Essendon","Geelong",40
6273,1962-06-23,"R9","North Melbourne",10,8,68,"Hawthorn",10,7,67,"Arden St",1,1962,"Regular",9,"Home","North Melbourne","Hawthorn",1
6274,1962-06-23,"R9","Melbourne",11,18,84,"St Kilda",11,6,72,"M.C.G.",12,1962,"Regular",9,"Home","Melbourne","St Kilda",12
6275,1962-06-23,"R9","Sydney",10,13,73,"Richmond",11,13,79,"Lake Oval",-6,1962,"Regular",9,"Away","Richmond","Sydney",6
6276,1962-06-30,"R10","Fitzroy",6,15,51,"Carlton",7,10,52,"Brunswick St",-1,1962,"Regular",10,"Away","Carlton","Fitzroy",1
6277,1962-06-30,"R10","Collingwood",14,16,100,"Richmond",13,10,88,"Victoria Park",12,1962,"Regular",10,"Home","Collingwood","Richmond",12
6278,1962-06-30,"R10","Melbourne",7,13,55,"Essendon",10,13,73,"M.C.G.",-18,1962,"Regular",10,"Away","Essendon","Melbourne",18
6279,1962-06-30,"R10","Footscray",12,10,82,"North Melbourne",8,17,65,"Western Oval",17,1962,"Regular",10,"Home","Footscray","North Melbourne",17
6280,1962-06-30,"R10","Geelong",7,10,52,"St Kilda",6,12,48,"Kardinia Park",4,1962,"Regular",10,"Home","Geelong","St Kilda",4
6281,1962-06-30,"R10","Sydney",7,8,50,"Hawthorn",12,14,86,"Lake Oval",-36,1962,"Regular",10,"Away","Hawthorn","Sydney",36
6282,1962-07-07,"R11","Carlton",17,14,116,"Sydney",6,12,48,"Princes Park",68,1962,"Regular",11,"Home","Carlton","Sydney",68
6283,1962-07-07,"R11","Essendon",13,16,94,"Collingwood",11,11,77,"Windy Hill",17,1962,"Regular",11,"Home","Essendon","Collingwood",17
6284,1962-07-07,"R11","Richmond",10,16,76,"Fitzroy",9,12,66,"Punt Rd",10,1962,"Regular",11,"Home","Richmond","Fitzroy",10
6285,1962-07-07,"R11","Footscray",8,10,58,"Geelong",20,9,129,"Western Oval",-71,1962,"Regular",11,"Away","Geelong","Footscray",71
6286,1962-07-07,"R11","Hawthorn",11,14,80,"Melbourne",14,12,96,"Glenferrie Oval",-16,1962,"Regular",11,"Away","Melbourne","Hawthorn",16
6287,1962-07-07,"R11","St Kilda",10,8,68,"North Melbourne",12,6,78,"Junction Oval",-10,1962,"Regular",11,"Away","North Melbourne","St Kilda",10
6288,1962-07-14,"R12","Geelong",8,9,57,"Carlton",11,7,73,"Kardinia Park",-16,1962,"Regular",12,"Away","Carlton","Geelong",16
6289,1962-07-14,"R12","St Kilda",16,12,108,"Collingwood",12,13,85,"Junction Oval",23,1962,"Regular",12,"Home","St Kilda","Collingwood",23
6290,1962-07-14,"R12","Fitzroy",5,19,49,"Essendon",14,18,102,"Brunswick St",-53,1962,"Regular",12,"Away","Essendon","Fitzroy",53
6291,1962-07-14,"R12","Hawthorn",13,6,84,"Footscray",16,6,102,"Glenferrie Oval",-18,1962,"Regular",12,"Away","Footscray","Hawthorn",18
6292,1962-07-14,"R12","Richmond",10,9,69,"Melbourne",12,12,84,"Punt Rd",-15,1962,"Regular",12,"Away","Melbourne","Richmond",15
6293,1962-07-14,"R12","North Melbourne",12,22,94,"Sydney",5,15,45,"Arden St",49,1962,"Regular",12,"Home","North Melbourne","Sydney",49
6294,1962-07-21,"R13","Carlton",9,13,67,"Richmond",6,15,51,"Princes Park",16,1962,"Regular",13,"Home","Carlton","Richmond",16
6295,1962-07-21,"R13","Collingwood",15,9,99,"Hawthorn",9,6,60,"Victoria Park",39,1962,"Regular",13,"Home","Collingwood","Hawthorn",39
6296,1962-07-21,"R13","Essendon",13,11,89,"North Melbourne",8,7,55,"Windy Hill",34,1962,"Regular",13,"Home","Essendon","North Melbourne",34
6297,1962-07-21,"R13","Footscray",10,5,65,"Fitzroy",5,16,46,"Western Oval",19,1962,"Regular",13,"Home","Footscray","Fitzroy",19
6298,1962-07-21,"R13","Melbourne",9,9,63,"Geelong",10,19,79,"M.C.G.",-16,1962,"Regular",13,"Away","Geelong","Melbourne",16
6299,1962-07-21,"R13","Sydney",9,9,63,"St Kilda",11,14,80,"Lake Oval",-17,1962,"Regular",13,"Away","St Kilda","Sydney",17
6300,1962-07-28,"R14","North Melbourne",7,6,48,"Carlton",11,12,78,"Arden St",-30,1962,"Regular",14,"Away","Carlton","North Melbourne",30
6301,1962-07-28,"R14","Collingwood",11,10,76,"Sydney",10,12,72,"Victoria Park",4,1962,"Regular",14,"Home","Collingwood","Sydney",4
6302,1962-07-28,"R14","Richmond",11,17,83,"Essendon",12,12,84,"Punt Rd",-1,1962,"Regular",14,"Away","Essendon","Richmond",1
6303,1962-07-28,"R14","St Kilda",13,16,94,"Fitzroy",8,6,54,"Junction Oval",40,1962,"Regular",14,"Home","St Kilda","Fitzroy",40
6304,1962-07-28,"R14","Footscray",6,11,47,"Melbourne",9,14,68,"Western Oval",-21,1962,"Regular",14,"Away","Melbourne","Footscray",21
6305,1962-07-28,"R14","Hawthorn",11,17,83,"Geelong",16,13,109,"Glenferrie Oval",-26,1962,"Regular",14,"Away","Geelong","Hawthorn",26
6306,1962-08-04,"R15","Carlton",8,11,59,"Hawthorn",7,11,53,"Princes Park",6,1962,"Regular",15,"Home","Carlton","Hawthorn",6
6307,1962-08-04,"R15","Melbourne",14,8,92,"Collingwood",11,11,77,"M.C.G.",15,1962,"Regular",15,"Home","Melbourne","Collingwood",15
6308,1962-08-04,"R15","Essendon",15,7,97,"St Kilda",5,17,47,"Windy Hill",50,1962,"Regular",15,"Home","Essendon","St Kilda",50
6309,1962-08-04,"R15","Fitzroy",7,8,50,"North Melbourne",8,12,60,"Brunswick St",-10,1962,"Regular",15,"Away","North Melbourne","Fitzroy",10
6310,1962-08-04,"R15","Sydney",9,9,63,"Footscray",10,20,80,"Lake Oval",-17,1962,"Regular",15,"Away","Footscray","Sydney",17
6311,1962-08-04,"R15","Geelong",15,8,98,"Richmond",7,12,54,"Kardinia Park",44,1962,"Regular",15,"Home","Geelong","Richmond",44
6312,1962-08-11,"R16","Essendon",10,11,71,"Carlton",9,8,62,"Windy Hill",9,1962,"Regular",16,"Home","Essendon","Carlton",9
6313,1962-08-11,"R16","Collingwood",7,11,53,"Geelong",12,23,95,"Victoria Park",-42,1962,"Regular",16,"Away","Geelong","Collingwood",42
6314,1962-08-11,"R16","Fitzroy",17,16,118,"Sydney",22,11,143,"Brunswick St",-25,1962,"Regular",16,"Away","Sydney","Fitzroy",25
6315,1962-08-11,"R16","St Kilda",12,14,86,"Footscray",11,10,76,"Junction Oval",10,1962,"Regular",16,"Home","St Kilda","Footscray",10
6316,1962-08-11,"R16","Richmond",11,11,77,"Hawthorn",15,4,94,"Punt Rd",-17,1962,"Regular",16,"Away","Hawthorn","Richmond",17
6317,1962-08-11,"R16","North Melbourne",10,11,71,"Melbourne",11,17,83,"Arden St",-12,1962,"Regular",16,"Away","Melbourne","North Melbourne",12
6318,1962-08-18,"R17","Carlton",17,14,116,"Collingwood",11,8,74,"Princes Park",42,1962,"Regular",17,"Home","Carlton","Collingwood",42
6319,1962-08-18,"R17","Footscray",15,11,101,"Essendon",9,10,64,"Western Oval",37,1962,"Regular",17,"Home","Footscray","Essendon",37
6320,1962-08-18,"R17","Hawthorn",12,11,83,"Fitzroy",13,13,91,"Glenferrie Oval",-8,1962,"Regular",17,"Away","Fitzroy","Hawthorn",8
6321,1962-08-18,"R17","Geelong",14,18,102,"North Melbourne",10,11,71,"Kardinia Park",31,1962,"Regular",17,"Home","Geelong","North Melbourne",31
6322,1962-08-18,"R17","Sydney",7,10,52,"Melbourne",9,13,67,"Lake Oval",-15,1962,"Regular",17,"Away","Melbourne","Sydney",15
6323,1962-08-18,"R17","Richmond",10,8,68,"St Kilda",8,16,64,"Punt Rd",4,1962,"Regular",17,"Home","Richmond","St Kilda",4
6324,1962-08-25,"R18","Melbourne",11,9,75,"Carlton",5,10,40,"M.C.G.",35,1962,"Regular",18,"Home","Melbourne","Carlton",35
6325,1962-08-25,"R18","Collingwood",12,10,82,"Footscray",7,11,53,"Victoria Park",29,1962,"Regular",18,"Home","Collingwood","Footscray",29
6326,1962-08-25,"R18","Essendon",13,15,93,"Sydney",13,10,88,"Windy Hill",5,1962,"Regular",18,"Home","Essendon","Sydney",5
6327,1962-08-25,"R18","Fitzroy",5,14,44,"Geelong",18,14,122,"Brunswick St",-78,1962,"Regular",18,"Away","Geelong","Fitzroy",78
6328,1962-08-25,"R18","St Kilda",14,16,100,"Hawthorn",9,11,65,"Junction Oval",35,1962,"Regular",18,"Home","St Kilda","Hawthorn",35
6329,1962-08-25,"R18","North Melbourne",9,9,63,"Richmond",12,10,82,"Arden St",-19,1962,"Regular",18,"Away","Richmond","North Melbourne",19
6330,1962-09-01,"SF","Melbourne",11,10,76,"Carlton",11,12,78,"M.C.G.",-2,1962,"Finals",19,"Away","Carlton","Melbourne",2
6331,1962-09-08,"SF","Essendon",14,21,105,"Geelong",7,17,59,"M.C.G.",46,1962,"Finals",19,"Home","Essendon","Geelong",46
6332,1962-09-15,"PF","Geelong",13,7,85,"Carlton",12,13,85,"M.C.G.",0,1962,"Finals",20,"Home","Geelong","Carlton",0
6333,1962-09-22,"PF","Geelong",10,13,73,"Carlton",10,18,78,"M.C.G.",-5,1962,"Finals",20,"Away","Carlton","Geelong",5
6334,1962-09-29,"GF","Essendon",13,12,90,"Carlton",8,10,58,"M.C.G.",32,1962,"Finals",21,"Home","Essendon","Carlton",32
6335,1963-04-20,"R1","Fitzroy",10,12,72,"Carlton",14,11,95,"Brunswick St",-23,1963,"Regular",1,"Away","Carlton","Fitzroy",23
6336,1963-04-20,"R1","Richmond",11,14,80,"Collingwood",18,16,124,"Punt Rd",-44,1963,"Regular",1,"Away","Collingwood","Richmond",44
6337,1963-04-20,"R1","Hawthorn",8,12,60,"Essendon",13,7,85,"Glenferrie Oval",-25,1963,"Regular",1,"Away","Essendon","Hawthorn",25
6338,1963-04-20,"R1","North Melbourne",11,11,77,"Footscray",5,10,40,"Arden St",37,1963,"Regular",1,"Home","North Melbourne","Footscray",37
6339,1963-04-20,"R1","Geelong",16,26,122,"Sydney",9,9,63,"Kardinia Park",59,1963,"Regular",1,"Home","Geelong","Sydney",59
6340,1963-04-20,"R1","St Kilda",13,5,83,"Melbourne",9,11,65,"Junction Oval",18,1963,"Regular",1,"Home","St Kilda","Melbourne",18
6341,1963-04-25,"R2","Melbourne",14,16,100,"Hawthorn",13,18,96,"M.C.G.",4,1963,"Regular",2,"Home","Melbourne","Hawthorn",4
6342,1963-04-25,"R2","Sydney",12,14,86,"Richmond",17,7,109,"Lake Oval",-23,1963,"Regular",2,"Away","Richmond","Sydney",23
6343,1963-04-27,"R2","Carlton",7,11,53,"St Kilda",6,15,51,"Princes Park",2,1963,"Regular",2,"Home","Carlton","St Kilda",2
6344,1963-04-27,"R2","Collingwood",8,14,62,"North Melbourne",12,9,81,"Victoria Park",-19,1963,"Regular",2,"Away","North Melbourne","Collingwood",19
6345,1963-04-27,"R2","Essendon",16,13,109,"Geelong",6,14,50,"Windy Hill",59,1963,"Regular",2,"Home","Essendon","Geelong",59
6346,1963-04-27,"R2","Footscray",15,11,101,"Fitzroy",7,13,55,"Western Oval",46,1963,"Regular",2,"Home","Footscray","Fitzroy",46
6347,1963-05-04,"R3","Sydney",10,14,74,"Carlton",16,15,111,"Lake Oval",-37,1963,"Regular",3,"Away","Carlton","Sydney",37
6348,1963-05-04,"R3","Collingwood",8,16,64,"Hawthorn",13,22,100,"Victoria Park",-36,1963,"Regular",3,"Away","Hawthorn","Collingwood",36
6349,1963-05-04,"R3","Essendon",9,14,68,"Melbourne",9,9,63,"Windy Hill",5,1963,"Regular",3,"Home","Essendon","Melbourne",5
6350,1963-05-04,"R3","Fitzroy",9,13,67,"St Kilda",11,11,77,"Brunswick St",-10,1963,"Regular",3,"Away","St Kilda","Fitzroy",10
6351,1963-05-04,"R3","Geelong",10,25,85,"Footscray",10,4,64,"Kardinia Park",21,1963,"Regular",3,"Home","Geelong","Footscray",21
6352,1963-05-04,"R3","Richmond",6,12,48,"North Melbourne",10,9,69,"Punt Rd",-21,1963,"Regular",3,"Away","North Melbourne","Richmond",21
6353,1963-05-11,"R4","Carlton",9,13,67,"Essendon",8,13,61,"Princes Park",6,1963,"Regular",4,"Home","Carlton","Essendon",6
6354,1963-05-11,"R4","St Kilda",14,13,97,"Collingwood",11,7,73,"Junction Oval",24,1963,"Regular",4,"Home","St Kilda","Collingwood",24
6355,1963-05-11,"R4","Melbourne",14,10,94,"Fitzroy",8,7,55,"M.C.G.",39,1963,"Regular",4,"Home","Melbourne","Fitzroy",39
6356,1963-05-11,"R4","Footscray",14,12,96,"Richmond",11,11,77,"Western Oval",19,1963,"Regular",4,"Home","Footscray","Richmond",19
6357,1963-05-11,"R4","North Melbourne",3,7,25,"Geelong",7,19,61,"Arden St",-36,1963,"Regular",4,"Away","Geelong","North Melbourne",36
6358,1963-05-11,"R4","Hawthorn",21,25,151,"Sydney",11,14,80,"Glenferrie Oval",71,1963,"Regular",4,"Home","Hawthorn","Sydney",71
6359,1963-05-18,"R5","Richmond",11,9,75,"Carlton",11,11,77,"Punt Rd",-2,1963,"Regular",5,"Away","Carlton","Richmond",2
6360,1963-05-18,"R5","Collingwood",15,10,100,"Melbourne",7,10,52,"Victoria Park",48,1963,"Regular",5,"Home","Collingwood","Melbourne",48
6361,1963-05-18,"R5","Fitzroy",6,15,51,"Essendon",16,16,112,"Brunswick St",-61,1963,"Regular",5,"Away","Essendon","Fitzroy",61
6362,1963-05-18,"R5","Footscray",8,9,57,"Hawthorn",11,10,76,"Western Oval",-19,1963,"Regular",5,"Away","Hawthorn","Footscray",19
6363,1963-05-18,"R5","Geelong",10,12,72,"St Kilda",3,11,29,"Kardinia Park",43,1963,"Regular",5,"Home","Geelong","St Kilda",43
6364,1963-05-18,"R5","Sydney",17,11,113,"North Melbourne",11,9,75,"Lake Oval",38,1963,"Regular",5,"Home","Sydney","North Melbourne",38
6365,1963-05-25,"R6","Carlton",7,16,58,"Geelong",7,22,64,"Princes Park",-6,1963,"Regular",6,"Away","Geelong","Carlton",6
6366,1963-05-25,"R6","Fitzroy",9,5,59,"Collingwood",12,14,86,"Brunswick St",-27,1963,"Regular",6,"Away","Collingwood","Fitzroy",27
6367,1963-05-25,"R6","Essendon",13,16,94,"Footscray",6,18,54,"Windy Hill",40,1963,"Regular",6,"Home","Essendon","Footscray",40
6368,1963-05-25,"R6","Hawthorn",11,17,83,"North Melbourne",9,7,61,"Glenferrie Oval",22,1963,"Regular",6,"Home","Hawthorn","North Melbourne",22
6369,1963-05-25,"R6","Melbourne",20,15,135,"Richmond",7,14,56,"M.C.G.",79,1963,"Regular",6,"Home","Melbourne","Richmond",79
6370,1963-05-25,"R6","St Kilda",13,16,94,"Sydney",8,5,53,"Junction Oval",41,1963,"Regular",6,"Home","St Kilda","Sydney",41
6371,1963-06-01,"R7","Footscray",7,7,49,"Carlton",8,9,57,"Western Oval",-8,1963,"Regular",7,"Away","Carlton","Footscray",8
6372,1963-06-01,"R7","Collingwood",10,11,71,"Essendon",13,9,87,"Victoria Park",-16,1963,"Regular",7,"Away","Essendon","Collingwood",16
6373,1963-06-01,"R7","Richmond",17,13,115,"Fitzroy",13,8,86,"Punt Rd",29,1963,"Regular",7,"Home","Richmond","Fitzroy",29
6374,1963-06-01,"R7","Geelong",9,12,66,"Hawthorn",9,12,66,"Kardinia Park",0,1963,"Regular",7,"Home","Geelong","Hawthorn",0
6375,1963-06-01,"R7","Sydney",11,8,74,"Melbourne",8,22,70,"Lake Oval",4,1963,"Regular",7,"Home","Sydney","Melbourne",4
6376,1963-06-01,"R7","North Melbourne",8,10,58,"St Kilda",9,12,66,"Arden St",-8,1963,"Regular",7,"Away","St Kilda","North Melbourne",8
6377,1963-06-08,"R8","Carlton",6,8,44,"Collingwood",6,10,46,"Princes Park",-2,1963,"Regular",8,"Away","Collingwood","Carlton",2
6378,1963-06-08,"R8","Essendon",13,11,89,"Richmond",7,5,47,"Windy Hill",42,1963,"Regular",8,"Home","Essendon","Richmond",42
6379,1963-06-08,"R8","St Kilda",8,13,61,"Hawthorn",9,11,65,"Junction Oval",-4,1963,"Regular",8,"Away","Hawthorn","St Kilda",4
6380,1963-06-10,"R8","Fitzroy",2,11,23,"North Melbourne",6,15,51,"Brunswick St",-28,1963,"Regular",8,"Away","North Melbourne","Fitzroy",28
6381,1963-06-10,"R8","Footscray",6,16,52,"Sydney",5,9,39,"Western Oval",13,1963,"Regular",8,"Home","Footscray","Sydney",13
6382,1963-06-10,"R8","Melbourne",11,16,82,"Geelong",4,11,35,"M.C.G.",47,1963,"Regular",8,"Home","Melbourne","Geelong",47
6383,1963-06-22,"R9","Hawthorn",9,6,60,"Carlton",7,12,54,"Glenferrie Oval",6,1963,"Regular",9,"Home","Hawthorn","Carlton",6
6384,1963-06-22,"R9","Collingwood",11,6,72,"Footscray",6,4,40,"Victoria Park",32,1963,"Regular",9,"Home","Collingwood","Footscray",32
6385,1963-06-22,"R9","Essendon",4,16,40,"St Kilda",8,8,56,"Windy Hill",-16,1963,"Regular",9,"Away","St Kilda","Essendon",16
6386,1963-06-22,"R9","Sydney",8,10,58,"Fitzroy",5,9,39,"Lake Oval",19,1963,"Regular",9,"Home","Sydney","Fitzroy",19
6387,1963-06-22,"R9","Geelong",16,13,109,"Richmond",10,11,71,"Kardinia Park",38,1963,"Regular",9,"Home","Geelong","Richmond",38
6388,1963-06-22,"R9","Melbourne",18,6,114,"North Melbourne",9,10,64,"M.C.G.",50,1963,"Regular",9,"Home","Melbourne","North Melbourne",50
6389,1963-06-29,"R10","Carlton",8,8,56,"Melbourne",12,12,84,"Princes Park",-28,1963,"Regular",10,"Away","Melbourne","Carlton",28
6390,1963-06-29,"R10","Collingwood",19,11,125,"Sydney",11,8,74,"Victoria Park",51,1963,"Regular",10,"Home","Collingwood","Sydney",51
6391,1963-06-29,"R10","St Kilda",14,13,97,"Footscray",15,11,101,"Junction Oval",-4,1963,"Regular",10,"Away","Footscray","St Kilda",4
6392,1963-07-06,"R10","North Melbourne",5,5,35,"Essendon",9,9,63,"Arden St",-28,1963,"Regular",10,"Away","Essendon","North Melbourne",28
6393,1963-07-06,"R10","Fitzroy",9,13,67,"Geelong",3,13,31,"Brunswick St",36,1963,"Regular",10,"Home","Fitzroy","Geelong",36
6394,1963-07-06,"R10","Richmond",4,10,34,"Hawthorn",11,14,80,"Punt Rd",-46,1963,"Regular",10,"Away","Hawthorn","Richmond",46
6395,1963-07-20,"R11","North Melbourne",8,14,62,"Carlton",5,9,39,"Arden St",23,1963,"Regular",11,"Home","North Melbourne","Carlton",23
6396,1963-07-20,"R11","Geelong",7,13,55,"Collingwood",5,13,43,"Kardinia Park",12,1963,"Regular",11,"Home","Geelong","Collingwood",12
6397,1963-07-20,"R11","Sydney",6,10,46,"Essendon",12,20,92,"Lake Oval",-46,1963,"Regular",11,"Away","Essendon","Sydney",46
6398,1963-07-20,"R11","Hawthorn",9,17,71,"Fitzroy",6,2,38,"Glenferrie Oval",33,1963,"Regular",11,"Home","Hawthorn","Fitzroy",33
6399,1963-07-20,"R11","Footscray",3,6,24,"Melbourne",10,9,69,"Western Oval",-45,1963,"Regular",11,"Away","Melbourne","Footscray",45
6400,1963-07-20,"R11","Richmond",9,4,58,"St Kilda",14,16,100,"Punt Rd",-42,1963,"Regular",11,"Away","St Kilda","Richmond",42
6401,1963-07-27,"R12","Carlton",16,19,115,"Fitzroy",11,8,74,"Princes Park",41,1963,"Regular",12,"Home","Carlton","Fitzroy",41
6402,1963-07-27,"R12","Collingwood",12,12,84,"Richmond",13,7,85,"Victoria Park",-1,1963,"Regular",12,"Away","Richmond","Collingwood",1
6403,1963-07-27,"R12","Essendon",11,17,83,"Hawthorn",7,10,52,"Windy Hill",31,1963,"Regular",12,"Home","Essendon","Hawthorn",31
6404,1963-07-27,"R12","Footscray",10,11,71,"North Melbourne",7,10,52,"Western Oval",19,1963,"Regular",12,"Home","Footscray","North Melbourne",19
6405,1963-07-27,"R12","Sydney",8,12,60,"Geelong",14,11,95,"Lake Oval",-35,1963,"Regular",12,"Away","Geelong","Sydney",35
6406,1963-07-27,"R12","Melbourne",14,14,98,"St Kilda",5,9,39,"M.C.G.",59,1963,"Regular",12,"Home","Melbourne","St Kilda",59
6407,1963-08-03,"R13","St Kilda",14,12,96,"Carlton",7,13,55,"Junction Oval",41,1963,"Regular",13,"Home","St Kilda","Carlton",41
6408,1963-08-03,"R13","North Melbourne",9,17,71,"Collingwood",8,10,58,"Arden St",13,1963,"Regular",13,"Home","North Melbourne","Collingwood",13
6409,1963-08-03,"R13","Geelong",14,15,99,"Essendon",9,8,62,"Kardinia Park",37,1963,"Regular",13,"Home","Geelong","Essendon",37
6410,1963-08-03,"R13","Fitzroy",7,7,49,"Footscray",10,20,80,"Brunswick St",-31,1963,"Regular",13,"Away","Footscray","Fitzroy",31
6411,1963-08-03,"R13","Hawthorn",13,6,84,"Melbourne",8,14,62,"Glenferrie Oval",22,1963,"Regular",13,"Home","Hawthorn","Melbourne",22
6412,1963-08-03,"R13","Richmond",9,10,64,"Sydney",20,10,130,"Punt Rd",-66,1963,"Regular",13,"Away","Sydney","Richmond",66
6413,1963-08-10,"R14","Carlton",17,13,115,"Sydney",8,9,57,"Princes Park",58,1963,"Regular",14,"Home","Carlton","Sydney",58
6414,1963-08-10,"R14","Hawthorn",15,9,99,"Collingwood",8,9,57,"Glenferrie Oval",42,1963,"Regular",14,"Home","Hawthorn","Collingwood",42
6415,1963-08-10,"R14","Melbourne",19,8,122,"Essendon",10,11,71,"M.C.G.",51,1963,"Regular",14,"Home","Melbourne","Essendon",51
6416,1963-08-10,"R14","St Kilda",16,21,117,"Fitzroy",2,3,15,"Junction Oval",102,1963,"Regular",14,"Home","St Kilda","Fitzroy",102
6417,1963-08-10,"R14","Footscray",5,8,38,"Geelong",8,10,58,"Western Oval",-20,1963,"Regular",14,"Away","Geelong","Footscray",20
6418,1963-08-10,"R14","North Melbourne",11,8,74,"Richmond",10,4,64,"Arden St",10,1963,"Regular",14,"Home","North Melbourne","Richmond",10
6419,1963-08-17,"R15","Essendon",10,10,70,"Carlton",11,10,76,"Windy Hill",-6,1963,"Regular",15,"Away","Carlton","Essendon",6
6420,1963-08-17,"R15","Collingwood",6,6,42,"St Kilda",14,20,104,"Victoria Park",-62,1963,"Regular",15,"Away","St Kilda","Collingwood",62
6421,1963-08-17,"R15","Fitzroy",8,9,57,"Melbourne",22,21,153,"Brunswick St",-96,1963,"Regular",15,"Away","Melbourne","Fitzroy",96
6422,1963-08-17,"R15","Richmond",7,10,52,"Footscray",16,21,117,"Punt Rd",-65,1963,"Regular",15,"Away","Footscray","Richmond",65
6423,1963-08-17,"R15","Geelong",15,8,98,"North Melbourne",5,13,43,"Kardinia Park",55,1963,"Regular",15,"Home","Geelong","North Melbourne",55
6424,1963-08-17,"R15","Sydney",6,9,45,"Hawthorn",15,15,105,"Lake Oval",-60,1963,"Regular",15,"Away","Hawthorn","Sydney",60
6425,1963-08-24,"R16","Carlton",10,18,78,"Richmond",12,13,85,"Princes Park",-7,1963,"Regular",16,"Away","Richmond","Carlton",7
6426,1963-08-24,"R16","Melbourne",19,15,129,"Collingwood",10,8,68,"M.C.G.",61,1963,"Regular",16,"Home","Melbourne","Collingwood",61
6427,1963-08-24,"R16","Essendon",16,21,117,"Fitzroy",5,6,36,"Windy Hill",81,1963,"Regular",16,"Home","Essendon","Fitzroy",81
6428,1963-08-24,"R16","Hawthorn",13,21,99,"Footscray",8,7,55,"Glenferrie Oval",44,1963,"Regular",16,"Home","Hawthorn","Footscray",44
6429,1963-08-24,"R16","St Kilda",12,18,90,"Geelong",8,21,69,"Junction Oval",21,1963,"Regular",16,"Home","St Kilda","Geelong",21
6430,1963-08-24,"R16","North Melbourne",12,12,84,"Sydney",5,9,39,"Arden St",45,1963,"Regular",16,"Home","North Melbourne","Sydney",45
6431,1963-08-31,"R17","Geelong",13,17,95,"Carlton",5,4,34,"Kardinia Park",61,1963,"Regular",17,"Home","Geelong","Carlton",61
6432,1963-08-31,"R17","Collingwood",20,14,134,"Fitzroy",12,15,87,"Victoria Park",47,1963,"Regular",17,"Home","Collingwood","Fitzroy",47
6433,1963-08-31,"R17","Footscray",4,4,28,"Essendon",12,12,84,"Western Oval",-56,1963,"Regular",17,"Away","Essendon","Footscray",56
6434,1963-08-31,"R17","North Melbourne",6,9,45,"Hawthorn",12,14,86,"Arden St",-41,1963,"Regular",17,"Away","Hawthorn","North Melbourne",41
6435,1963-08-31,"R17","Richmond",7,8,50,"Melbourne",14,13,97,"Punt Rd",-47,1963,"Regular",17,"Away","Melbourne","Richmond",47
6436,1963-08-31,"R17","Sydney",8,7,55,"St Kilda",19,14,128,"Lake Oval",-73,1963,"Regular",17,"Away","St Kilda","Sydney",73
6437,1963-09-07,"R18","Carlton",13,13,91,"Footscray",8,11,59,"Princes Park",32,1963,"Regular",18,"Home","Carlton","Footscray",32
6438,1963-09-07,"R18","Essendon",12,11,83,"Collingwood",8,8,56,"Windy Hill",27,1963,"Regular",18,"Home","Essendon","Collingwood",27
6439,1963-09-07,"R18","Fitzroy",8,8,56,"Richmond",16,13,109,"Brunswick St",-53,1963,"Regular",18,"Away","Richmond","Fitzroy",53
6440,1963-09-07,"R18","Hawthorn",6,16,52,"Geelong",13,12,90,"Glenferrie Oval",-38,1963,"Regular",18,"Away","Geelong","Hawthorn",38
6441,1963-09-07,"R18","Melbourne",12,19,91,"Sydney",8,8,56,"M.C.G.",35,1963,"Regular",18,"Home","Melbourne","Sydney",35
6442,1963-09-07,"R18","St Kilda",17,14,116,"North Melbourne",4,8,32,"Junction Oval",84,1963,"Regular",18,"Home","St Kilda","North Melbourne",84
6443,1963-09-14,"SF","Melbourne",9,17,71,"St Kilda",8,16,64,"M.C.G.",7,1963,"Finals",19,"Home","Melbourne","St Kilda",7
6444,1963-09-21,"SF","Hawthorn",11,16,82,"Geelong",14,17,101,"M.C.G.",-19,1963,"Finals",19,"Away","Geelong","Hawthorn",19
6445,1963-09-28,"PF","Hawthorn",11,11,77,"Melbourne",10,8,68,"M.C.G.",9,1963,"Finals",20,"Home","Hawthorn","Melbourne",9
6446,1963-10-05,"GF","Hawthorn",8,12,60,"Geelong",15,19,109,"M.C.G.",-49,1963,"Finals",21,"Away","Geelong","Hawthorn",49
6447,1964-04-18,"R1","Carlton",10,16,76,"North Melbourne",10,8,68,"Princes Park",8,1964,"Regular",1,"Home","Carlton","North Melbourne",8
6448,1964-04-18,"R1","Collingwood",14,15,99,"Fitzroy",10,11,71,"Victoria Park",28,1964,"Regular",1,"Home","Collingwood","Fitzroy",28
6449,1964-04-18,"R1","Essendon",12,13,85,"St Kilda",11,13,79,"Windy Hill",6,1964,"Regular",1,"Home","Essendon","St Kilda",6
6450,1964-04-18,"R1","Footscray",8,16,64,"Richmond",5,4,34,"Western Oval",30,1964,"Regular",1,"Home","Footscray","Richmond",30
6451,1964-04-18,"R1","Melbourne",14,13,97,"Geelong",17,8,110,"M.C.G.",-13,1964,"Regular",1,"Away","Geelong","Melbourne",13
6452,1964-04-18,"R1","Sydney",10,13,73,"Hawthorn",14,13,97,"Lake Oval",-24,1964,"Regular",1,"Away","Hawthorn","Sydney",24
6453,1964-04-25,"R2","Hawthorn",9,20,74,"Carlton",8,5,53,"Glenferrie Oval",21,1964,"Regular",2,"Home","Hawthorn","Carlton",21
6454,1964-04-25,"R2","Geelong",14,11,95,"Collingwood",6,7,43,"Kardinia Park",52,1964,"Regular",2,"Home","Geelong","Collingwood",52
6455,1964-04-25,"R2","Richmond",11,9,75,"Essendon",15,21,111,"Punt Rd",-36,1964,"Regular",2,"Away","Essendon","Richmond",36
6456,1964-04-25,"R2","Fitzroy",13,17,95,"Sydney",18,10,118,"Brunswick St",-23,1964,"Regular",2,"Away","Sydney","Fitzroy",23
6457,1964-04-25,"R2","St Kilda",13,18,96,"Footscray",6,7,43,"Junction Oval",53,1964,"Regular",2,"Home","St Kilda","Footscray",53
6458,1964-04-25,"R2","North Melbourne",8,13,61,"Melbourne",11,11,77,"Arden St",-16,1964,"Regular",2,"Away","Melbourne","North Melbourne",16
6459,1964-05-02,"R3","Melbourne",11,13,79,"Carlton",4,9,33,"M.C.G.",46,1964,"Regular",3,"Home","Melbourne","Carlton",46
6460,1964-05-02,"R3","Footscray",8,12,60,"Collingwood",11,13,79,"Western Oval",-19,1964,"Regular",3,"Away","Collingwood","Footscray",19
6461,1964-05-02,"R3","Essendon",16,11,107,"North Melbourne",19,7,121,"Windy Hill",-14,1964,"Regular",3,"Away","North Melbourne","Essendon",14
6462,1964-05-02,"R3","Fitzroy",6,12,48,"Geelong",11,24,90,"Brunswick St",-42,1964,"Regular",3,"Away","Geelong","Fitzroy",42
6463,1964-05-02,"R3","Hawthorn",12,15,87,"St Kilda",9,11,65,"Glenferrie Oval",22,1964,"Regular",3,"Home","Hawthorn","St Kilda",22
6464,1964-05-02,"R3","Sydney",8,7,55,"Richmond",8,15,63,"Lake Oval",-8,1964,"Regular",3,"Away","Richmond","Sydney",8
6465,1964-05-09,"R4","Carlton",12,8,80,"Footscray",16,15,111,"Princes Park",-31,1964,"Regular",4,"Away","Footscray","Carlton",31
6466,1964-05-09,"R4","Collingwood",12,13,85,"Sydney",8,9,57,"Victoria Park",28,1964,"Regular",4,"Home","Collingwood","Sydney",28
6467,1964-05-09,"R4","Geelong",8,21,69,"Essendon",14,7,91,"Kardinia Park",-22,1964,"Regular",4,"Away","Essendon","Geelong",22
6468,1964-05-09,"R4","Richmond",14,20,104,"Fitzroy",5,10,40,"Punt Rd",64,1964,"Regular",4,"Home","Richmond","Fitzroy",64
6469,1964-05-09,"R4","North Melbourne",14,15,99,"Hawthorn",9,14,68,"Arden St",31,1964,"Regular",4,"Home","North Melbourne","Hawthorn",31
6470,1964-05-09,"R4","St Kilda",13,15,93,"Melbourne",9,13,67,"Junction Oval",26,1964,"Regular",4,"Home","St Kilda","Melbourne",26
6471,1964-05-16,"R5","Collingwood",12,13,85,"Carlton",9,12,66,"Victoria Park",19,1964,"Regular",5,"Home","Collingwood","Carlton",19
6472,1964-05-16,"R5","Essendon",7,11,53,"Melbourne",10,25,85,"Windy Hill",-32,1964,"Regular",5,"Away","Melbourne","Essendon",32
6473,1964-05-16,"R5","Hawthorn",16,18,114,"Fitzroy",8,19,67,"Glenferrie Oval",47,1964,"Regular",5,"Home","Hawthorn","Fitzroy",47
6474,1964-05-16,"R5","North Melbourne",15,13,103,"Footscray",7,14,56,"Arden St",47,1964,"Regular",5,"Home","North Melbourne","Footscray",47
6475,1964-05-16,"R5","Sydney",8,11,59,"Geelong",11,10,76,"Lake Oval",-17,1964,"Regular",5,"Away","Geelong","Sydney",17
6476,1964-05-16,"R5","Richmond",10,14,74,"St Kilda",8,19,67,"Punt Rd",7,1964,"Regular",5,"Home","Richmond","St Kilda",7
6477,1964-05-23,"R6","St Kilda",13,19,97,"Carlton",6,13,49,"Junction Oval",48,1964,"Regular",6,"Home","St Kilda","Carlton",48
6478,1964-05-23,"R6","Essendon",9,19,73,"Collingwood",11,3,69,"Windy Hill",4,1964,"Regular",6,"Home","Essendon","Collingwood",4
6479,1964-05-23,"R6","Fitzroy",10,18,78,"North Melbourne",13,17,95,"Brunswick St",-17,1964,"Regular",6,"Away","North Melbourne","Fitzroy",17
6480,1964-05-23,"R6","Footscray",10,22,82,"Sydney",10,9,69,"Western Oval",13,1964,"Regular",6,"Home","Footscray","Sydney",13
6481,1964-05-23,"R6","Geelong",11,6,72,"Richmond",8,11,59,"Kardinia Park",13,1964,"Regular",6,"Home","Geelong","Richmond",13
6482,1964-05-23,"R6","Melbourne",10,13,73,"Hawthorn",10,8,68,"M.C.G.",5,1964,"Regular",6,"Home","Melbourne","Hawthorn",5
6483,1964-05-30,"R7","Carlton",8,12,60,"Fitzroy",8,11,59,"Princes Park",1,1964,"Regular",7,"Home","Carlton","Fitzroy",1
6484,1964-05-30,"R7","Collingwood",22,18,150,"North Melbourne",6,6,42,"Victoria Park",108,1964,"Regular",7,"Home","Collingwood","North Melbourne",108
6485,1964-05-30,"R7","Sydney",11,18,84,"Essendon",14,12,96,"Lake Oval",-12,1964,"Regular",7,"Away","Essendon","Sydney",12
6486,1964-05-30,"R7","Melbourne",12,14,86,"Footscray",6,8,44,"M.C.G.",42,1964,"Regular",7,"Home","Melbourne","Footscray",42
6487,1964-05-30,"R7","Geelong",11,23,89,"St Kilda",13,8,86,"Kardinia Park",3,1964,"Regular",7,"Home","Geelong","St Kilda",3
6488,1964-05-30,"R7","Hawthorn",13,11,89,"Richmond",7,16,58,"Glenferrie Oval",31,1964,"Regular",7,"Home","Hawthorn","Richmond",31
6489,1964-06-06,"R8","Sydney",8,13,61,"Carlton",12,14,86,"Lake Oval",-25,1964,"Regular",8,"Away","Carlton","Sydney",25
6490,1964-06-06,"R8","Richmond",3,12,30,"Collingwood",7,13,55,"Punt Rd",-25,1964,"Regular",8,"Away","Collingwood","Richmond",25
6491,1964-06-06,"R8","Hawthorn",9,8,62,"Essendon",6,12,48,"Glenferrie Oval",14,1964,"Regular",8,"Home","Hawthorn","Essendon",14
6492,1964-06-06,"R8","Fitzroy",7,9,51,"Melbourne",17,16,118,"Brunswick St",-67,1964,"Regular",8,"Away","Melbourne","Fitzroy",67
6493,1964-06-06,"R8","Footscray",5,5,35,"Geelong",6,12,48,"Western Oval",-13,1964,"Regular",8,"Away","Geelong","Footscray",13
6494,1964-06-06,"R8","North Melbourne",10,9,69,"St Kilda",11,17,83,"Arden St",-14,1964,"Regular",8,"Away","St Kilda","North Melbourne",14
6495,1964-06-13,"R9","Carlton",11,15,81,"Richmond",11,12,78,"Princes Park",3,1964,"Regular",9,"Home","Carlton","Richmond",3
6496,1964-06-13,"R9","Essendon",13,10,88,"Footscray",10,13,73,"Windy Hill",15,1964,"Regular",9,"Home","Essendon","Footscray",15
6497,1964-06-13,"R9","St Kilda",13,18,96,"Fitzroy",6,12,48,"Junction Oval",48,1964,"Regular",9,"Home","St Kilda","Fitzroy",48
6498,1964-06-15,"R9","Melbourne",10,13,73,"Collingwood",8,15,63,"M.C.G.",10,1964,"Regular",9,"Home","Melbourne","Collingwood",10
6499,1964-06-15,"R9","Geelong",10,15,75,"Hawthorn",3,8,26,"Kardinia Park",49,1964,"Regular",9,"Home","Geelong","Hawthorn",49
6500,1964-06-15,"R9","North Melbourne",10,15,75,"Sydney",7,9,51,"Arden St",24,1964,"Regular",9,"Home","North Melbourne","Sydney",24
6501,1964-06-27,"R10","Essendon",10,9,69,"Carlton",8,15,63,"Windy Hill",6,1964,"Regular",10,"Home","Essendon","Carlton",6
6502,1964-06-27,"R10","Collingwood",13,11,89,"Hawthorn",15,8,98,"Victoria Park",-9,1964,"Regular",10,"Away","Hawthorn","Collingwood",9
6503,1964-06-27,"R10","Footscray",14,9,93,"Fitzroy",13,7,85,"Western Oval",8,1964,"Regular",10,"Home","Footscray","Fitzroy",8
6504,1964-06-27,"R10","Geelong",11,8,74,"North Melbourne",10,12,72,"Kardinia Park",2,1964,"Regular",10,"Home","Geelong","North Melbourne",2
6505,1964-06-27,"R10","Melbourne",23,18,156,"Richmond",6,7,43,"M.C.G.",113,1964,"Regular",10,"Home","Melbourne","Richmond",113
6506,1964-06-27,"R10","St Kilda",18,15,123,"Sydney",10,8,68,"Junction Oval",55,1964,"Regular",10,"Home","St Kilda","Sydney",55
6507,1964-07-04,"R11","Carlton",7,19,61,"Geelong",13,7,85,"Princes Park",-24,1964,"Regular",11,"Away","Geelong","Carlton",24
6508,1964-07-04,"R11","Collingwood",12,11,83,"St Kilda",10,9,69,"Victoria Park",14,1964,"Regular",11,"Home","Collingwood","St Kilda",14
6509,1964-07-04,"R11","Fitzroy",7,8,50,"Essendon",10,9,69,"Brunswick St",-19,1964,"Regular",11,"Away","Essendon","Fitzroy",19
6510,1964-07-04,"R11","Hawthorn",12,9,81,"Footscray",3,3,21,"Glenferrie Oval",60,1964,"Regular",11,"Home","Hawthorn","Footscray",60
6511,1964-07-04,"R11","Sydney",12,11,83,"Melbourne",18,21,129,"Lake Oval",-46,1964,"Regular",11,"Away","Melbourne","Sydney",46
6512,1964-07-04,"R11","Richmond",6,12,48,"North Melbourne",10,5,65,"Punt Rd",-17,1964,"Regular",11,"Away","North Melbourne","Richmond",17
6513,1964-07-11,"R12","North Melbourne",6,12,48,"Carlton",7,5,47,"Arden St",1,1964,"Regular",12,"Home","North Melbourne","Carlton",1
6514,1964-07-11,"R12","Fitzroy",5,8,38,"Collingwood",13,10,88,"Brunswick St",-50,1964,"Regular",12,"Away","Collingwood","Fitzroy",50
6515,1964-07-11,"R12","St Kilda",5,13,43,"Essendon",11,10,76,"Junction Oval",-33,1964,"Regular",12,"Away","Essendon","St Kilda",33
6516,1964-07-11,"R12","Richmond",12,11,83,"Footscray",9,7,61,"Punt Rd",22,1964,"Regular",12,"Home","Richmond","Footscray",22
6517,1964-07-11,"R12","Geelong",7,12,54,"Melbourne",10,15,75,"Kardinia Park",-21,1964,"Regular",12,"Away","Melbourne","Geelong",21
6518,1964-07-11,"R12","Hawthorn",15,13,103,"Sydney",6,15,51,"Glenferrie Oval",52,1964,"Regular",12,"Home","Hawthorn","Sydney",52
6519,1964-07-18,"R13","Carlton",5,12,42,"Hawthorn",8,10,58,"Princes Park",-16,1964,"Regular",13,"Away","Hawthorn","Carlton",16
6520,1964-07-18,"R13","Collingwood",8,11,59,"Geelong",7,7,49,"Victoria Park",10,1964,"Regular",13,"Home","Collingwood","Geelong",10
6521,1964-07-18,"R13","Essendon",13,28,106,"Richmond",6,8,44,"Windy Hill",62,1964,"Regular",13,"Home","Essendon","Richmond",62
6522,1964-07-18,"R13","Sydney",17,15,117,"Fitzroy",5,14,44,"Lake Oval",73,1964,"Regular",13,"Home","Sydney","Fitzroy",73
6523,1964-07-18,"R13","Footscray",11,9,75,"St Kilda",10,10,70,"Western Oval",5,1964,"Regular",13,"Home","Footscray","St Kilda",5
6524,1964-07-18,"R13","Melbourne",18,15,123,"North Melbourne",6,15,51,"M.C.G.",72,1964,"Regular",13,"Home","Melbourne","North Melbourne",72
6525,1964-07-25,"R14","Carlton",9,14,68,"Melbourne",12,8,80,"Princes Park",-12,1964,"Regular",14,"Away","Melbourne","Carlton",12
6526,1964-07-25,"R14","Collingwood",14,15,99,"Footscray",5,5,35,"Victoria Park",64,1964,"Regular",14,"Home","Collingwood","Footscray",64
6527,1964-07-25,"R14","North Melbourne",7,14,56,"Essendon",12,13,85,"Arden St",-29,1964,"Regular",14,"Away","Essendon","North Melbourne",29
6528,1964-07-25,"R14","Geelong",10,22,82,"Fitzroy",4,3,27,"Kardinia Park",55,1964,"Regular",14,"Home","Geelong","Fitzroy",55
6529,1964-07-25,"R14","St Kilda",11,15,81,"Hawthorn",7,9,51,"Junction Oval",30,1964,"Regular",14,"Home","St Kilda","Hawthorn",30
6530,1964-07-25,"R14","Richmond",13,21,99,"Sydney",5,4,34,"Punt Rd",65,1964,"Regular",14,"Home","Richmond","Sydney",65
6531,1964-08-01,"R15","Footscray",11,6,72,"Carlton",10,7,67,"Western Oval",5,1964,"Regular",15,"Home","Footscray","Carlton",5
6532,1964-08-01,"R15","Sydney",5,13,43,"Collingwood",12,13,85,"Lake Oval",-42,1964,"Regular",15,"Away","Collingwood","Sydney",42
6533,1964-08-01,"R15","Essendon",5,13,43,"Geelong",6,7,43,"Windy Hill",0,1964,"Regular",15,"Home","Essendon","Geelong",0
6534,1964-08-01,"R15","Fitzroy",2,9,21,"Richmond",10,16,76,"Brunswick St",-55,1964,"Regular",15,"Away","Richmond","Fitzroy",55
6535,1964-08-01,"R15","Hawthorn",7,7,49,"North Melbourne",5,8,38,"Glenferrie Oval",11,1964,"Regular",15,"Home","Hawthorn","North Melbourne",11
6536,1964-08-01,"R15","Melbourne",8,7,55,"St Kilda",5,7,37,"M.C.G.",18,1964,"Regular",15,"Home","Melbourne","St Kilda",18
6537,1964-08-08,"R16","Carlton",11,13,79,"Collingwood",12,7,79,"Princes Park",0,1964,"Regular",16,"Home","Carlton","Collingwood",0
6538,1964-08-08,"R16","Melbourne",7,6,48,"Essendon",6,14,50,"M.C.G.",-2,1964,"Regular",16,"Away","Essendon","Melbourne",2
6539,1964-08-08,"R16","Fitzroy",9,10,64,"Hawthorn",10,13,73,"Brunswick St",-9,1964,"Regular",16,"Away","Hawthorn","Fitzroy",9
6540,1964-08-08,"R16","Footscray",10,8,68,"North Melbourne",4,3,27,"Western Oval",41,1964,"Regular",16,"Home","Footscray","North Melbourne",41
6541,1964-08-08,"R16","Geelong",8,9,57,"Sydney",1,9,15,"Kardinia Park",42,1964,"Regular",16,"Home","Geelong","Sydney",42
6542,1964-08-08,"R16","St Kilda",10,12,72,"Richmond",6,11,47,"Junction Oval",25,1964,"Regular",16,"Home","St Kilda","Richmond",25
6543,1964-08-15,"R17","Carlton",6,9,45,"St Kilda",8,13,61,"Princes Park",-16,1964,"Regular",17,"Away","St Kilda","Carlton",16
6544,1964-08-15,"R17","Collingwood",9,14,68,"Essendon",9,11,65,"Victoria Park",3,1964,"Regular",17,"Home","Collingwood","Essendon",3
6545,1964-08-15,"R17","North Melbourne",11,14,80,"Fitzroy",12,7,79,"Arden St",1,1964,"Regular",17,"Home","North Melbourne","Fitzroy",1
6546,1964-08-15,"R17","Sydney",10,8,68,"Footscray",10,15,75,"Lake Oval",-7,1964,"Regular",17,"Away","Footscray","Sydney",7
6547,1964-08-15,"R17","Richmond",7,14,56,"Geelong",12,10,82,"Punt Rd",-26,1964,"Regular",17,"Away","Geelong","Richmond",26
6548,1964-08-15,"R17","Hawthorn",10,9,69,"Melbourne",10,13,73,"Glenferrie Oval",-4,1964,"Regular",17,"Away","Melbourne","Hawthorn",4
6549,1964-08-22,"R18","Fitzroy",7,12,54,"Carlton",19,20,134,"Brunswick St",-80,1964,"Regular",18,"Away","Carlton","Fitzroy",80
6550,1964-08-22,"R18","North Melbourne",8,13,61,"Collingwood",14,8,92,"Arden St",-31,1964,"Regular",18,"Away","Collingwood","North Melbourne",31
6551,1964-08-22,"R18","Essendon",28,16,184,"Sydney",2,7,19,"Windy Hill",165,1964,"Regular",18,"Home","Essendon","Sydney",165
6552,1964-08-22,"R18","Footscray",12,6,78,"Melbourne",4,14,38,"Western Oval",40,1964,"Regular",18,"Home","Footscray","Melbourne",40
6553,1964-08-22,"R18","St Kilda",12,18,90,"Geelong",11,12,78,"Junction Oval",12,1964,"Regular",18,"Home","St Kilda","Geelong",12
6554,1964-08-22,"R18","Richmond",9,18,72,"Hawthorn",16,19,115,"Punt Rd",-43,1964,"Regular",18,"Away","Hawthorn","Richmond",43
6555,1964-08-29,"SF","Essendon",10,5,65,"Geelong",12,12,84,"M.C.G.",-19,1964,"Finals",19,"Away","Geelong","Essendon",19
6556,1964-09-05,"SF","Melbourne",19,20,134,"Collingwood",6,9,45,"M.C.G.",89,1964,"Finals",19,"Home","Melbourne","Collingwood",89
6557,1964-09-12,"PF","Collingwood",7,6,48,"Geelong",5,14,44,"M.C.G.",4,1964,"Finals",20,"Home","Collingwood","Geelong",4
6558,1964-09-19,"GF","Melbourne",8,16,64,"Collingwood",8,12,60,"M.C.G.",4,1964,"Finals",21,"Home","Melbourne","Collingwood",4
6559,1965-04-17,"R1","Hawthorn",8,6,54,"Carlton",12,19,91,"Glenferrie Oval",-37,1965,"Regular",1,"Away","Carlton","Hawthorn",37
6560,1965-04-17,"R1","St Kilda",8,12,60,"Collingwood",8,6,54,"Moorabbin Oval",6,1965,"Regular",1,"Home","St Kilda","Collingwood",6
6561,1965-04-17,"R1","Fitzroy",8,16,64,"Essendon",11,18,84,"Brunswick St",-20,1965,"Regular",1,"Away","Essendon","Fitzroy",20
6562,1965-04-19,"R1","Geelong",5,5,35,"Footscray",5,3,33,"Kardinia Park",2,1965,"Regular",1,"Home","Geelong","Footscray",2
6563,1965-04-19,"R1","Richmond",6,5,41,"Melbourne",7,5,47,"M.C.G.",-6,1965,"Regular",1,"Away","Melbourne","Richmond",6
6564,1965-04-19,"R1","North Melbourne",4,12,36,"Sydney",6,10,46,"Coburg Oval",-10,1965,"Regular",1,"Away","Sydney","North Melbourne",10
6565,1965-04-24,"R2","Carlton",8,11,59,"Geelong",9,11,65,"Princes Park",-6,1965,"Regular",2,"Away","Geelong","Carlton",6
6566,1965-04-24,"R2","Collingwood",11,13,79,"Richmond",9,10,64,"Victoria Park",15,1965,"Regular",2,"Home","Collingwood","Richmond",15
6567,1965-04-24,"R2","Essendon",20,18,138,"Hawthorn",6,8,44,"Windy Hill",94,1965,"Regular",2,"Home","Essendon","Hawthorn",94
6568,1965-04-24,"R2","Footscray",8,6,54,"Fitzroy",9,4,58,"Western Oval",-4,1965,"Regular",2,"Away","Fitzroy","Footscray",4
6569,1965-04-24,"R2","Melbourne",11,14,80,"North Melbourne",10,12,72,"M.C.G.",8,1965,"Regular",2,"Home","Melbourne","North Melbourne",8
6570,1965-04-24,"R2","Sydney",7,9,51,"St Kilda",12,12,84,"Lake Oval",-33,1965,"Regular",2,"Away","St Kilda","Sydney",33
6571,1965-05-01,"R3","Sydney",12,14,86,"Carlton",10,11,71,"Lake Oval",15,1965,"Regular",3,"Home","Sydney","Carlton",15
6572,1965-05-01,"R3","Collingwood",19,16,130,"Hawthorn",10,9,69,"Victoria Park",61,1965,"Regular",3,"Home","Collingwood","Hawthorn",61
6573,1965-05-01,"R3","Footscray",6,12,48,"Essendon",18,18,126,"Western Oval",-78,1965,"Regular",3,"Away","Essendon","Footscray",78
6574,1965-05-01,"R3","Fitzroy",9,4,58,"Melbourne",14,25,109,"Brunswick St",-51,1965,"Regular",3,"Away","Melbourne","Fitzroy",51
6575,1965-05-01,"R3","North Melbourne",7,13,55,"Geelong",14,14,98,"Coburg Oval",-43,1965,"Regular",3,"Away","Geelong","North Melbourne",43
6576,1965-05-01,"R3","Richmond",12,13,85,"St Kilda",14,12,96,"M.C.G.",-11,1965,"Regular",3,"Away","St Kilda","Richmond",11
6577,1965-05-08,"R4","Carlton",16,11,107,"North Melbourne",6,8,44,"Princes Park",63,1965,"Regular",4,"Home","Carlton","North Melbourne",63
6578,1965-05-08,"R4","Geelong",7,8,50,"Collingwood",6,9,45,"Kardinia Park",5,1965,"Regular",4,"Home","Geelong","Collingwood",5
6579,1965-05-08,"R4","Essendon",10,9,69,"Richmond",14,9,93,"Windy Hill",-24,1965,"Regular",4,"Away","Richmond","Essendon",24
6580,1965-05-08,"R4","Hawthorn",14,14,98,"Fitzroy",9,7,61,"Glenferrie Oval",37,1965,"Regular",4,"Home","Hawthorn","Fitzroy",37
6581,1965-05-08,"R4","St Kilda",14,7,91,"Footscray",7,8,50,"Moorabbin Oval",41,1965,"Regular",4,"Home","St Kilda","Footscray",41
6582,1965-05-08,"R4","Melbourne",12,8,80,"Sydney",11,11,77,"M.C.G.",3,1965,"Regular",4,"Home","Melbourne","Sydney",3
6583,1965-05-15,"R5","Collingwood",9,11,65,"Carlton",13,7,85,"Victoria Park",-20,1965,"Regular",5,"Away","Carlton","Collingwood",20
6584,1965-05-15,"R5","St Kilda",7,14,56,"Essendon",14,9,93,"Moorabbin Oval",-37,1965,"Regular",5,"Away","Essendon","St Kilda",37
6585,1965-05-15,"R5","Fitzroy",12,9,81,"North Melbourne",16,13,109,"Brunswick St",-28,1965,"Regular",5,"Away","North Melbourne","Fitzroy",28
6586,1965-05-15,"R5","Footscray",11,11,77,"Sydney",11,10,76,"Western Oval",1,1965,"Regular",5,"Home","Footscray","Sydney",1
6587,1965-05-15,"R5","Geelong",8,7,55,"Melbourne",10,9,69,"Kardinia Park",-14,1965,"Regular",5,"Away","Melbourne","Geelong",14
6588,1965-05-15,"R5","Richmond",14,21,105,"Hawthorn",8,12,60,"M.C.G.",45,1965,"Regular",5,"Home","Richmond","Hawthorn",45
6589,1965-05-22,"R6","Carlton",8,13,61,"Richmond",6,9,45,"Princes Park",16,1965,"Regular",6,"Home","Carlton","Richmond",16
6590,1965-05-22,"R6","Melbourne",6,13,49,"Collingwood",7,5,47,"M.C.G.",2,1965,"Regular",6,"Home","Melbourne","Collingwood",2
6591,1965-05-22,"R6","Sydney",14,12,96,"Essendon",12,16,88,"Lake Oval",8,1965,"Regular",6,"Home","Sydney","Essendon",8
6592,1965-05-22,"R6","Fitzroy",8,8,56,"Geelong",11,21,87,"Brunswick St",-31,1965,"Regular",6,"Away","Geelong","Fitzroy",31
6593,1965-05-22,"R6","Hawthorn",12,9,81,"Footscray",10,14,74,"Glenferrie Oval",7,1965,"Regular",6,"Home","Hawthorn","Footscray",7
6594,1965-05-22,"R6","North Melbourne",8,10,58,"St Kilda",14,12,96,"Coburg Oval",-38,1965,"Regular",6,"Away","St Kilda","North Melbourne",38
6595,1965-05-29,"R7","Essendon",5,23,53,"Carlton",10,9,69,"Windy Hill",-16,1965,"Regular",7,"Away","Carlton","Essendon",16
6596,1965-05-29,"R7","Collingwood",15,11,101,"Sydney",10,12,72,"Victoria Park",29,1965,"Regular",7,"Home","Collingwood","Sydney",29
6597,1965-05-29,"R7","St Kilda",11,18,84,"Fitzroy",5,5,35,"Moorabbin Oval",49,1965,"Regular",7,"Home","St Kilda","Fitzroy",49
6598,1965-05-29,"R7","Footscray",9,11,65,"Melbourne",10,9,69,"Western Oval",-4,1965,"Regular",7,"Away","Melbourne","Footscray",4
6599,1965-05-29,"R7","Geelong",18,14,122,"Hawthorn",6,9,45,"Kardinia Park",77,1965,"Regular",7,"Home","Geelong","Hawthorn",77
6600,1965-05-29,"R7","Richmond",21,16,142,"North Melbourne",6,12,48,"M.C.G.",94,1965,"Regular",7,"Home","Richmond","North Melbourne",94
6601,1965-06-05,"R8","Carlton",6,22,58,"Melbourne",13,17,95,"Princes Park",-37,1965,"Regular",8,"Away","Melbourne","Carlton",37
6602,1965-06-05,"R8","Collingwood",14,12,96,"Footscray",11,12,78,"Victoria Park",18,1965,"Regular",8,"Home","Collingwood","Footscray",18
6603,1965-06-05,"R8","North Melbourne",11,15,81,"Essendon",13,10,88,"Coburg Oval",-7,1965,"Regular",8,"Away","Essendon","North Melbourne",7
6604,1965-06-05,"R8","Richmond",21,17,143,"Fitzroy",10,15,75,"M.C.G.",68,1965,"Regular",8,"Home","Richmond","Fitzroy",68
6605,1965-06-05,"R8","Geelong",8,14,62,"St Kilda",6,7,43,"Kardinia Park",19,1965,"Regular",8,"Home","Geelong","St Kilda",19
6606,1965-06-05,"R8","Sydney",13,24,102,"Hawthorn",12,19,91,"Lake Oval",11,1965,"Regular",8,"Home","Sydney","Hawthorn",11
6607,1965-06-12,"R9","Essendon",7,12,54,"Collingwood",12,14,86,"Windy Hill",-32,1965,"Regular",9,"Away","Collingwood","Essendon",32
6608,1965-06-12,"R9","Sydney",20,9,129,"Geelong",17,13,115,"Lake Oval",14,1965,"Regular",9,"Home","Sydney","Geelong",14
6609,1965-06-12,"R9","Hawthorn",14,10,94,"North Melbourne",14,13,97,"Glenferrie Oval",-3,1965,"Regular",9,"Away","North Melbourne","Hawthorn",3
6610,1965-06-14,"R9","Fitzroy",9,7,61,"Carlton",14,18,102,"Brunswick St",-41,1965,"Regular",9,"Away","Carlton","Fitzroy",41
6611,1965-06-14,"R9","Footscray",9,11,65,"Richmond",9,17,71,"Western Oval",-6,1965,"Regular",9,"Away","Richmond","Footscray",6
6612,1965-06-14,"R9","Melbourne",9,7,61,"St Kilda",18,14,122,"M.C.G.",-61,1965,"Regular",9,"Away","St Kilda","Melbourne",61
6613,1965-06-26,"R10","Carlton",12,10,82,"Footscray",8,10,58,"Princes Park",24,1965,"Regular",10,"Home","Carlton","Footscray",24
6614,1965-06-26,"R10","North Melbourne",12,11,83,"Collingwood",13,12,90,"Coburg Oval",-7,1965,"Regular",10,"Away","Collingwood","North Melbourne",7
6615,1965-06-26,"R10","Melbourne",6,6,42,"Essendon",10,11,71,"M.C.G.",-29,1965,"Regular",10,"Away","Essendon","Melbourne",29
6616,1965-06-26,"R10","Fitzroy",14,16,100,"Sydney",14,10,94,"Brunswick St",6,1965,"Regular",10,"Home","Fitzroy","Sydney",6
6617,1965-06-26,"R10","Geelong",12,9,81,"Richmond",9,11,65,"Kardinia Park",16,1965,"Regular",10,"Home","Geelong","Richmond",16
6618,1965-06-26,"R10","St Kilda",24,12,156,"Hawthorn",11,9,75,"Moorabbin Oval",81,1965,"Regular",10,"Home","St Kilda","Hawthorn",81
6619,1965-07-03,"R11","St Kilda",12,8,80,"Carlton",10,14,74,"Moorabbin Oval",6,1965,"Regular",11,"Home","St Kilda","Carlton",6
6620,1965-07-03,"R11","Footscray",7,10,52,"North Melbourne",5,10,40,"Western Oval",12,1965,"Regular",11,"Home","Footscray","North Melbourne",12
6621,1965-07-03,"R11","Hawthorn",9,13,67,"Melbourne",19,11,125,"Glenferrie Oval",-58,1965,"Regular",11,"Away","Melbourne","Hawthorn",58
6622,1965-07-10,"R11","Collingwood",10,14,74,"Fitzroy",4,6,30,"Victoria Park",44,1965,"Regular",11,"Home","Collingwood","Fitzroy",44
6623,1965-07-10,"R11","Essendon",12,16,88,"Geelong",6,9,45,"Windy Hill",43,1965,"Regular",11,"Home","Essendon","Geelong",43
6624,1965-07-10,"R11","Richmond",23,20,158,"Sydney",12,10,82,"M.C.G.",76,1965,"Regular",11,"Home","Richmond","Sydney",76
6625,1965-07-17,"R12","Carlton",8,19,67,"Hawthorn",8,4,52,"Princes Park",15,1965,"Regular",12,"Home","Carlton","Hawthorn",15
6626,1965-07-17,"R12","Collingwood",8,13,61,"St Kilda",7,5,47,"Victoria Park",14,1965,"Regular",12,"Home","Collingwood","St Kilda",14
6627,1965-07-17,"R12","Essendon",12,12,84,"Fitzroy",3,8,26,"Windy Hill",58,1965,"Regular",12,"Home","Essendon","Fitzroy",58
6628,1965-07-17,"R12","Footscray",1,8,14,"Geelong",5,13,43,"Western Oval",-29,1965,"Regular",12,"Away","Geelong","Footscray",29
6629,1965-07-17,"R12","Melbourne",9,6,60,"Richmond",9,12,66,"M.C.G.",-6,1965,"Regular",12,"Away","Richmond","Melbourne",6
6630,1965-07-17,"R12","Sydney",8,8,56,"North Melbourne",6,17,53,"Lake Oval",3,1965,"Regular",12,"Home","Sydney","North Melbourne",3
6631,1965-07-24,"R13","Geelong",5,9,39,"Carlton",9,12,66,"Kardinia Park",-27,1965,"Regular",13,"Away","Carlton","Geelong",27
6632,1965-07-24,"R13","Richmond",8,8,56,"Collingwood",12,7,79,"M.C.G.",-23,1965,"Regular",13,"Away","Collingwood","Richmond",23
6633,1965-07-24,"R13","Hawthorn",7,5,47,"Essendon",10,11,71,"Glenferrie Oval",-24,1965,"Regular",13,"Away","Essendon","Hawthorn",24
6634,1965-07-24,"R13","Fitzroy",7,13,55,"Footscray",6,6,42,"Brunswick St",13,1965,"Regular",13,"Home","Fitzroy","Footscray",13
6635,1965-07-24,"R13","North Melbourne",11,15,81,"Melbourne",9,6,60,"Coburg Oval",21,1965,"Regular",13,"Home","North Melbourne","Melbourne",21
6636,1965-07-24,"R13","St Kilda",18,9,117,"Sydney",6,12,48,"Moorabbin Oval",69,1965,"Regular",13,"Home","St Kilda","Sydney",69
6637,1965-07-31,"R14","Carlton",9,19,73,"Sydney",13,12,90,"Princes Park",-17,1965,"Regular",14,"Away","Sydney","Carlton",17
6638,1965-07-31,"R14","Hawthorn",8,12,60,"Collingwood",12,22,94,"Glenferrie Oval",-34,1965,"Regular",14,"Away","Collingwood","Hawthorn",34
6639,1965-07-31,"R14","Essendon",13,18,96,"Footscray",6,11,47,"Windy Hill",49,1965,"Regular",14,"Home","Essendon","Footscray",49
6640,1965-07-31,"R14","Melbourne",12,11,83,"Fitzroy",11,15,81,"M.C.G.",2,1965,"Regular",14,"Home","Melbourne","Fitzroy",2
6641,1965-07-31,"R14","Geelong",10,17,77,"North Melbourne",5,4,34,"Kardinia Park",43,1965,"Regular",14,"Home","Geelong","North Melbourne",43
6642,1965-07-31,"R14","St Kilda",14,12,96,"Richmond",11,17,83,"Moorabbin Oval",13,1965,"Regular",14,"Home","St Kilda","Richmond",13
6643,1965-08-07,"R15","North Melbourne",6,8,44,"Carlton",5,2,32,"Coburg Oval",12,1965,"Regular",15,"Home","North Melbourne","Carlton",12
6644,1965-08-07,"R15","Collingwood",14,9,93,"Geelong",7,4,46,"Victoria Park",47,1965,"Regular",15,"Home","Collingwood","Geelong",47
6645,1965-08-07,"R15","Richmond",14,10,94,"Essendon",5,6,36,"M.C.G.",58,1965,"Regular",15,"Home","Richmond","Essendon",58
6646,1965-08-07,"R15","Fitzroy",4,12,36,"Hawthorn",8,6,54,"Brunswick St",-18,1965,"Regular",15,"Away","Hawthorn","Fitzroy",18
6647,1965-08-07,"R15","Footscray",6,9,45,"St Kilda",9,15,69,"Western Oval",-24,1965,"Regular",15,"Away","St Kilda","Footscray",24
6648,1965-08-07,"R15","Sydney",11,12,78,"Melbourne",5,9,39,"Lake Oval",39,1965,"Regular",15,"Home","Sydney","Melbourne",39
6649,1965-08-14,"R16","Carlton",11,16,82,"Collingwood",16,11,107,"Princes Park",-25,1965,"Regular",16,"Away","Collingwood","Carlton",25
6650,1965-08-14,"R16","Essendon",9,15,69,"St Kilda",9,10,64,"Windy Hill",5,1965,"Regular",16,"Home","Essendon","St Kilda",5
6651,1965-08-14,"R16","North Melbourne",12,10,82,"Fitzroy",12,11,83,"Coburg Oval",-1,1965,"Regular",16,"Away","Fitzroy","North Melbourne",1
6652,1965-08-14,"R16","Sydney",10,18,78,"Footscray",13,14,92,"Lake Oval",-14,1965,"Regular",16,"Away","Footscray","Sydney",14
6653,1965-08-14,"R16","Melbourne",11,7,73,"Geelong",16,11,107,"M.C.G.",-34,1965,"Regular",16,"Away","Geelong","Melbourne",34
6654,1965-08-14,"R16","Hawthorn",9,14,68,"Richmond",16,14,110,"Glenferrie Oval",-42,1965,"Regular",16,"Away","Richmond","Hawthorn",42
6655,1965-08-21,"R17","Richmond",14,8,92,"Carlton",10,9,69,"M.C.G.",23,1965,"Regular",17,"Home","Richmond","Carlton",23
6656,1965-08-21,"R17","Collingwood",14,10,94,"Melbourne",7,10,52,"Victoria Park",42,1965,"Regular",17,"Home","Collingwood","Melbourne",42
6657,1965-08-21,"R17","Essendon",14,13,97,"Sydney",4,7,31,"Windy Hill",66,1965,"Regular",17,"Home","Essendon","Sydney",66
6658,1965-08-21,"R17","Geelong",9,16,70,"Fitzroy",8,4,52,"Kardinia Park",18,1965,"Regular",17,"Home","Geelong","Fitzroy",18
6659,1965-08-21,"R17","Footscray",4,17,41,"Hawthorn",11,6,72,"Western Oval",-31,1965,"Regular",17,"Away","Hawthorn","Footscray",31
6660,1965-08-21,"R17","St Kilda",12,13,85,"North Melbourne",6,12,48,"Moorabbin Oval",37,1965,"Regular",17,"Home","St Kilda","North Melbourne",37
6661,1965-08-28,"R18","Carlton",10,9,69,"Essendon",9,6,60,"Princes Park",9,1965,"Regular",18,"Home","Carlton","Essendon",9
6662,1965-08-28,"R18","Sydney",13,16,94,"Collingwood",12,6,78,"Lake Oval",16,1965,"Regular",18,"Home","Sydney","Collingwood",16
6663,1965-08-28,"R18","Fitzroy",16,6,102,"St Kilda",19,13,127,"Brunswick St",-25,1965,"Regular",18,"Away","St Kilda","Fitzroy",25
6664,1965-08-28,"R18","Melbourne",10,12,72,"Footscray",10,15,75,"M.C.G.",-3,1965,"Regular",18,"Away","Footscray","Melbourne",3
6665,1965-08-28,"R18","Hawthorn",10,9,69,"Geelong",17,20,122,"Glenferrie Oval",-53,1965,"Regular",18,"Away","Geelong","Hawthorn",53
6666,1965-08-28,"R18","North Melbourne",11,12,78,"Richmond",6,12,48,"Coburg Oval",30,1965,"Regular",18,"Home","North Melbourne","Richmond",30
6667,1965-09-04,"SF","Geelong",7,9,51,"Essendon",14,19,103,"M.C.G.",-52,1965,"Finals",19,"Away","Essendon","Geelong",52
6668,1965-09-11,"SF","St Kilda",13,24,102,"Collingwood",14,17,101,"M.C.G.",1,1965,"Finals",19,"Home","St Kilda","Collingwood",1
6669,1965-09-18,"PF","Collingwood",6,6,42,"Essendon",14,13,97,"M.C.G.",-55,1965,"Finals",20,"Away","Essendon","Collingwood",55
6670,1965-09-25,"GF","St Kilda",9,16,70,"Essendon",14,21,105,"M.C.G.",-35,1965,"Finals",21,"Away","Essendon","St Kilda",35
6671,1966-04-23,"R1","Collingwood",17,13,115,"Hawthorn",9,8,62,"Victoria Park",53,1966,"Regular",1,"Home","Collingwood","Hawthorn",53
6672,1966-04-23,"R1","Essendon",11,6,72,"Geelong",9,4,58,"Windy Hill",14,1966,"Regular",1,"Home","Essendon","Geelong",14
6673,1966-04-23,"R1","Sydney",16,19,115,"Fitzroy",9,8,62,"Lake Oval",53,1966,"Regular",1,"Home","Sydney","Fitzroy",53
6674,1966-04-25,"R1","Carlton",14,16,100,"Richmond",16,10,106,"Princes Park",-6,1966,"Regular",1,"Away","Richmond","Carlton",6
6675,1966-04-25,"R1","Footscray",11,9,75,"North Melbourne",13,9,87,"Western Oval",-12,1966,"Regular",1,"Away","North Melbourne","Footscray",12
6676,1966-04-25,"R1","Melbourne",4,9,33,"St Kilda",17,7,109,"M.C.G.",-76,1966,"Regular",1,"Away","St Kilda","Melbourne",76
6677,1966-04-30,"R2","St Kilda",15,17,107,"Carlton",7,12,54,"Moorabbin Oval",53,1966,"Regular",2,"Home","St Kilda","Carlton",53
6678,1966-04-30,"R2","Fitzroy",5,12,42,"Collingwood",9,17,71,"Brunswick St",-29,1966,"Regular",2,"Away","Collingwood","Fitzroy",29
6679,1966-04-30,"R2","North Melbourne",5,13,43,"Essendon",12,20,92,"Arden St",-49,1966,"Regular",2,"Away","Essendon","North Melbourne",49
6680,1966-04-30,"R2","Richmond",17,15,117,"Footscray",5,17,47,"M.C.G.",70,1966,"Regular",2,"Home","Richmond","Footscray",70
6681,1966-04-30,"R2","Geelong",13,16,94,"Sydney",11,8,74,"Kardinia Park",20,1966,"Regular",2,"Home","Geelong","Sydney",20
6682,1966-04-30,"R2","Hawthorn",7,14,56,"Melbourne",3,11,29,"Glenferrie Oval",27,1966,"Regular",2,"Home","Hawthorn","Melbourne",27
6683,1966-05-07,"R3","Fitzroy",6,8,44,"Carlton",10,16,76,"Brunswick St",-32,1966,"Regular",3,"Away","Carlton","Fitzroy",32
6684,1966-05-07,"R3","Essendon",8,18,66,"Collingwood",8,6,54,"Windy Hill",12,1966,"Regular",3,"Home","Essendon","Collingwood",12
6685,1966-05-07,"R3","Geelong",12,14,86,"Footscray",7,4,46,"Kardinia Park",40,1966,"Regular",3,"Home","Geelong","Footscray",40
6686,1966-05-07,"R3","Sydney",14,22,106,"Hawthorn",7,15,57,"Lake Oval",49,1966,"Regular",3,"Home","Sydney","Hawthorn",49
6687,1966-05-07,"R3","Richmond",18,15,123,"Melbourne",11,14,80,"M.C.G.",43,1966,"Regular",3,"Home","Richmond","Melbourne",43
6688,1966-05-07,"R3","North Melbourne",9,13,67,"St Kilda",15,13,103,"Arden St",-36,1966,"Regular",3,"Away","St Kilda","North Melbourne",36
6689,1966-05-14,"R4","Carlton",15,12,102,"Essendon",5,11,41,"Princes Park",61,1966,"Regular",4,"Home","Carlton","Essendon",61
6690,1966-05-14,"R4","Collingwood",12,13,85,"Richmond",5,18,48,"Victoria Park",37,1966,"Regular",4,"Home","Collingwood","Richmond",37
6691,1966-05-14,"R4","Footscray",12,12,84,"Fitzroy",5,16,46,"Western Oval",38,1966,"Regular",4,"Home","Footscray","Fitzroy",38
6692,1966-05-14,"R4","St Kilda",15,11,101,"Geelong",7,16,58,"Moorabbin Oval",43,1966,"Regular",4,"Home","St Kilda","Geelong",43
6693,1966-05-14,"R4","Hawthorn",9,13,67,"North Melbourne",14,15,99,"Glenferrie Oval",-32,1966,"Regular",4,"Away","North Melbourne","Hawthorn",32
6694,1966-05-14,"R4","Melbourne",12,17,89,"Sydney",17,17,119,"M.C.G.",-30,1966,"Regular",4,"Away","Sydney","Melbourne",30
6695,1966-05-21,"R5","Melbourne",3,14,32,"Carlton",11,13,79,"M.C.G.",-47,1966,"Regular",5,"Away","Carlton","Melbourne",47
6696,1966-05-21,"R5","North Melbourne",7,4,46,"Collingwood",11,15,81,"Arden St",-35,1966,"Regular",5,"Away","Collingwood","North Melbourne",35
6697,1966-05-21,"R5","Fitzroy",9,10,64,"Essendon",17,11,113,"Brunswick St",-49,1966,"Regular",5,"Away","Essendon","Fitzroy",49
6698,1966-05-21,"R5","Footscray",10,10,70,"Hawthorn",4,10,34,"Western Oval",36,1966,"Regular",5,"Home","Footscray","Hawthorn",36
6699,1966-05-21,"R5","Geelong",12,8,80,"Richmond",15,8,98,"Kardinia Park",-18,1966,"Regular",5,"Away","Richmond","Geelong",18
6700,1966-05-21,"R5","Sydney",7,11,53,"St Kilda",13,17,95,"Lake Oval",-42,1966,"Regular",5,"Away","St Kilda","Sydney",42
6701,1966-05-28,"R6","Carlton",11,13,79,"Footscray",6,10,46,"Princes Park",33,1966,"Regular",6,"Home","Carlton","Footscray",33
6702,1966-05-28,"R6","Collingwood",12,18,90,"Melbourne",8,9,57,"Victoria Park",33,1966,"Regular",6,"Home","Collingwood","Melbourne",33
6703,1966-05-28,"R6","Essendon",15,15,105,"Hawthorn",12,9,81,"Windy Hill",24,1966,"Regular",6,"Home","Essendon","Hawthorn",24
6704,1966-05-28,"R6","St Kilda",17,16,118,"Fitzroy",8,6,54,"Moorabbin Oval",64,1966,"Regular",6,"Home","St Kilda","Fitzroy",64
6705,1966-05-28,"R6","North Melbourne",8,7,55,"Geelong",12,20,92,"Arden St",-37,1966,"Regular",6,"Away","Geelong","North Melbourne",37
6706,1966-05-28,"R6","Richmond",12,16,88,"Sydney",9,9,63,"M.C.G.",25,1966,"Regular",6,"Home","Richmond","Sydney",25
6707,1966-06-04,"R7","Geelong",8,9,57,"Carlton",8,8,56,"Kardinia Park",1,1966,"Regular",7,"Home","Geelong","Carlton",1
6708,1966-06-04,"R7","Footscray",6,12,48,"Collingwood",8,20,68,"Western Oval",-20,1966,"Regular",7,"Away","Collingwood","Footscray",20
6709,1966-06-04,"R7","Melbourne",14,10,94,"Essendon",9,6,60,"M.C.G.",34,1966,"Regular",7,"Home","Melbourne","Essendon",34
6710,1966-06-04,"R7","Fitzroy",12,6,78,"Richmond",15,12,102,"Brunswick St",-24,1966,"Regular",7,"Away","Richmond","Fitzroy",24
6711,1966-06-04,"R7","Hawthorn",11,12,78,"St Kilda",15,12,102,"Glenferrie Oval",-24,1966,"Regular",7,"Away","St Kilda","Hawthorn",24
6712,1966-06-04,"R7","Sydney",17,16,118,"North Melbourne",15,16,106,"Lake Oval",12,1966,"Regular",7,"Home","Sydney","North Melbourne",12
6713,1966-06-11,"R8","Carlton",7,15,57,"Sydney",8,6,54,"Princes Park",3,1966,"Regular",8,"Home","Carlton","Sydney",3
6714,1966-06-11,"R8","Collingwood",14,21,105,"Geelong",11,10,76,"Victoria Park",29,1966,"Regular",8,"Home","Collingwood","Geelong",29
6715,1966-06-11,"R8","Footscray",11,5,71,"Melbourne",7,8,50,"Western Oval",21,1966,"Regular",8,"Home","Footscray","Melbourne",21
6716,1966-06-13,"R8","St Kilda",8,8,56,"Essendon",7,7,49,"Moorabbin Oval",7,1966,"Regular",8,"Home","St Kilda","Essendon",7
6717,1966-06-13,"R8","Fitzroy",8,13,61,"Hawthorn",11,14,80,"Brunswick St",-19,1966,"Regular",8,"Away","Hawthorn","Fitzroy",19
6718,1966-06-13,"R8","Richmond",10,11,71,"North Melbourne",8,23,71,"M.C.G.",0,1966,"Regular",8,"Home","Richmond","North Melbourne",0
6719,1966-06-18,"R9","Hawthorn",9,13,67,"Carlton",9,9,63,"Glenferrie Oval",4,1966,"Regular",9,"Home","Hawthorn","Carlton",4
6720,1966-06-18,"R9","Sydney",11,7,73,"Collingwood",13,20,98,"Lake Oval",-25,1966,"Regular",9,"Away","Collingwood","Sydney",25
6721,1966-06-18,"R9","Essendon",9,17,71,"Footscray",4,13,37,"Windy Hill",34,1966,"Regular",9,"Home","Essendon","Footscray",34
6722,1966-06-18,"R9","Geelong",20,24,144,"Fitzroy",5,1,31,"Kardinia Park",113,1966,"Regular",9,"Home","Geelong","Fitzroy",113
6723,1966-06-18,"R9","North Melbourne",9,11,65,"Melbourne",4,12,36,"Arden St",29,1966,"Regular",9,"Home","North Melbourne","Melbourne",29
6724,1966-06-18,"R9","Richmond",16,13,109,"St Kilda",11,8,74,"M.C.G.",35,1966,"Regular",9,"Home","Richmond","St Kilda",35
6725,1966-06-25,"R10","North Melbourne",8,17,65,"Carlton",6,6,42,"Arden St",23,1966,"Regular",10,"Home","North Melbourne","Carlton",23
6726,1966-06-25,"R10","Collingwood",17,15,117,"St Kilda",6,9,45,"Victoria Park",72,1966,"Regular",10,"Home","Collingwood","St Kilda",72
6727,1966-06-25,"R10","Essendon",14,16,100,"Richmond",15,6,96,"Windy Hill",4,1966,"Regular",10,"Home","Essendon","Richmond",4
6728,1966-06-25,"R10","Melbourne",11,17,83,"Fitzroy",3,7,25,"M.C.G.",58,1966,"Regular",10,"Home","Melbourne","Fitzroy",58
6729,1966-06-25,"R10","Footscray",8,19,67,"Sydney",8,7,55,"Western Oval",12,1966,"Regular",10,"Home","Footscray","Sydney",12
6730,1966-06-25,"R10","Geelong",17,15,117,"Hawthorn",8,9,57,"Kardinia Park",60,1966,"Regular",10,"Home","Geelong","Hawthorn",60
6731,1966-07-02,"R11","Fitzroy",10,7,67,"North Melbourne",22,8,140,"Brunswick St",-73,1966,"Regular",11,"Away","North Melbourne","Fitzroy",73
6732,1966-07-02,"R11","St Kilda",15,15,105,"Footscray",7,12,54,"Moorabbin Oval",51,1966,"Regular",11,"Home","St Kilda","Footscray",51
6733,1966-07-02,"R11","Melbourne",9,21,75,"Geelong",13,15,93,"M.C.G.",-18,1966,"Regular",11,"Away","Geelong","Melbourne",18
6734,1966-07-09,"R11","Carlton",7,11,53,"Collingwood",6,6,42,"Princes Park",11,1966,"Regular",11,"Home","Carlton","Collingwood",11
6735,1966-07-09,"R11","Sydney",12,10,82,"Essendon",13,12,90,"Lake Oval",-8,1966,"Regular",11,"Away","Essendon","Sydney",8
6736,1966-07-09,"R11","Hawthorn",6,13,49,"Richmond",11,13,79,"Glenferrie Oval",-30,1966,"Regular",11,"Away","Richmond","Hawthorn",30
6737,1966-07-16,"R12","Richmond",8,13,61,"Carlton",4,6,30,"M.C.G.",31,1966,"Regular",12,"Home","Richmond","Carlton",31
6738,1966-07-16,"R12","Hawthorn",5,7,37,"Collingwood",16,14,110,"Glenferrie Oval",-73,1966,"Regular",12,"Away","Collingwood","Hawthorn",73
6739,1966-07-16,"R12","Geelong",15,7,97,"Essendon",5,7,37,"Kardinia Park",60,1966,"Regular",12,"Home","Geelong","Essendon",60
6740,1966-07-16,"R12","Fitzroy",8,5,53,"Sydney",10,15,75,"Brunswick St",-22,1966,"Regular",12,"Away","Sydney","Fitzroy",22
6741,1966-07-16,"R12","North Melbourne",10,15,75,"Footscray",6,6,42,"Arden St",33,1966,"Regular",12,"Home","North Melbourne","Footscray",33
6742,1966-07-16,"R12","St Kilda",12,13,85,"Melbourne",6,6,42,"Moorabbin Oval",43,1966,"Regular",12,"Home","St Kilda","Melbourne",43
6743,1966-07-23,"R13","Carlton",7,15,57,"St Kilda",5,11,41,"Princes Park",16,1966,"Regular",13,"Home","Carlton","St Kilda",16
6744,1966-07-23,"R13","Collingwood",19,14,128,"Fitzroy",9,7,61,"Victoria Park",67,1966,"Regular",13,"Home","Collingwood","Fitzroy",67
6745,1966-07-23,"R13","Essendon",6,16,52,"North Melbourne",6,6,42,"Windy Hill",10,1966,"Regular",13,"Home","Essendon","North Melbourne",10
6746,1966-07-23,"R13","Footscray",7,15,57,"Richmond",11,16,82,"Western Oval",-25,1966,"Regular",13,"Away","Richmond","Footscray",25
6747,1966-07-23,"R13","Sydney",9,11,65,"Geelong",9,17,71,"Lake Oval",-6,1966,"Regular",13,"Away","Geelong","Sydney",6
6748,1966-07-23,"R13","Melbourne",23,13,151,"Hawthorn",9,5,59,"M.C.G.",92,1966,"Regular",13,"Home","Melbourne","Hawthorn",92
6749,1966-07-30,"R14","Carlton",12,15,87,"Fitzroy",9,6,60,"Princes Park",27,1966,"Regular",14,"Home","Carlton","Fitzroy",27
6750,1966-07-30,"R14","Collingwood",7,10,52,"Essendon",18,9,117,"Victoria Park",-65,1966,"Regular",14,"Away","Essendon","Collingwood",65
6751,1966-07-30,"R14","Footscray",7,9,51,"Geelong",10,11,71,"Western Oval",-20,1966,"Regular",14,"Away","Geelong","Footscray",20
6752,1966-07-30,"R14","Hawthorn",10,16,76,"Sydney",14,17,101,"Glenferrie Oval",-25,1966,"Regular",14,"Away","Sydney","Hawthorn",25
6753,1966-07-30,"R14","Melbourne",10,12,72,"Richmond",14,13,97,"M.C.G.",-25,1966,"Regular",14,"Away","Richmond","Melbourne",25
6754,1966-07-30,"R14","St Kilda",10,18,78,"North Melbourne",4,16,40,"Moorabbin Oval",38,1966,"Regular",14,"Home","St Kilda","North Melbourne",38
6755,1966-08-06,"R15","Essendon",18,7,115,"Carlton",10,13,73,"Windy Hill",42,1966,"Regular",15,"Home","Essendon","Carlton",42
6756,1966-08-06,"R15","Richmond",13,8,86,"Collingwood",16,9,105,"M.C.G.",-19,1966,"Regular",15,"Away","Collingwood","Richmond",19
6757,1966-08-06,"R15","Fitzroy",13,17,95,"Footscray",13,11,89,"Brunswick St",6,1966,"Regular",15,"Home","Fitzroy","Footscray",6
6758,1966-08-06,"R15","Geelong",14,11,95,"St Kilda",10,12,72,"Kardinia Park",23,1966,"Regular",15,"Home","Geelong","St Kilda",23
6759,1966-08-06,"R15","North Melbourne",11,16,82,"Hawthorn",12,11,83,"Arden St",-1,1966,"Regular",15,"Away","Hawthorn","North Melbourne",1
6760,1966-08-06,"R15","Sydney",18,17,125,"Melbourne",15,19,109,"Lake Oval",16,1966,"Regular",15,"Home","Sydney","Melbourne",16
6761,1966-08-13,"R16","Carlton",14,15,99,"Melbourne",10,10,70,"Princes Park",29,1966,"Regular",16,"Home","Carlton","Melbourne",29
6762,1966-08-13,"R16","Collingwood",12,21,93,"North Melbourne",6,8,44,"Victoria Park",49,1966,"Regular",16,"Home","Collingwood","North Melbourne",49
6763,1966-08-13,"R16","Essendon",14,9,93,"Fitzroy",6,9,45,"Windy Hill",48,1966,"Regular",16,"Home","Essendon","Fitzroy",48
6764,1966-08-13,"R16","Hawthorn",18,11,119,"Footscray",9,13,67,"Glenferrie Oval",52,1966,"Regular",16,"Home","Hawthorn","Footscray",52
6765,1966-08-13,"R16","Richmond",6,12,48,"Geelong",11,16,82,"M.C.G.",-34,1966,"Regular",16,"Away","Geelong","Richmond",34
6766,1966-08-13,"R16","St Kilda",19,19,133,"Sydney",10,6,66,"Moorabbin Oval",67,1966,"Regular",16,"Home","St Kilda","Sydney",67
6767,1966-08-20,"R17","Footscray",4,1,25,"Carlton",12,14,86,"Western Oval",-61,1966,"Regular",17,"Away","Carlton","Footscray",61
6768,1966-08-20,"R17","Melbourne",12,12,84,"Collingwood",21,15,141,"M.C.G.",-57,1966,"Regular",17,"Away","Collingwood","Melbourne",57
6769,1966-08-20,"R17","Hawthorn",11,13,79,"Essendon",15,10,100,"Glenferrie Oval",-21,1966,"Regular",17,"Away","Essendon","Hawthorn",21
6770,1966-08-20,"R17","Fitzroy",5,10,40,"St Kilda",17,22,124,"Brunswick St",-84,1966,"Regular",17,"Away","St Kilda","Fitzroy",84
6771,1966-08-20,"R17","Geelong",17,16,118,"North Melbourne",11,13,79,"Kardinia Park",39,1966,"Regular",17,"Home","Geelong","North Melbourne",39
6772,1966-08-20,"R17","Sydney",10,11,71,"Richmond",10,12,72,"Lake Oval",-1,1966,"Regular",17,"Away","Richmond","Sydney",1
6773,1966-08-27,"R18","Carlton",5,10,40,"Geelong",16,14,110,"Princes Park",-70,1966,"Regular",18,"Away","Geelong","Carlton",70
6774,1966-08-27,"R18","Collingwood",18,24,132,"Footscray",3,10,28,"Victoria Park",104,1966,"Regular",18,"Home","Collingwood","Footscray",104
6775,1966-08-27,"R18","Essendon",11,18,84,"Melbourne",7,7,49,"Windy Hill",35,1966,"Regular",18,"Home","Essendon","Melbourne",35
6776,1966-08-27,"R18","Richmond",20,23,143,"Fitzroy",11,10,76,"M.C.G.",67,1966,"Regular",18,"Home","Richmond","Fitzroy",67
6777,1966-08-27,"R18","St Kilda",14,9,93,"Hawthorn",13,5,83,"Moorabbin Oval",10,1966,"Regular",18,"Home","St Kilda","Hawthorn",10
6778,1966-08-27,"R18","North Melbourne",12,16,88,"Sydney",11,5,71,"Arden St",17,1966,"Regular",18,"Home","North Melbourne","Sydney",17
6779,1966-09-03,"SF","Geelong",12,14,86,"Essendon",15,6,96,"M.C.G.",-10,1966,"Finals",19,"Away","Essendon","Geelong",10
6780,1966-09-10,"SF","Collingwood",15,9,99,"St Kilda",13,11,89,"M.C.G.",10,1966,"Finals",19,"Home","Collingwood","St Kilda",10
6781,1966-09-17,"PF","St Kilda",15,4,94,"Essendon",7,10,52,"M.C.G.",42,1966,"Finals",20,"Home","St Kilda","Essendon",42
6782,1966-09-24,"GF","Collingwood",10,13,73,"St Kilda",10,14,74,"M.C.G.",-1,1966,"Finals",21,"Away","St Kilda","Collingwood",1
6783,1967-04-15,"R1","Fitzroy",5,6,36,"Carlton",18,22,130,"Princes Park",-94,1967,"Regular",1,"Away","Carlton","Fitzroy",94
6784,1967-04-15,"R1","Geelong",13,13,91,"Collingwood",13,12,90,"Kardinia Park",1,1967,"Regular",1,"Home","Geelong","Collingwood",1
6785,1967-04-15,"R1","Richmond",15,20,110,"Essendon",11,9,75,"M.C.G.",35,1967,"Regular",1,"Home","Richmond","Essendon",35
6786,1967-04-15,"R1","St Kilda",22,13,145,"Footscray",9,10,64,"Moorabbin Oval",81,1967,"Regular",1,"Home","St Kilda","Footscray",81
6787,1967-04-15,"R1","Hawthorn",20,12,132,"Sydney",15,12,102,"Glenferrie Oval",30,1967,"Regular",1,"Home","Hawthorn","Sydney",30
6788,1967-04-15,"R1","North Melbourne",8,14,62,"Melbourne",9,13,67,"Arden St",-5,1967,"Regular",1,"Away","Melbourne","North Melbourne",5
6789,1967-04-22,"R2","Carlton",12,16,88,"Hawthorn",6,8,44,"Princes Park",44,1967,"Regular",2,"Home","Carlton","Hawthorn",44
6790,1967-04-22,"R2","Collingwood",16,17,113,"North Melbourne",7,8,50,"Victoria Park",63,1967,"Regular",2,"Home","Collingwood","North Melbourne",63
6791,1967-04-22,"R2","Essendon",7,11,53,"St Kilda",8,8,56,"Windy Hill",-3,1967,"Regular",2,"Away","St Kilda","Essendon",3
6792,1967-04-22,"R2","Sydney",15,13,103,"Fitzroy",10,5,65,"Lake Oval",38,1967,"Regular",2,"Home","Sydney","Fitzroy",38
6793,1967-04-22,"R2","Footscray",12,6,78,"Richmond",8,22,70,"Western Oval",8,1967,"Regular",2,"Home","Footscray","Richmond",8
6794,1967-04-22,"R2","Melbourne",9,8,62,"Geelong",14,11,95,"M.C.G.",-33,1967,"Regular",2,"Away","Geelong","Melbourne",33
6795,1967-04-29,"R3","Carlton",10,13,73,"North Melbourne",8,9,57,"Princes Park",16,1967,"Regular",3,"Home","Carlton","North Melbourne",16
6796,1967-04-29,"R3","Essendon",8,6,54,"Collingwood",10,16,76,"Windy Hill",-22,1967,"Regular",3,"Away","Collingwood","Essendon",22
6797,1967-04-29,"R3","Richmond",11,12,78,"Fitzroy",7,11,53,"M.C.G.",25,1967,"Regular",3,"Home","Richmond","Fitzroy",25
6798,1967-04-29,"R3","Footscray",6,5,41,"Sydney",11,13,79,"Western Oval",-38,1967,"Regular",3,"Away","Sydney","Footscray",38
6799,1967-04-29,"R3","Geelong",11,15,81,"Hawthorn",7,5,47,"Kardinia Park",34,1967,"Regular",3,"Home","Geelong","Hawthorn",34
6800,1967-04-29,"R3","St Kilda",9,13,67,"Melbourne",10,9,69,"Moorabbin Oval",-2,1967,"Regular",3,"Away","Melbourne","St Kilda",2
6801,1967-05-06,"R4","Melbourne",5,15,45,"Carlton",16,8,104,"M.C.G.",-59,1967,"Regular",4,"Away","Carlton","Melbourne",59
6802,1967-05-06,"R4","Collingwood",13,17,95,"Footscray",5,7,37,"Victoria Park",58,1967,"Regular",4,"Home","Collingwood","Footscray",58
6803,1967-05-06,"R4","Sydney",18,19,127,"Essendon",13,10,88,"Lake Oval",39,1967,"Regular",4,"Home","Sydney","Essendon",39
6804,1967-05-06,"R4","Fitzroy",9,10,64,"Geelong",22,13,145,"Princes Park",-81,1967,"Regular",4,"Away","Geelong","Fitzroy",81
6805,1967-05-06,"R4","Hawthorn",10,6,66,"St Kilda",15,11,101,"Glenferrie Oval",-35,1967,"Regular",4,"Away","St Kilda","Hawthorn",35
6806,1967-05-06,"R4","North Melbourne",10,8,68,"Richmond",11,22,88,"Arden St",-20,1967,"Regular",4,"Away","Richmond","North Melbourne",20
6807,1967-05-13,"R5","St Kilda",11,9,75,"Carlton",11,14,80,"Moorabbin Oval",-5,1967,"Regular",5,"Away","Carlton","St Kilda",5
6808,1967-05-13,"R5","Collingwood",13,25,103,"Sydney",7,15,57,"Victoria Park",46,1967,"Regular",5,"Home","Collingwood","Sydney",46
6809,1967-05-13,"R5","Essendon",8,13,61,"Geelong",10,12,72,"Windy Hill",-11,1967,"Regular",5,"Away","Geelong","Essendon",11
6810,1967-05-13,"R5","Fitzroy",9,6,60,"North Melbourne",13,13,91,"Princes Park",-31,1967,"Regular",5,"Away","North Melbourne","Fitzroy",31
6811,1967-05-13,"R5","Footscray",12,11,83,"Melbourne",12,10,82,"Western Oval",1,1967,"Regular",5,"Home","Footscray","Melbourne",1
6812,1967-05-13,"R5","Richmond",16,22,118,"Hawthorn",5,13,43,"M.C.G.",75,1967,"Regular",5,"Home","Richmond","Hawthorn",75
6813,1967-05-20,"R6","Carlton",10,13,73,"Collingwood",9,13,67,"Princes Park",6,1967,"Regular",6,"Home","Carlton","Collingwood",6
6814,1967-05-20,"R6","Footscray",4,7,31,"Essendon",11,13,79,"Western Oval",-48,1967,"Regular",6,"Away","Essendon","Footscray",48
6815,1967-05-20,"R6","Melbourne",13,15,93,"Fitzroy",7,9,51,"M.C.G.",42,1967,"Regular",6,"Home","Melbourne","Fitzroy",42
6816,1967-05-20,"R6","Geelong",16,12,108,"Sydney",13,11,89,"Kardinia Park",19,1967,"Regular",6,"Home","Geelong","Sydney",19
6817,1967-05-20,"R6","Hawthorn",7,9,51,"North Melbourne",10,13,73,"Glenferrie Oval",-22,1967,"Regular",6,"Away","North Melbourne","Hawthorn",22
6818,1967-05-20,"R6","St Kilda",9,4,58,"Richmond",14,15,99,"Moorabbin Oval",-41,1967,"Regular",6,"Away","Richmond","St Kilda",41
6819,1967-05-27,"R7","Sydney",11,12,78,"Carlton",11,12,78,"Lake Oval",0,1967,"Regular",7,"Home","Sydney","Carlton",0
6820,1967-05-27,"R7","Collingwood",16,20,116,"St Kilda",14,14,98,"Victoria Park",18,1967,"Regular",7,"Home","Collingwood","St Kilda",18
6821,1967-05-27,"R7","Essendon",10,12,72,"Melbourne",6,10,46,"Windy Hill",26,1967,"Regular",7,"Home","Essendon","Melbourne",26
6822,1967-05-27,"R7","Fitzroy",9,12,66,"Hawthorn",16,14,110,"Princes Park",-44,1967,"Regular",7,"Away","Hawthorn","Fitzroy",44
6823,1967-05-27,"R7","North Melbourne",7,13,55,"Footscray",6,6,42,"Arden St",13,1967,"Regular",7,"Home","North Melbourne","Footscray",13
6824,1967-05-27,"R7","Richmond",18,11,119,"Geelong",12,9,81,"M.C.G.",38,1967,"Regular",7,"Home","Richmond","Geelong",38
6825,1967-06-03,"R8","Carlton",11,19,85,"Geelong",12,9,81,"Princes Park",4,1967,"Regular",8,"Home","Carlton","Geelong",4
6826,1967-06-03,"R8","Richmond",13,5,83,"Collingwood",13,12,90,"M.C.G.",-7,1967,"Regular",8,"Away","Collingwood","Richmond",7
6827,1967-06-03,"R8","North Melbourne",12,16,88,"Essendon",13,10,88,"Arden St",0,1967,"Regular",8,"Home","North Melbourne","Essendon",0
6828,1967-06-03,"R8","Footscray",7,15,57,"Fitzroy",12,9,81,"Western Oval",-24,1967,"Regular",8,"Away","Fitzroy","Footscray",24
6829,1967-06-03,"R8","Hawthorn",12,8,80,"Melbourne",18,17,125,"Glenferrie Oval",-45,1967,"Regular",8,"Away","Melbourne","Hawthorn",45
6830,1967-06-03,"R8","Sydney",20,18,138,"St Kilda",14,25,109,"Lake Oval",29,1967,"Regular",8,"Home","Sydney","St Kilda",29
6831,1967-06-10,"R9","Collingwood",19,20,134,"Fitzroy",4,9,33,"Victoria Park",101,1967,"Regular",9,"Home","Collingwood","Fitzroy",101
6832,1967-06-10,"R9","Essendon",21,16,142,"Hawthorn",6,15,51,"Windy Hill",91,1967,"Regular",9,"Home","Essendon","Hawthorn",91
6833,1967-06-10,"R9","St Kilda",9,17,71,"North Melbourne",8,13,61,"Moorabbin Oval",10,1967,"Regular",9,"Home","St Kilda","North Melbourne",10
6834,1967-06-12,"R9","Carlton",14,7,91,"Richmond",13,15,93,"Princes Park",-2,1967,"Regular",9,"Away","Richmond","Carlton",2
6835,1967-06-12,"R9","Geelong",15,12,102,"Footscray",9,8,62,"Kardinia Park",40,1967,"Regular",9,"Home","Geelong","Footscray",40
6836,1967-06-12,"R9","Melbourne",19,14,128,"Sydney",12,17,89,"M.C.G.",39,1967,"Regular",9,"Home","Melbourne","Sydney",39
6837,1967-06-24,"R10","Footscray",7,12,54,"Carlton",11,4,70,"Western Oval",-16,1967,"Regular",10,"Away","Carlton","Footscray",16
6838,1967-06-24,"R10","Collingwood",17,16,118,"Hawthorn",12,9,81,"Victoria Park",37,1967,"Regular",10,"Home","Collingwood","Hawthorn",37
6839,1967-06-24,"R10","Fitzroy",9,11,65,"Essendon",13,13,91,"Princes Park",-26,1967,"Regular",10,"Away","Essendon","Fitzroy",26
6840,1967-06-24,"R10","St Kilda",18,14,122,"Geelong",10,10,70,"Moorabbin Oval",52,1967,"Regular",10,"Home","St Kilda","Geelong",52
6841,1967-06-24,"R10","Richmond",24,14,158,"Melbourne",12,9,81,"M.C.G.",77,1967,"Regular",10,"Home","Richmond","Melbourne",77
6842,1967-06-24,"R10","North Melbourne",16,11,107,"Sydney",14,7,91,"Arden St",16,1967,"Regular",10,"Home","North Melbourne","Sydney",16
6843,1967-07-01,"R11","Essendon",9,16,70,"Carlton",12,7,79,"Windy Hill",-9,1967,"Regular",11,"Away","Carlton","Essendon",9
6844,1967-07-01,"R11","Melbourne",9,11,65,"Collingwood",14,14,98,"M.C.G.",-33,1967,"Regular",11,"Away","Collingwood","Melbourne",33
6845,1967-07-01,"R11","Fitzroy",9,9,63,"St Kilda",15,21,111,"Princes Park",-48,1967,"Regular",11,"Away","St Kilda","Fitzroy",48
6846,1967-07-01,"R11","Hawthorn",8,11,59,"Footscray",14,12,96,"Glenferrie Oval",-37,1967,"Regular",11,"Away","Footscray","Hawthorn",37
6847,1967-07-01,"R11","Geelong",12,6,78,"North Melbourne",9,18,72,"Kardinia Park",6,1967,"Regular",11,"Home","Geelong","North Melbourne",6
6848,1967-07-01,"R11","Sydney",8,9,57,"Richmond",14,25,109,"Lake Oval",-52,1967,"Regular",11,"Away","Richmond","Sydney",52
6849,1967-07-08,"R12","Collingwood",6,15,51,"Geelong",12,16,88,"Victoria Park",-37,1967,"Regular",12,"Away","Geelong","Collingwood",37
6850,1967-07-08,"R12","Essendon",13,15,93,"Richmond",10,12,72,"Windy Hill",21,1967,"Regular",12,"Home","Essendon","Richmond",21
6851,1967-07-08,"R12","Sydney",10,17,77,"Hawthorn",13,12,90,"Lake Oval",-13,1967,"Regular",12,"Away","Hawthorn","Sydney",13
6852,1967-07-15,"R12","Carlton",10,16,76,"Fitzroy",10,8,68,"Princes Park",8,1967,"Regular",12,"Home","Carlton","Fitzroy",8
6853,1967-07-15,"R12","Footscray",3,15,33,"St Kilda",11,12,78,"Western Oval",-45,1967,"Regular",12,"Away","St Kilda","Footscray",45
6854,1967-07-15,"R12","Melbourne",8,7,55,"North Melbourne",5,22,52,"M.C.G.",3,1967,"Regular",12,"Home","Melbourne","North Melbourne",3
6855,1967-07-22,"R13","Hawthorn",9,9,63,"Carlton",11,21,87,"Glenferrie Oval",-24,1967,"Regular",13,"Away","Carlton","Hawthorn",24
6856,1967-07-22,"R13","North Melbourne",9,8,62,"Collingwood",11,15,81,"Arden St",-19,1967,"Regular",13,"Away","Collingwood","North Melbourne",19
6857,1967-07-22,"R13","St Kilda",18,6,114,"Essendon",13,13,91,"Moorabbin Oval",23,1967,"Regular",13,"Home","St Kilda","Essendon",23
6858,1967-07-22,"R13","Fitzroy",19,21,135,"Sydney",12,10,82,"Princes Park",53,1967,"Regular",13,"Home","Fitzroy","Sydney",53
6859,1967-07-22,"R13","Richmond",19,16,130,"Footscray",8,10,58,"M.C.G.",72,1967,"Regular",13,"Home","Richmond","Footscray",72
6860,1967-07-22,"R13","Geelong",13,12,90,"Melbourne",8,9,57,"Kardinia Park",33,1967,"Regular",13,"Home","Geelong","Melbourne",33
6861,1967-07-29,"R14","North Melbourne",8,9,57,"Carlton",6,8,44,"Arden St",13,1967,"Regular",14,"Home","North Melbourne","Carlton",13
6862,1967-07-29,"R14","Collingwood",8,14,62,"Essendon",10,11,71,"Victoria Park",-9,1967,"Regular",14,"Away","Essendon","Collingwood",9
6863,1967-07-29,"R14","Fitzroy",8,10,58,"Richmond",8,19,67,"Princes Park",-9,1967,"Regular",14,"Away","Richmond","Fitzroy",9
6864,1967-07-29,"R14","Sydney",10,11,71,"Footscray",5,10,40,"Lake Oval",31,1967,"Regular",14,"Home","Sydney","Footscray",31
6865,1967-07-29,"R14","Hawthorn",11,12,78,"Geelong",7,16,58,"Glenferrie Oval",20,1967,"Regular",14,"Home","Hawthorn","Geelong",20
6866,1967-07-29,"R14","Melbourne",8,10,58,"St Kilda",12,19,91,"M.C.G.",-33,1967,"Regular",14,"Away","St Kilda","Melbourne",33
6867,1967-08-05,"R15","Carlton",7,10,52,"Melbourne",6,13,49,"Princes Park",3,1967,"Regular",15,"Home","Carlton","Melbourne",3
6868,1967-08-05,"R15","Footscray",14,9,93,"Collingwood",12,15,87,"Western Oval",6,1967,"Regular",15,"Home","Footscray","Collingwood",6
6869,1967-08-05,"R15","Essendon",14,15,99,"Sydney",7,16,58,"Windy Hill",41,1967,"Regular",15,"Home","Essendon","Sydney",41
6870,1967-08-05,"R15","Geelong",9,14,68,"Fitzroy",7,8,50,"Kardinia Park",18,1967,"Regular",15,"Home","Geelong","Fitzroy",18
6871,1967-08-05,"R15","St Kilda",17,17,119,"Hawthorn",8,8,56,"Moorabbin Oval",63,1967,"Regular",15,"Home","St Kilda","Hawthorn",63
6872,1967-08-05,"R15","Richmond",14,21,105,"North Melbourne",13,7,85,"M.C.G.",20,1967,"Regular",15,"Home","Richmond","North Melbourne",20
6873,1967-08-12,"R16","Carlton",11,7,73,"St Kilda",9,8,62,"Princes Park",11,1967,"Regular",16,"Home","Carlton","St Kilda",11
6874,1967-08-12,"R16","Sydney",5,6,36,"Collingwood",16,14,110,"Lake Oval",-74,1967,"Regular",16,"Away","Collingwood","Sydney",74
6875,1967-08-12,"R16","Geelong",10,13,73,"Essendon",4,10,34,"Kardinia Park",39,1967,"Regular",16,"Home","Geelong","Essendon",39
6876,1967-08-12,"R16","North Melbourne",9,12,66,"Fitzroy",15,15,105,"Arden St",-39,1967,"Regular",16,"Away","Fitzroy","North Melbourne",39
6877,1967-08-12,"R16","Melbourne",7,12,54,"Footscray",7,9,51,"M.C.G.",3,1967,"Regular",16,"Home","Melbourne","Footscray",3
6878,1967-08-12,"R16","Hawthorn",7,12,54,"Richmond",23,30,168,"Glenferrie Oval",-114,1967,"Regular",16,"Away","Richmond","Hawthorn",114
6879,1967-08-19,"R17","Collingwood",12,13,85,"Carlton",8,12,60,"Victoria Park",25,1967,"Regular",17,"Home","Collingwood","Carlton",25
6880,1967-08-19,"R17","Essendon",13,11,89,"Footscray",12,15,87,"Windy Hill",2,1967,"Regular",17,"Home","Essendon","Footscray",2
6881,1967-08-19,"R17","Fitzroy",8,18,66,"Melbourne",9,8,62,"Princes Park",4,1967,"Regular",17,"Home","Fitzroy","Melbourne",4
6882,1967-08-19,"R17","Sydney",9,9,63,"Geelong",21,13,139,"Lake Oval",-76,1967,"Regular",17,"Away","Geelong","Sydney",76
6883,1967-08-19,"R17","North Melbourne",9,19,73,"Hawthorn",7,3,45,"Arden St",28,1967,"Regular",17,"Home","North Melbourne","Hawthorn",28
6884,1967-08-19,"R17","Richmond",12,13,85,"St Kilda",7,11,53,"M.C.G.",32,1967,"Regular",17,"Home","Richmond","St Kilda",32
6885,1967-08-26,"R18","Carlton",10,22,82,"Sydney",7,7,49,"Princes Park",33,1967,"Regular",18,"Home","Carlton","Sydney",33
6886,1967-08-26,"R18","St Kilda",14,16,100,"Collingwood",8,5,53,"Moorabbin Oval",47,1967,"Regular",18,"Home","St Kilda","Collingwood",47
6887,1967-08-26,"R18","Melbourne",8,12,60,"Essendon",7,14,56,"M.C.G.",4,1967,"Regular",18,"Home","Melbourne","Essendon",4
6888,1967-08-26,"R18","Hawthorn",13,13,91,"Fitzroy",10,14,74,"Glenferrie Oval",17,1967,"Regular",18,"Home","Hawthorn","Fitzroy",17
6889,1967-08-26,"R18","Footscray",7,11,53,"North Melbourne",8,7,55,"Western Oval",-2,1967,"Regular",18,"Away","North Melbourne","Footscray",2
6890,1967-08-26,"R18","Geelong",15,15,105,"Richmond",18,9,117,"Kardinia Park",-12,1967,"Regular",18,"Away","Richmond","Geelong",12
6891,1967-09-02,"SF","Geelong",16,12,108,"Collingwood",11,12,78,"M.C.G.",30,1967,"Finals",19,"Home","Geelong","Collingwood",30
6892,1967-09-09,"SF","Richmond",20,21,141,"Carlton",14,17,101,"M.C.G.",40,1967,"Finals",19,"Home","Richmond","Carlton",40
6893,1967-09-16,"PF","Carlton",11,13,79,"Geelong",17,6,108,"M.C.G.",-29,1967,"Finals",20,"Away","Geelong","Carlton",29
6894,1967-09-23,"GF","Richmond",16,18,114,"Geelong",15,15,105,"M.C.G.",9,1967,"Finals",21,"Home","Richmond","Geelong",9
6895,1968-04-15,"R1","Carlton",13,22,100,"Geelong",7,12,54,"Princes Park",46,1968,"Regular",1,"Home","Carlton","Geelong",46
6896,1968-04-15,"R1","Collingwood",10,12,72,"Richmond",11,22,88,"Victoria Park",-16,1968,"Regular",1,"Away","Richmond","Collingwood",16
6897,1968-04-15,"R1","Essendon",26,16,172,"Hawthorn",15,9,99,"Windy Hill",73,1968,"Regular",1,"Home","Essendon","Hawthorn",73
6898,1968-04-15,"R1","Melbourne",14,10,94,"Fitzroy",12,18,90,"M.C.G.",4,1968,"Regular",1,"Home","Melbourne","Fitzroy",4
6899,1968-04-15,"R1","Footscray",9,18,72,"North Melbourne",13,10,88,"Western Oval",-16,1968,"Regular",1,"Away","North Melbourne","Footscray",16
6900,1968-04-15,"R1","Sydney",18,17,125,"St Kilda",13,22,100,"Lake Oval",25,1968,"Regular",1,"Home","Sydney","St Kilda",25
6901,1968-04-20,"R2","Richmond",17,16,118,"Carlton",10,12,72,"M.C.G.",46,1968,"Regular",2,"Home","Richmond","Carlton",46
6902,1968-04-20,"R2","Fitzroy",14,16,100,"Collingwood",10,11,71,"Princes Park",29,1968,"Regular",2,"Home","Fitzroy","Collingwood",29
6903,1968-04-20,"R2","North Melbourne",9,9,63,"Essendon",10,22,82,"Arden St",-19,1968,"Regular",2,"Away","Essendon","North Melbourne",19
6904,1968-04-20,"R2","Geelong",9,17,71,"Footscray",6,11,47,"Kardinia Park",24,1968,"Regular",2,"Home","Geelong","Footscray",24
6905,1968-04-20,"R2","Hawthorn",17,24,126,"Sydney",19,12,126,"Glenferrie Oval",0,1968,"Regular",2,"Home","Hawthorn","Sydney",0
6906,1968-04-20,"R2","St Kilda",16,22,118,"Melbourne",9,8,62,"Moorabbin Oval",56,1968,"Regular",2,"Home","St Kilda","Melbourne",56
6907,1968-04-25,"R3","Carlton",1,11,17,"Essendon",7,8,50,"Princes Park",-33,1968,"Regular",3,"Away","Essendon","Carlton",33
6908,1968-04-25,"R3","Richmond",10,15,75,"Geelong",17,21,123,"M.C.G.",-48,1968,"Regular",3,"Away","Geelong","Richmond",48
6909,1968-04-27,"R3","Collingwood",2,19,31,"St Kilda",10,7,67,"Victoria Park",-36,1968,"Regular",3,"Away","St Kilda","Collingwood",36
6910,1968-04-27,"R3","North Melbourne",15,17,107,"Fitzroy",14,7,91,"Arden St",16,1968,"Regular",3,"Home","North Melbourne","Fitzroy",16
6911,1968-04-27,"R3","Footscray",14,10,94,"Hawthorn",16,9,105,"Western Oval",-11,1968,"Regular",3,"Away","Hawthorn","Footscray",11
6912,1968-04-27,"R3","Sydney",13,10,88,"Melbourne",14,14,98,"Lake Oval",-10,1968,"Regular",3,"Away","Melbourne","Sydney",10
6913,1968-05-04,"R4","Hawthorn",11,11,77,"Carlton",15,10,100,"Glenferrie Oval",-23,1968,"Regular",4,"Away","Carlton","Hawthorn",23
6914,1968-05-04,"R4","Geelong",6,10,46,"Collingwood",4,13,37,"Kardinia Park",9,1968,"Regular",4,"Home","Geelong","Collingwood",9
6915,1968-05-04,"R4","Essendon",16,19,115,"Sydney",10,15,75,"Windy Hill",40,1968,"Regular",4,"Home","Essendon","Sydney",40
6916,1968-05-04,"R4","Fitzroy",13,19,97,"Footscray",12,13,85,"Princes Park",12,1968,"Regular",4,"Home","Fitzroy","Footscray",12
6917,1968-05-04,"R4","Melbourne",12,10,82,"North Melbourne",12,4,76,"M.C.G.",6,1968,"Regular",4,"Home","Melbourne","North Melbourne",6
6918,1968-05-04,"R4","St Kilda",12,12,84,"Richmond",7,18,60,"Moorabbin Oval",24,1968,"Regular",4,"Home","St Kilda","Richmond",24
6919,1968-05-11,"R5","Carlton",16,15,111,"Footscray",5,9,39,"Princes Park",72,1968,"Regular",5,"Home","Carlton","Footscray",72
6920,1968-05-11,"R5","Collingwood",17,11,113,"Hawthorn",11,16,82,"Victoria Park",31,1968,"Regular",5,"Home","Collingwood","Hawthorn",31
6921,1968-05-11,"R5","Essendon",16,16,112,"Fitzroy",11,15,81,"Windy Hill",31,1968,"Regular",5,"Home","Essendon","Fitzroy",31
6922,1968-05-11,"R5","Melbourne",9,9,63,"Geelong",10,10,70,"M.C.G.",-7,1968,"Regular",5,"Away","Geelong","Melbourne",7
6923,1968-05-11,"R5","North Melbourne",6,13,49,"St Kilda",9,7,61,"Arden St",-12,1968,"Regular",5,"Away","St Kilda","North Melbourne",12
6924,1968-05-11,"R5","Sydney",8,10,58,"Richmond",13,25,103,"Lake Oval",-45,1968,"Regular",5,"Away","Richmond","Sydney",45
6925,1968-05-18,"R6","Sydney",10,11,71,"Carlton",12,11,83,"Lake Oval",-12,1968,"Regular",6,"Away","Carlton","Sydney",12
6926,1968-05-18,"R6","Collingwood",13,14,92,"Essendon",9,12,66,"Victoria Park",26,1968,"Regular",6,"Home","Collingwood","Essendon",26
6927,1968-05-18,"R6","Fitzroy",6,8,44,"St Kilda",19,6,120,"Princes Park",-76,1968,"Regular",6,"Away","St Kilda","Fitzroy",76
6928,1968-05-18,"R6","Footscray",13,7,85,"Melbourne",6,12,48,"Western Oval",37,1968,"Regular",6,"Home","Footscray","Melbourne",37
6929,1968-05-18,"R6","Hawthorn",10,11,71,"Geelong",12,10,82,"Glenferrie Oval",-11,1968,"Regular",6,"Away","Geelong","Hawthorn",11
6930,1968-05-18,"R6","Richmond",14,17,101,"North Melbourne",4,7,31,"M.C.G.",70,1968,"Regular",6,"Home","Richmond","North Melbourne",70
6931,1968-05-25,"R7","Carlton",15,11,101,"Collingwood",9,13,67,"Princes Park",34,1968,"Regular",7,"Home","Carlton","Collingwood",34
6932,1968-05-25,"R7","Essendon",11,14,80,"Richmond",10,18,78,"Windy Hill",2,1968,"Regular",7,"Home","Essendon","Richmond",2
6933,1968-05-25,"R7","Geelong",11,21,87,"Fitzroy",7,6,48,"Kardinia Park",39,1968,"Regular",7,"Home","Geelong","Fitzroy",39
6934,1968-05-25,"R7","St Kilda",11,13,79,"Footscray",4,11,35,"Moorabbin Oval",44,1968,"Regular",7,"Home","St Kilda","Footscray",44
6935,1968-05-25,"R7","Melbourne",11,14,80,"Hawthorn",11,10,76,"M.C.G.",4,1968,"Regular",7,"Home","Melbourne","Hawthorn",4
6936,1968-05-25,"R7","North Melbourne",7,15,57,"Sydney",8,13,61,"Arden St",-4,1968,"Regular",7,"Away","Sydney","North Melbourne",4
6937,1968-06-08,"R8","Collingwood",11,13,79,"Melbourne",13,7,85,"Victoria Park",-6,1968,"Regular",8,"Away","Melbourne","Collingwood",6
6938,1968-06-08,"R8","Footscray",9,8,62,"Sydney",11,9,75,"Western Oval",-13,1968,"Regular",8,"Away","Sydney","Footscray",13
6939,1968-06-08,"R8","North Melbourne",9,11,65,"Geelong",13,11,89,"Arden St",-24,1968,"Regular",8,"Away","Geelong","North Melbourne",24
6940,1968-06-10,"R8","Fitzroy",4,10,34,"Carlton",13,15,93,"Princes Park",-59,1968,"Regular",8,"Away","Carlton","Fitzroy",59
6941,1968-06-10,"R8","St Kilda",16,17,113,"Essendon",8,9,57,"Moorabbin Oval",56,1968,"Regular",8,"Home","St Kilda","Essendon",56
6942,1968-06-10,"R8","Richmond",11,15,81,"Hawthorn",11,14,80,"M.C.G.",1,1968,"Regular",8,"Home","Richmond","Hawthorn",1
6943,1968-06-15,"R9","Carlton",20,11,131,"North Melbourne",10,15,75,"Princes Park",56,1968,"Regular",9,"Home","Carlton","North Melbourne",56
6944,1968-06-15,"R9","Sydney",19,10,124,"Collingwood",15,9,99,"Lake Oval",25,1968,"Regular",9,"Home","Sydney","Collingwood",25
6945,1968-06-15,"R9","Essendon",11,17,83,"Footscray",5,11,41,"Windy Hill",42,1968,"Regular",9,"Home","Essendon","Footscray",42
6946,1968-06-15,"R9","Hawthorn",21,14,140,"Fitzroy",16,14,110,"Glenferrie Oval",30,1968,"Regular",9,"Home","Hawthorn","Fitzroy",30
6947,1968-06-15,"R9","Geelong",15,9,99,"St Kilda",11,9,75,"Kardinia Park",24,1968,"Regular",9,"Home","Geelong","St Kilda",24
6948,1968-06-15,"R9","Melbourne",9,9,63,"Richmond",17,17,119,"M.C.G.",-56,1968,"Regular",9,"Away","Richmond","Melbourne",56
6949,1968-06-22,"R10","St Kilda",3,10,28,"Carlton",8,8,56,"Moorabbin Oval",-28,1968,"Regular",10,"Away","Carlton","St Kilda",28
6950,1968-06-22,"R10","Footscray",5,7,37,"Collingwood",9,11,65,"Western Oval",-28,1968,"Regular",10,"Away","Collingwood","Footscray",28
6951,1968-06-22,"R10","Melbourne",9,14,68,"Essendon",15,6,96,"M.C.G.",-28,1968,"Regular",10,"Away","Essendon","Melbourne",28
6952,1968-06-22,"R10","Fitzroy",12,12,84,"Richmond",15,15,105,"Princes Park",-21,1968,"Regular",10,"Away","Richmond","Fitzroy",21
6953,1968-06-22,"R10","Geelong",13,15,93,"Sydney",8,15,63,"Kardinia Park",30,1968,"Regular",10,"Home","Geelong","Sydney",30
6954,1968-06-22,"R10","North Melbourne",8,14,62,"Hawthorn",15,16,106,"Arden St",-44,1968,"Regular",10,"Away","Hawthorn","North Melbourne",44
6955,1968-06-29,"R11","Carlton",11,19,85,"Melbourne",6,7,43,"Princes Park",42,1968,"Regular",11,"Home","Carlton","Melbourne",42
6956,1968-06-29,"R11","Collingwood",13,16,94,"North Melbourne",4,8,32,"Victoria Park",62,1968,"Regular",11,"Home","Collingwood","North Melbourne",62
6957,1968-06-29,"R11","Essendon",14,20,104,"Geelong",12,9,81,"Windy Hill",23,1968,"Regular",11,"Home","Essendon","Geelong",23
6958,1968-06-29,"R11","Sydney",17,15,117,"Fitzroy",13,12,90,"Lake Oval",27,1968,"Regular",11,"Home","Sydney","Fitzroy",27
6959,1968-06-29,"R11","Richmond",17,20,122,"Footscray",16,8,104,"M.C.G.",18,1968,"Regular",11,"Home","Richmond","Footscray",18
6960,1968-06-29,"R11","Hawthorn",15,11,101,"St Kilda",17,9,111,"Glenferrie Oval",-10,1968,"Regular",11,"Away","St Kilda","Hawthorn",10
6961,1968-07-06,"R12","Geelong",8,7,55,"Carlton",9,9,63,"Kardinia Park",-8,1968,"Regular",12,"Away","Carlton","Geelong",8
6962,1968-07-06,"R12","Richmond",17,12,114,"Collingwood",17,15,117,"M.C.G.",-3,1968,"Regular",12,"Away","Collingwood","Richmond",3
6963,1968-07-06,"R12","Hawthorn",11,17,83,"Essendon",17,10,112,"Glenferrie Oval",-29,1968,"Regular",12,"Away","Essendon","Hawthorn",29
6964,1968-07-06,"R12","Fitzroy",11,14,80,"Melbourne",14,16,100,"Princes Park",-20,1968,"Regular",12,"Away","Melbourne","Fitzroy",20
6965,1968-07-06,"R12","North Melbourne",8,9,57,"Footscray",9,18,72,"Arden St",-15,1968,"Regular",12,"Away","Footscray","North Melbourne",15
6966,1968-07-06,"R12","St Kilda",15,19,109,"Sydney",6,9,45,"Moorabbin Oval",64,1968,"Regular",12,"Home","St Kilda","Sydney",64
6967,1968-07-13,"R13","Carlton",11,14,80,"Richmond",10,14,74,"Princes Park",6,1968,"Regular",13,"Home","Carlton","Richmond",6
6968,1968-07-13,"R13","Collingwood",18,14,122,"Fitzroy",18,7,115,"Victoria Park",7,1968,"Regular",13,"Home","Collingwood","Fitzroy",7
6969,1968-07-13,"R13","Essendon",16,19,115,"North Melbourne",9,9,63,"Windy Hill",52,1968,"Regular",13,"Home","Essendon","North Melbourne",52
6970,1968-07-13,"R13","Footscray",18,18,126,"Geelong",5,13,43,"Western Oval",83,1968,"Regular",13,"Home","Footscray","Geelong",83
6971,1968-07-13,"R13","Sydney",12,10,82,"Hawthorn",15,11,101,"Lake Oval",-19,1968,"Regular",13,"Away","Hawthorn","Sydney",19
6972,1968-07-13,"R13","Melbourne",10,11,71,"St Kilda",10,16,76,"M.C.G.",-5,1968,"Regular",13,"Away","St Kilda","Melbourne",5
6973,1968-07-20,"R14","Essendon",7,13,55,"Carlton",6,13,49,"Windy Hill",6,1968,"Regular",14,"Home","Essendon","Carlton",6
6974,1968-07-20,"R14","St Kilda",11,10,76,"Collingwood",12,13,85,"Moorabbin Oval",-9,1968,"Regular",14,"Away","Collingwood","St Kilda",9
6975,1968-07-20,"R14","Fitzroy",13,17,95,"North Melbourne",9,14,68,"Princes Park",27,1968,"Regular",14,"Home","Fitzroy","North Melbourne",27
6976,1968-07-20,"R14","Hawthorn",24,8,152,"Footscray",10,10,70,"Glenferrie Oval",82,1968,"Regular",14,"Home","Hawthorn","Footscray",82
6977,1968-07-20,"R14","Geelong",13,11,89,"Richmond",9,16,70,"Kardinia Park",19,1968,"Regular",14,"Home","Geelong","Richmond",19
6978,1968-07-20,"R14","Melbourne",10,10,70,"Sydney",12,8,80,"M.C.G.",-10,1968,"Regular",14,"Away","Sydney","Melbourne",10
6979,1968-07-27,"R15","Carlton",9,14,68,"Hawthorn",11,15,81,"Princes Park",-13,1968,"Regular",15,"Away","Hawthorn","Carlton",13
6980,1968-07-27,"R15","Collingwood",4,12,36,"Geelong",7,12,54,"Victoria Park",-18,1968,"Regular",15,"Away","Geelong","Collingwood",18
6981,1968-07-27,"R15","Sydney",7,12,54,"Essendon",14,13,97,"Lake Oval",-43,1968,"Regular",15,"Away","Essendon","Sydney",43
6982,1968-07-27,"R15","Footscray",9,12,66,"Fitzroy",10,11,71,"Western Oval",-5,1968,"Regular",15,"Away","Fitzroy","Footscray",5
6983,1968-07-27,"R15","North Melbourne",5,8,38,"Melbourne",6,4,40,"Arden St",-2,1968,"Regular",15,"Away","Melbourne","North Melbourne",2
6984,1968-07-27,"R15","Richmond",13,16,94,"St Kilda",9,10,64,"M.C.G.",30,1968,"Regular",15,"Home","Richmond","St Kilda",30
6985,1968-08-03,"R16","Footscray",16,6,102,"Carlton",10,10,70,"Western Oval",32,1968,"Regular",16,"Home","Footscray","Carlton",32
6986,1968-08-03,"R16","Hawthorn",15,11,101,"Collingwood",10,16,76,"Glenferrie Oval",25,1968,"Regular",16,"Home","Hawthorn","Collingwood",25
6987,1968-08-03,"R16","Fitzroy",13,15,93,"Essendon",13,16,94,"Princes Park",-1,1968,"Regular",16,"Away","Essendon","Fitzroy",1
6988,1968-08-03,"R16","Geelong",11,9,75,"Melbourne",10,8,68,"Kardinia Park",7,1968,"Regular",16,"Home","Geelong","Melbourne",7
6989,1968-08-03,"R16","St Kilda",8,13,61,"North Melbourne",6,3,39,"Moorabbin Oval",22,1968,"Regular",16,"Home","St Kilda","North Melbourne",22
6990,1968-08-03,"R16","Richmond",15,21,111,"Sydney",10,11,71,"M.C.G.",40,1968,"Regular",16,"Home","Richmond","Sydney",40
6991,1968-08-10,"R17","Carlton",18,14,122,"Sydney",11,14,80,"Princes Park",42,1968,"Regular",17,"Home","Carlton","Sydney",42
6992,1968-08-10,"R17","Essendon",20,18,138,"Collingwood",7,11,53,"Windy Hill",85,1968,"Regular",17,"Home","Essendon","Collingwood",85
6993,1968-08-10,"R17","St Kilda",12,19,91,"Fitzroy",6,5,41,"Moorabbin Oval",50,1968,"Regular",17,"Home","St Kilda","Fitzroy",50
6994,1968-08-10,"R17","Melbourne",10,14,74,"Footscray",9,11,65,"M.C.G.",9,1968,"Regular",17,"Home","Melbourne","Footscray",9
6995,1968-08-10,"R17","Geelong",10,7,67,"Hawthorn",7,9,51,"Kardinia Park",16,1968,"Regular",17,"Home","Geelong","Hawthorn",16
6996,1968-08-10,"R17","North Melbourne",7,9,51,"Richmond",11,19,85,"Arden St",-34,1968,"Regular",17,"Away","Richmond","North Melbourne",34
6997,1968-08-17,"R18","Collingwood",10,10,70,"Carlton",16,11,107,"Victoria Park",-37,1968,"Regular",18,"Away","Carlton","Collingwood",37
6998,1968-08-17,"R18","Richmond",10,14,74,"Essendon",7,12,54,"M.C.G.",20,1968,"Regular",18,"Home","Richmond","Essendon",20
6999,1968-08-17,"R18","Fitzroy",10,12,72,"Geelong",14,10,94,"Princes Park",-22,1968,"Regular",18,"Away","Geelong","Fitzroy",22
7000,1968-08-17,"R18","Footscray",6,8,44,"St Kilda",16,13,109,"Western Oval",-65,1968,"Regular",18,"Away","St Kilda","Footscray",65
7001,1968-08-17,"R18","Hawthorn",14,13,97,"Melbourne",8,11,59,"Glenferrie Oval",38,1968,"Regular",18,"Home","Hawthorn","Melbourne",38
7002,1968-08-17,"R18","Sydney",9,14,68,"North Melbourne",11,13,79,"Lake Oval",-11,1968,"Regular",18,"Away","North Melbourne","Sydney",11
7003,1968-08-24,"R19","Carlton",21,17,143,"Fitzroy",12,19,91,"Princes Park",52,1968,"Regular",19,"Home","Carlton","Fitzroy",52
7004,1968-08-24,"R19","Melbourne",12,14,86,"Collingwood",12,15,87,"M.C.G.",-1,1968,"Regular",19,"Away","Collingwood","Melbourne",1
7005,1968-08-24,"R19","Essendon",10,6,66,"St Kilda",9,12,66,"Windy Hill",0,1968,"Regular",19,"Home","Essendon","St Kilda",0
7006,1968-08-24,"R19","Sydney",11,12,78,"Footscray",11,16,82,"Lake Oval",-4,1968,"Regular",19,"Away","Footscray","Sydney",4
7007,1968-08-24,"R19","Geelong",14,13,97,"North Melbourne",13,9,87,"Kardinia Park",10,1968,"Regular",19,"Home","Geelong","North Melbourne",10
7008,1968-08-24,"R19","Hawthorn",11,13,79,"Richmond",11,22,88,"Glenferrie Oval",-9,1968,"Regular",19,"Away","Richmond","Hawthorn",9
7009,1968-08-31,"R20","North Melbourne",11,13,79,"Carlton",15,10,100,"Arden St",-21,1968,"Regular",20,"Away","Carlton","North Melbourne",21
7010,1968-08-31,"R20","Collingwood",23,19,157,"Sydney",14,14,98,"Victoria Park",59,1968,"Regular",20,"Home","Collingwood","Sydney",59
7011,1968-08-31,"R20","Footscray",12,13,85,"Essendon",15,22,112,"Western Oval",-27,1968,"Regular",20,"Away","Essendon","Footscray",27
7012,1968-08-31,"R20","Fitzroy",17,14,116,"Hawthorn",18,18,126,"Princes Park",-10,1968,"Regular",20,"Away","Hawthorn","Fitzroy",10
7013,1968-08-31,"R20","St Kilda",16,14,110,"Geelong",8,11,59,"Moorabbin Oval",51,1968,"Regular",20,"Home","St Kilda","Geelong",51
7014,1968-08-31,"R20","Richmond",18,21,129,"Melbourne",12,8,80,"M.C.G.",49,1968,"Regular",20,"Home","Richmond","Melbourne",49
7015,1968-09-07,"SF","Geelong",19,13,127,"St Kilda",11,17,83,"M.C.G.",44,1968,"Finals",21,"Home","Geelong","St Kilda",44
7016,1968-09-14,"SF","Essendon",8,11,59,"Carlton",13,17,95,"M.C.G.",-36,1968,"Finals",21,"Away","Carlton","Essendon",36
7017,1968-09-21,"PF","Essendon",11,25,91,"Geelong",9,13,67,"M.C.G.",24,1968,"Finals",22,"Home","Essendon","Geelong",24
7018,1968-09-28,"GF","Essendon",8,5,53,"Carlton",7,14,56,"M.C.G.",-3,1968,"Finals",23,"Away","Carlton","Essendon",3
7019,1969-04-05,"R1","St Kilda",11,13,79,"Carlton",11,16,82,"Moorabbin Oval",-3,1969,"Regular",1,"Away","Carlton","St Kilda",3
7020,1969-04-05,"R1","Hawthorn",17,9,111,"Collingwood",11,23,89,"Glenferrie Oval",22,1969,"Regular",1,"Home","Hawthorn","Collingwood",22
7021,1969-04-05,"R1","North Melbourne",15,20,110,"Sydney",14,17,101,"Arden St",9,1969,"Regular",1,"Home","North Melbourne","Sydney",9
7022,1969-04-07,"R1","Richmond",15,21,111,"Essendon",12,10,82,"M.C.G.",29,1969,"Regular",1,"Home","Richmond","Essendon",29
7023,1969-04-07,"R1","Fitzroy",15,13,103,"Footscray",23,21,159,"Princes Park",-56,1969,"Regular",1,"Away","Footscray","Fitzroy",56
7024,1969-04-07,"R1","Geelong",17,16,118,"Melbourne",13,13,91,"Kardinia Park",27,1969,"Regular",1,"Home","Geelong","Melbourne",27
7025,1969-04-12,"R2","Carlton",30,30,210,"Hawthorn",12,10,82,"Princes Park",128,1969,"Regular",2,"Home","Carlton","Hawthorn",128
7026,1969-04-12,"R2","Collingwood",11,16,82,"Richmond",14,15,99,"Victoria Park",-17,1969,"Regular",2,"Away","Richmond","Collingwood",17
7027,1969-04-12,"R2","Essendon",13,13,91,"Geelong",14,7,91,"Windy Hill",0,1969,"Regular",2,"Home","Essendon","Geelong",0
7028,1969-04-12,"R2","Sydney",14,14,98,"Fitzroy",15,10,100,"Lake Oval",-2,1969,"Regular",2,"Away","Fitzroy","Sydney",2
7029,1969-04-12,"R2","Footscray",9,11,65,"St Kilda",14,14,98,"Western Oval",-33,1969,"Regular",2,"Away","St Kilda","Footscray",33
7030,1969-04-12,"R2","Melbourne",12,7,79,"North Melbourne",15,17,107,"M.C.G.",-28,1969,"Regular",2,"Away","North Melbourne","Melbourne",28
7031,1969-04-19,"R3","Footscray",7,10,52,"Carlton",11,15,81,"Western Oval",-29,1969,"Regular",3,"Away","Carlton","Footscray",29
7032,1969-04-19,"R3","Collingwood",19,16,130,"Melbourne",9,8,62,"Victoria Park",68,1969,"Regular",3,"Home","Collingwood","Melbourne",68
7033,1969-04-19,"R3","Essendon",12,13,85,"Hawthorn",14,14,98,"Windy Hill",-13,1969,"Regular",3,"Away","Hawthorn","Essendon",13
7034,1969-04-19,"R3","Fitzroy",14,7,91,"St Kilda",19,18,132,"Princes Park",-41,1969,"Regular",3,"Away","St Kilda","Fitzroy",41
7035,1969-04-19,"R3","Geelong",19,20,134,"Sydney",11,8,74,"Kardinia Park",60,1969,"Regular",3,"Home","Geelong","Sydney",60
7036,1969-04-19,"R3","Richmond",13,28,106,"North Melbourne",16,15,111,"M.C.G.",-5,1969,"Regular",3,"Away","North Melbourne","Richmond",5
7037,1969-04-25,"R4","Melbourne",10,19,79,"Essendon",13,19,97,"M.C.G.",-18,1969,"Regular",4,"Away","Essendon","Melbourne",18
7038,1969-04-25,"R4","St Kilda",9,15,69,"Geelong",13,14,92,"Moorabbin Oval",-23,1969,"Regular",4,"Away","Geelong","St Kilda",23
7039,1969-04-26,"R4","Carlton",13,11,89,"Collingwood",23,15,153,"Princes Park",-64,1969,"Regular",4,"Away","Collingwood","Carlton",64
7040,1969-04-26,"R4","North Melbourne",19,15,129,"Fitzroy",13,18,96,"Arden St",33,1969,"Regular",4,"Home","North Melbourne","Fitzroy",33
7041,1969-04-26,"R4","Hawthorn",19,16,130,"Footscray",12,13,85,"Glenferrie Oval",45,1969,"Regular",4,"Home","Hawthorn","Footscray",45
7042,1969-04-26,"R4","Sydney",13,13,91,"Richmond",19,22,136,"Lake Oval",-45,1969,"Regular",4,"Away","Richmond","Sydney",45
7043,1969-05-03,"R5","Carlton",20,17,137,"Sydney",17,10,112,"Princes Park",25,1969,"Regular",5,"Home","Carlton","Sydney",25
7044,1969-05-03,"R5","St Kilda",18,12,120,"Collingwood",16,18,114,"Moorabbin Oval",6,1969,"Regular",5,"Home","St Kilda","Collingwood",6
7045,1969-05-03,"R5","Essendon",16,17,113,"North Melbourne",12,11,83,"Windy Hill",30,1969,"Regular",5,"Home","Essendon","North Melbourne",30
7046,1969-05-03,"R5","Richmond",18,12,120,"Fitzroy",6,19,55,"M.C.G.",65,1969,"Regular",5,"Home","Richmond","Fitzroy",65
7047,1969-05-03,"R5","Footscray",11,18,84,"Geelong",22,12,144,"Western Oval",-60,1969,"Regular",5,"Away","Geelong","Footscray",60
7048,1969-05-03,"R5","Hawthorn",21,10,136,"Melbourne",14,20,104,"Glenferrie Oval",32,1969,"Regular",5,"Home","Hawthorn","Melbourne",32
7049,1969-05-10,"R6","Geelong",18,16,124,"Carlton",13,7,85,"Kardinia Park",39,1969,"Regular",6,"Home","Geelong","Carlton",39
7050,1969-05-10,"R6","Collingwood",17,13,115,"Footscray",8,14,62,"Victoria Park",53,1969,"Regular",6,"Home","Collingwood","Footscray",53
7051,1969-05-10,"R6","Fitzroy",13,12,90,"Essendon",17,13,115,"Princes Park",-25,1969,"Regular",6,"Away","Essendon","Fitzroy",25
7052,1969-05-10,"R6","North Melbourne",13,9,87,"Hawthorn",14,12,96,"Arden St",-9,1969,"Regular",6,"Away","Hawthorn","North Melbourne",9
7053,1969-05-10,"R6","Melbourne",13,15,93,"Richmond",16,25,121,"M.C.G.",-28,1969,"Regular",6,"Away","Richmond","Melbourne",28
7054,1969-05-10,"R6","Sydney",14,9,93,"St Kilda",7,14,56,"Lake Oval",37,1969,"Regular",6,"Home","Sydney","St Kilda",37
7055,1969-05-17,"R7","Carlton",14,24,108,"Melbourne",12,6,78,"Princes Park",30,1969,"Regular",7,"Home","Carlton","Melbourne",30
7056,1969-05-17,"R7","Collingwood",13,20,98,"Fitzroy",13,7,85,"Victoria Park",13,1969,"Regular",7,"Home","Collingwood","Fitzroy",13
7057,1969-05-17,"R7","St Kilda",16,10,106,"Essendon",11,14,80,"Moorabbin Oval",26,1969,"Regular",7,"Home","St Kilda","Essendon",26
7058,1969-05-17,"R7","Footscray",8,10,58,"Sydney",9,12,66,"Western Oval",-8,1969,"Regular",7,"Away","Sydney","Footscray",8
7059,1969-05-17,"R7","Geelong",14,15,99,"North Melbourne",14,23,107,"Kardinia Park",-8,1969,"Regular",7,"Away","North Melbourne","Geelong",8
7060,1969-05-17,"R7","Richmond",7,10,52,"Hawthorn",8,13,61,"M.C.G.",-9,1969,"Regular",7,"Away","Hawthorn","Richmond",9
7061,1969-05-24,"R8","Richmond",12,14,86,"Carlton",17,13,115,"M.C.G.",-29,1969,"Regular",8,"Away","Carlton","Richmond",29
7062,1969-05-24,"R8","Sydney",11,8,74,"Collingwood",18,22,130,"Lake Oval",-56,1969,"Regular",8,"Away","Collingwood","Sydney",56
7063,1969-05-24,"R8","Essendon",15,15,105,"Footscray",13,12,90,"Windy Hill",15,1969,"Regular",8,"Home","Essendon","Footscray",15
7064,1969-05-24,"R8","Fitzroy",12,9,81,"Melbourne",15,12,102,"Princes Park",-21,1969,"Regular",8,"Away","Melbourne","Fitzroy",21
7065,1969-05-24,"R8","Hawthorn",13,16,94,"Geelong",13,12,90,"Glenferrie Oval",4,1969,"Regular",8,"Home","Hawthorn","Geelong",4
7066,1969-05-24,"R8","North Melbourne",15,13,103,"St Kilda",13,16,94,"Arden St",9,1969,"Regular",8,"Home","North Melbourne","St Kilda",9
7067,1969-05-31,"R9","Carlton",15,13,103,"Essendon",6,9,45,"Princes Park",58,1969,"Regular",9,"Home","Carlton","Essendon",58
7068,1969-05-31,"R9","Collingwood",17,16,118,"North Melbourne",9,4,58,"Victoria Park",60,1969,"Regular",9,"Home","Collingwood","North Melbourne",60
7069,1969-05-31,"R9","Geelong",15,17,107,"Fitzroy",6,9,45,"Kardinia Park",62,1969,"Regular",9,"Home","Geelong","Fitzroy",62
7070,1969-05-31,"R9","Footscray",8,13,61,"Richmond",7,8,50,"Western Oval",11,1969,"Regular",9,"Home","Footscray","Richmond",11
7071,1969-05-31,"R9","St Kilda",14,11,95,"Hawthorn",7,7,49,"Moorabbin Oval",46,1969,"Regular",9,"Home","St Kilda","Hawthorn",46
7072,1969-05-31,"R9","Melbourne",9,15,69,"Sydney",14,10,94,"M.C.G.",-25,1969,"Regular",9,"Away","Sydney","Melbourne",25
7073,1969-06-07,"R10","Fitzroy",12,9,81,"Hawthorn",16,9,105,"Princes Park",-24,1969,"Regular",10,"Away","Hawthorn","Fitzroy",24
7074,1969-06-07,"R10","Richmond",14,10,94,"St Kilda",11,14,80,"M.C.G.",14,1969,"Regular",10,"Home","Richmond","St Kilda",14
7075,1969-06-14,"R10","Collingwood",14,22,106,"Geelong",8,11,59,"Victoria Park",47,1969,"Regular",10,"Home","Collingwood","Geelong",47
7076,1969-06-14,"R10","Sydney",15,13,103,"Essendon",18,15,123,"Lake Oval",-20,1969,"Regular",10,"Away","Essendon","Sydney",20
7077,1969-06-16,"R10","North Melbourne",7,15,57,"Carlton",10,18,78,"Arden St",-21,1969,"Regular",10,"Away","Carlton","North Melbourne",21
7078,1969-06-16,"R10","Melbourne",17,18,120,"Footscray",12,23,95,"M.C.G.",25,1969,"Regular",10,"Home","Melbourne","Footscray",25
7079,1969-06-21,"R11","Carlton",24,14,158,"Fitzroy",14,14,98,"Princes Park",60,1969,"Regular",11,"Home","Carlton","Fitzroy",60
7080,1969-06-21,"R11","Essendon",13,19,97,"Collingwood",16,12,108,"Windy Hill",-11,1969,"Regular",11,"Away","Collingwood","Essendon",11
7081,1969-06-21,"R11","Footscray",20,23,143,"North Melbourne",15,7,97,"Western Oval",46,1969,"Regular",11,"Home","Footscray","North Melbourne",46
7082,1969-06-21,"R11","Geelong",17,11,113,"Richmond",12,14,86,"Kardinia Park",27,1969,"Regular",11,"Home","Geelong","Richmond",27
7083,1969-06-21,"R11","Hawthorn",25,13,163,"Sydney",14,21,105,"Glenferrie Oval",58,1969,"Regular",11,"Home","Hawthorn","Sydney",58
7084,1969-06-21,"R11","St Kilda",17,18,120,"Melbourne",13,16,94,"Moorabbin Oval",26,1969,"Regular",11,"Home","St Kilda","Melbourne",26
7085,1969-06-28,"R12","Carlton",9,12,66,"St Kilda",7,12,54,"Princes Park",12,1969,"Regular",12,"Home","Carlton","St Kilda",12
7086,1969-06-28,"R12","Collingwood",9,24,78,"Hawthorn",6,11,47,"Victoria Park",31,1969,"Regular",12,"Home","Collingwood","Hawthorn",31
7087,1969-06-28,"R12","Essendon",8,15,63,"Richmond",7,12,54,"Windy Hill",9,1969,"Regular",12,"Home","Essendon","Richmond",9
7088,1969-06-28,"R12","Footscray",17,13,115,"Fitzroy",10,8,68,"Western Oval",47,1969,"Regular",12,"Home","Footscray","Fitzroy",47
7089,1969-06-28,"R12","Melbourne",11,12,78,"Geelong",15,9,99,"M.C.G.",-21,1969,"Regular",12,"Away","Geelong","Melbourne",21
7090,1969-06-28,"R12","Sydney",12,11,83,"North Melbourne",11,14,80,"Lake Oval",3,1969,"Regular",12,"Home","Sydney","North Melbourne",3
7091,1969-07-05,"R13","Hawthorn",11,14,80,"Carlton",22,17,149,"Glenferrie Oval",-69,1969,"Regular",13,"Away","Carlton","Hawthorn",69
7092,1969-07-05,"R13","Richmond",13,15,93,"Collingwood",12,19,91,"M.C.G.",2,1969,"Regular",13,"Home","Richmond","Collingwood",2
7093,1969-07-05,"R13","Geelong",10,14,74,"Essendon",13,16,94,"Kardinia Park",-20,1969,"Regular",13,"Away","Essendon","Geelong",20
7094,1969-07-05,"R13","Fitzroy",18,21,129,"Sydney",11,14,80,"Princes Park",49,1969,"Regular",13,"Home","Fitzroy","Sydney",49
7095,1969-07-05,"R13","St Kilda",12,15,87,"Footscray",12,5,77,"Moorabbin Oval",10,1969,"Regular",13,"Home","St Kilda","Footscray",10
7096,1969-07-05,"R13","North Melbourne",19,16,130,"Melbourne",19,13,127,"Arden St",3,1969,"Regular",13,"Home","North Melbourne","Melbourne",3
7097,1969-07-12,"R14","Carlton",17,12,114,"Footscray",16,16,112,"Princes Park",2,1969,"Regular",14,"Home","Carlton","Footscray",2
7098,1969-07-12,"R14","Melbourne",16,11,107,"Collingwood",15,19,109,"M.C.G.",-2,1969,"Regular",14,"Away","Collingwood","Melbourne",2
7099,1969-07-12,"R14","Hawthorn",17,19,121,"Essendon",16,18,114,"Glenferrie Oval",7,1969,"Regular",14,"Home","Hawthorn","Essendon",7
7100,1969-07-12,"R14","St Kilda",9,4,58,"Fitzroy",11,8,74,"Moorabbin Oval",-16,1969,"Regular",14,"Away","Fitzroy","St Kilda",16
7101,1969-07-12,"R14","Sydney",12,15,87,"Geelong",17,11,113,"Lake Oval",-26,1969,"Regular",14,"Away","Geelong","Sydney",26
7102,1969-07-12,"R14","North Melbourne",6,12,48,"Richmond",17,15,117,"Arden St",-69,1969,"Regular",14,"Away","Richmond","North Melbourne",69
7103,1969-07-19,"R15","Collingwood",15,16,106,"Carlton",17,14,116,"Victoria Park",-10,1969,"Regular",15,"Away","Carlton","Collingwood",10
7104,1969-07-19,"R15","Essendon",13,21,99,"Melbourne",13,16,94,"Windy Hill",5,1969,"Regular",15,"Home","Essendon","Melbourne",5
7105,1969-07-19,"R15","Fitzroy",20,6,126,"North Melbourne",14,12,96,"Princes Park",30,1969,"Regular",15,"Home","Fitzroy","North Melbourne",30
7106,1969-07-19,"R15","Footscray",15,16,106,"Hawthorn",14,9,93,"Western Oval",13,1969,"Regular",15,"Home","Footscray","Hawthorn",13
7107,1969-07-19,"R15","Geelong",13,14,92,"St Kilda",16,8,104,"Kardinia Park",-12,1969,"Regular",15,"Away","St Kilda","Geelong",12
7108,1969-07-19,"R15","Richmond",22,12,144,"Sydney",11,11,77,"M.C.G.",67,1969,"Regular",15,"Home","Richmond","Sydney",67
7109,1969-07-26,"R16","Sydney",11,8,74,"Carlton",19,12,126,"Lake Oval",-52,1969,"Regular",16,"Away","Carlton","Sydney",52
7110,1969-07-26,"R16","North Melbourne",13,16,94,"Essendon",9,13,67,"Arden St",27,1969,"Regular",16,"Home","North Melbourne","Essendon",27
7111,1969-07-26,"R16","Melbourne",13,17,95,"Hawthorn",21,5,131,"M.C.G.",-36,1969,"Regular",16,"Away","Hawthorn","Melbourne",36
7112,1969-08-02,"R16","Collingwood",12,11,83,"St Kilda",10,13,73,"Victoria Park",10,1969,"Regular",16,"Home","Collingwood","St Kilda",10
7113,1969-08-02,"R16","Fitzroy",9,12,66,"Richmond",8,9,57,"Princes Park",9,1969,"Regular",16,"Home","Fitzroy","Richmond",9
7114,1969-08-02,"R16","Geelong",23,17,155,"Footscray",11,12,78,"Kardinia Park",77,1969,"Regular",16,"Home","Geelong","Footscray",77
7115,1969-08-09,"R17","Carlton",14,11,95,"Geelong",17,8,110,"Princes Park",-15,1969,"Regular",17,"Away","Geelong","Carlton",15
7116,1969-08-09,"R17","Footscray",11,16,82,"Collingwood",16,8,104,"Western Oval",-22,1969,"Regular",17,"Away","Collingwood","Footscray",22
7117,1969-08-09,"R17","Essendon",19,18,132,"Fitzroy",14,11,95,"Windy Hill",37,1969,"Regular",17,"Home","Essendon","Fitzroy",37
7118,1969-08-09,"R17","Hawthorn",22,12,144,"North Melbourne",18,18,126,"Glenferrie Oval",18,1969,"Regular",17,"Home","Hawthorn","North Melbourne",18
7119,1969-08-09,"R17","Richmond",19,11,125,"Melbourne",12,13,85,"M.C.G.",40,1969,"Regular",17,"Home","Richmond","Melbourne",40
7120,1969-08-09,"R17","St Kilda",9,14,68,"Sydney",15,10,100,"Moorabbin Oval",-32,1969,"Regular",17,"Away","Sydney","St Kilda",32
7121,1969-08-16,"R18","Melbourne",14,15,99,"Carlton",13,14,92,"M.C.G.",7,1969,"Regular",18,"Home","Melbourne","Carlton",7
7122,1969-08-16,"R18","Fitzroy",9,16,70,"Collingwood",12,18,90,"Princes Park",-20,1969,"Regular",18,"Away","Collingwood","Fitzroy",20
7123,1969-08-16,"R18","Essendon",19,25,139,"St Kilda",11,10,76,"Windy Hill",63,1969,"Regular",18,"Home","Essendon","St Kilda",63
7124,1969-08-16,"R18","Sydney",16,17,113,"Footscray",13,18,96,"Lake Oval",17,1969,"Regular",18,"Home","Sydney","Footscray",17
7125,1969-08-16,"R18","North Melbourne",13,11,89,"Geelong",14,14,98,"Arden St",-9,1969,"Regular",18,"Away","Geelong","North Melbourne",9
7126,1969-08-16,"R18","Hawthorn",13,10,88,"Richmond",13,21,99,"Glenferrie Oval",-11,1969,"Regular",18,"Away","Richmond","Hawthorn",11
7127,1969-08-23,"R19","Carlton",20,7,127,"Richmond",24,12,156,"Princes Park",-29,1969,"Regular",19,"Away","Richmond","Carlton",29
7128,1969-08-23,"R19","Collingwood",19,15,129,"Sydney",6,22,58,"Victoria Park",71,1969,"Regular",19,"Home","Collingwood","Sydney",71
7129,1969-08-23,"R19","Footscray",14,10,94,"Essendon",12,10,82,"Western Oval",12,1969,"Regular",19,"Home","Footscray","Essendon",12
7130,1969-08-23,"R19","Melbourne",14,13,97,"Fitzroy",14,15,99,"M.C.G.",-2,1969,"Regular",19,"Away","Fitzroy","Melbourne",2
7131,1969-08-23,"R19","Geelong",16,14,110,"Hawthorn",14,11,95,"Kardinia Park",15,1969,"Regular",19,"Home","Geelong","Hawthorn",15
7132,1969-08-23,"R19","St Kilda",21,18,144,"North Melbourne",8,10,58,"Moorabbin Oval",86,1969,"Regular",19,"Home","St Kilda","North Melbourne",86
7133,1969-08-30,"R20","Essendon",17,16,118,"Carlton",20,9,129,"Windy Hill",-11,1969,"Regular",20,"Away","Carlton","Essendon",11
7134,1969-08-30,"R20","North Melbourne",13,11,89,"Collingwood",14,12,96,"Arden St",-7,1969,"Regular",20,"Away","Collingwood","North Melbourne",7
7135,1969-08-30,"R20","Fitzroy",13,15,93,"Geelong",9,16,70,"Princes Park",23,1969,"Regular",20,"Home","Fitzroy","Geelong",23
7136,1969-08-30,"R20","Richmond",23,16,154,"Footscray",9,10,64,"M.C.G.",90,1969,"Regular",20,"Home","Richmond","Footscray",90
7137,1969-08-30,"R20","Hawthorn",14,17,101,"St Kilda",13,12,90,"Glenferrie Oval",11,1969,"Regular",20,"Home","Hawthorn","St Kilda",11
7138,1969-08-30,"R20","Sydney",17,18,120,"Melbourne",13,7,85,"Lake Oval",35,1969,"Regular",20,"Home","Sydney","Melbourne",35
7139,1969-09-06,"SF","Geelong",7,7,49,"Richmond",25,17,167,"M.C.G.",-118,1969,"Finals",21,"Away","Richmond","Geelong",118
7140,1969-09-13,"SF","Collingwood",10,11,71,"Carlton",16,11,107,"M.C.G.",-36,1969,"Finals",21,"Away","Carlton","Collingwood",36
7141,1969-09-20,"PF","Collingwood",12,9,81,"Richmond",15,17,107,"M.C.G.",-26,1969,"Finals",22,"Away","Richmond","Collingwood",26
7142,1969-09-27,"GF","Carlton",8,12,60,"Richmond",12,13,85,"M.C.G.",-25,1969,"Finals",23,"Away","Richmond","Carlton",25
7143,1970-04-04,"R1","Carlton",21,19,145,"Essendon",14,12,96,"Princes Park",49,1970,"Regular",1,"Home","Carlton","Essendon",49
7144,1970-04-04,"R1","Footscray",12,12,84,"Collingwood",23,10,148,"Western Oval",-64,1970,"Regular",1,"Away","Collingwood","Footscray",64
7145,1970-04-04,"R1","Hawthorn",19,12,126,"Geelong",21,9,135,"Glenferrie Oval",-9,1970,"Regular",1,"Away","Geelong","Hawthorn",9
7146,1970-04-04,"R1","Sydney",9,14,68,"Melbourne",14,9,93,"Lake Oval",-25,1970,"Regular",1,"Away","Melbourne","Sydney",25
7147,1970-04-04,"R1","St Kilda",14,16,100,"North Melbourne",7,6,48,"Moorabbin Oval",52,1970,"Regular",1,"Home","St Kilda","North Melbourne",52
7148,1970-04-05,"R1","Richmond",14,12,96,"Fitzroy",16,20,116,"M.C.G.",-20,1970,"Regular",1,"Away","Fitzroy","Richmond",20
7149,1970-04-11,"R2","Geelong",12,9,81,"Carlton",16,7,103,"Kardinia Park",-22,1970,"Regular",2,"Away","Carlton","Geelong",22
7150,1970-04-11,"R2","Collingwood",19,19,133,"Richmond",13,16,94,"Victoria Park",39,1970,"Regular",2,"Home","Collingwood","Richmond",39
7151,1970-04-11,"R2","Essendon",10,14,74,"Footscray",14,22,106,"Windy Hill",-32,1970,"Regular",2,"Away","Footscray","Essendon",32
7152,1970-04-11,"R2","Fitzroy",7,9,51,"St Kilda",23,23,161,"Junction Oval",-110,1970,"Regular",2,"Away","St Kilda","Fitzroy",110
7153,1970-04-11,"R2","Melbourne",14,12,96,"Hawthorn",11,19,85,"M.C.G.",11,1970,"Regular",2,"Home","Melbourne","Hawthorn",11
7154,1970-04-11,"R2","North Melbourne",8,11,59,"Sydney",8,12,60,"Arden St",-1,1970,"Regular",2,"Away","Sydney","North Melbourne",1
7155,1970-04-18,"R3","Richmond",17,12,114,"Carlton",15,11,101,"M.C.G.",13,1970,"Regular",3,"Home","Richmond","Carlton",13
7156,1970-04-18,"R3","Collingwood",14,24,108,"Hawthorn",15,11,101,"Victoria Park",7,1970,"Regular",3,"Home","Collingwood","Hawthorn",7
7157,1970-04-18,"R3","Sydney",12,17,89,"Essendon",15,10,100,"Lake Oval",-11,1970,"Regular",3,"Away","Essendon","Sydney",11
7158,1970-04-18,"R3","Fitzroy",7,11,53,"Geelong",17,12,114,"Waverley Park",-61,1970,"Regular",3,"Away","Geelong","Fitzroy",61
7159,1970-04-18,"R3","Footscray",14,23,107,"St Kilda",10,14,74,"Western Oval",33,1970,"Regular",3,"Home","Footscray","St Kilda",33
7160,1970-04-18,"R3","North Melbourne",18,13,121,"Melbourne",8,16,64,"Arden St",57,1970,"Regular",3,"Home","North Melbourne","Melbourne",57
7161,1970-04-25,"R4","Carlton",16,16,112,"North Melbourne",13,15,93,"Princes Park",19,1970,"Regular",4,"Home","Carlton","North Melbourne",19
7162,1970-04-25,"R4","Geelong",14,9,93,"Collingwood",14,17,101,"Kardinia Park",-8,1970,"Regular",4,"Away","Collingwood","Geelong",8
7163,1970-04-25,"R4","Hawthorn",10,10,70,"Essendon",16,14,110,"Glenferrie Oval",-40,1970,"Regular",4,"Away","Essendon","Hawthorn",40
7164,1970-04-25,"R4","Melbourne",17,19,121,"Fitzroy",13,13,91,"M.C.G.",30,1970,"Regular",4,"Home","Melbourne","Fitzroy",30
7165,1970-04-25,"R4","Sydney",11,11,77,"Footscray",9,6,60,"Waverley Park",17,1970,"Regular",4,"Home","Sydney","Footscray",17
7166,1970-04-25,"R4","St Kilda",15,19,109,"Richmond",7,12,54,"Moorabbin Oval",55,1970,"Regular",4,"Home","St Kilda","Richmond",55
7167,1970-05-02,"R5","Footscray",11,13,79,"Hawthorn",11,10,76,"Western Oval",3,1970,"Regular",5,"Home","Footscray","Hawthorn",3
7168,1970-05-02,"R5","St Kilda",8,9,57,"Carlton",12,14,86,"Moorabbin Oval",-29,1970,"Regular",5,"Away","Carlton","St Kilda",29
7169,1970-05-02,"R5","Collingwood",8,17,65,"Melbourne",8,9,57,"Waverley Park",8,1970,"Regular",5,"Home","Collingwood","Melbourne",8
7170,1970-05-02,"R5","Essendon",9,14,68,"Geelong",14,4,88,"Windy Hill",-20,1970,"Regular",5,"Away","Geelong","Essendon",20
7171,1970-05-02,"R5","Fitzroy",5,24,54,"North Melbourne",7,7,49,"Junction Oval",5,1970,"Regular",5,"Home","Fitzroy","North Melbourne",5
7172,1970-05-02,"R5","Richmond",6,13,49,"Sydney",10,11,71,"M.C.G.",-22,1970,"Regular",5,"Away","Sydney","Richmond",22
7173,1970-05-09,"R6","Carlton",23,9,147,"Fitzroy",15,20,110,"Princes Park",37,1970,"Regular",6,"Home","Carlton","Fitzroy",37
7174,1970-05-09,"R6","North Melbourne",10,6,66,"Collingwood",17,30,132,"Arden St",-66,1970,"Regular",6,"Away","Collingwood","North Melbourne",66
7175,1970-05-09,"R6","Melbourne",10,12,72,"Essendon",7,15,57,"M.C.G.",15,1970,"Regular",6,"Home","Melbourne","Essendon",15
7176,1970-05-09,"R6","Geelong",18,15,123,"Footscray",11,11,77,"Kardinia Park",46,1970,"Regular",6,"Home","Geelong","Footscray",46
7177,1970-05-09,"R6","Hawthorn",20,10,130,"Richmond",21,11,137,"Waverley Park",-7,1970,"Regular",6,"Away","Richmond","Hawthorn",7
7178,1970-05-09,"R6","Sydney",9,25,79,"St Kilda",9,8,62,"Lake Oval",17,1970,"Regular",6,"Home","Sydney","St Kilda",17
7179,1970-05-16,"R7","Sydney",23,12,150,"Carlton",10,13,73,"Lake Oval",77,1970,"Regular",7,"Home","Sydney","Carlton",77
7180,1970-05-16,"R7","Collingwood",15,15,105,"Fitzroy",9,18,72,"Victoria Park",33,1970,"Regular",7,"Home","Collingwood","Fitzroy",33
7181,1970-05-16,"R7","Essendon",8,12,60,"North Melbourne",9,22,76,"Waverley Park",-16,1970,"Regular",7,"Away","North Melbourne","Essendon",16
7182,1970-05-16,"R7","Footscray",9,14,68,"Melbourne",7,4,46,"Western Oval",22,1970,"Regular",7,"Home","Footscray","Melbourne",22
7183,1970-05-16,"R7","Richmond",16,20,116,"Geelong",15,2,92,"M.C.G.",24,1970,"Regular",7,"Home","Richmond","Geelong",24
7184,1970-05-16,"R7","St Kilda",10,21,81,"Hawthorn",8,8,56,"Moorabbin Oval",25,1970,"Regular",7,"Home","St Kilda","Hawthorn",25
7185,1970-05-23,"R8","Carlton",12,13,85,"Collingwood",16,12,108,"Waverley Park",-23,1970,"Regular",8,"Away","Collingwood","Carlton",23
7186,1970-05-23,"R8","Fitzroy",9,14,68,"Essendon",11,5,71,"Junction Oval",-3,1970,"Regular",8,"Away","Essendon","Fitzroy",3
7187,1970-05-23,"R8","North Melbourne",9,13,67,"Footscray",13,18,96,"Arden St",-29,1970,"Regular",8,"Away","Footscray","North Melbourne",29
7188,1970-05-23,"R8","Geelong",14,5,89,"St Kilda",12,9,81,"Kardinia Park",8,1970,"Regular",8,"Home","Geelong","St Kilda",8
7189,1970-05-23,"R8","Hawthorn",21,20,146,"Sydney",12,12,84,"Glenferrie Oval",62,1970,"Regular",8,"Home","Hawthorn","Sydney",62
7190,1970-05-23,"R8","Melbourne",15,10,100,"Richmond",18,19,127,"M.C.G.",-27,1970,"Regular",8,"Away","Richmond","Melbourne",27
7191,1970-05-30,"R9","Carlton",10,14,74,"Hawthorn",15,16,106,"Princes Park",-32,1970,"Regular",9,"Away","Hawthorn","Carlton",32
7192,1970-05-30,"R9","Essendon",13,15,93,"Collingwood",11,21,87,"Windy Hill",6,1970,"Regular",9,"Home","Essendon","Collingwood",6
7193,1970-05-30,"R9","Footscray",11,13,79,"Fitzroy",12,9,81,"Waverley Park",-2,1970,"Regular",9,"Away","Fitzroy","Footscray",2
7194,1970-05-30,"R9","Sydney",19,14,128,"Geelong",10,18,78,"Lake Oval",50,1970,"Regular",9,"Home","Sydney","Geelong",50
7195,1970-05-30,"R9","St Kilda",14,12,96,"Melbourne",7,11,53,"Moorabbin Oval",43,1970,"Regular",9,"Home","St Kilda","Melbourne",43
7196,1970-05-30,"R9","Richmond",10,17,77,"North Melbourne",15,7,97,"M.C.G.",-20,1970,"Regular",9,"Away","North Melbourne","Richmond",20
7197,1970-06-06,"R10","Footscray",15,14,104,"Carlton",14,10,94,"Western Oval",10,1970,"Regular",10,"Home","Footscray","Carlton",10
7198,1970-06-06,"R10","Collingwood",14,23,107,"St Kilda",15,10,100,"Victoria Park",7,1970,"Regular",10,"Home","Collingwood","St Kilda",7
7199,1970-06-06,"R10","Essendon",14,13,97,"Richmond",15,14,104,"Windy Hill",-7,1970,"Regular",10,"Away","Richmond","Essendon",7
7200,1970-06-06,"R10","Fitzroy",14,9,93,"Sydney",12,19,91,"Junction Oval",2,1970,"Regular",10,"Home","Fitzroy","Sydney",2
7201,1970-06-06,"R10","Melbourne",10,14,74,"Geelong",13,13,91,"M.C.G.",-17,1970,"Regular",10,"Away","Geelong","Melbourne",17
7202,1970-06-06,"R10","North Melbourne",9,8,62,"Hawthorn",11,9,75,"Waverley Park",-13,1970,"Regular",10,"Away","Hawthorn","North Melbourne",13
7203,1970-06-15,"R11","Carlton",22,15,147,"Melbourne",9,8,62,"Princes Park",85,1970,"Regular",11,"Home","Carlton","Melbourne",85
7204,1970-06-15,"R11","Sydney",16,15,111,"Collingwood",16,14,110,"Lake Oval",1,1970,"Regular",11,"Home","Sydney","Collingwood",1
7205,1970-06-15,"R11","St Kilda",8,21,69,"Essendon",8,9,57,"Waverley Park",12,1970,"Regular",11,"Home","St Kilda","Essendon",12
7206,1970-06-15,"R11","Hawthorn",18,12,120,"Fitzroy",12,8,80,"Glenferrie Oval",40,1970,"Regular",11,"Home","Hawthorn","Fitzroy",40
7207,1970-06-15,"R11","Richmond",22,15,147,"Footscray",13,12,90,"M.C.G.",57,1970,"Regular",11,"Home","Richmond","Footscray",57
7208,1970-06-15,"R11","Geelong",11,17,83,"North Melbourne",9,10,64,"Kardinia Park",19,1970,"Regular",11,"Home","Geelong","North Melbourne",19
7209,1970-06-20,"R12","Essendon",10,16,76,"Carlton",12,9,81,"Windy Hill",-5,1970,"Regular",12,"Away","Carlton","Essendon",5
7210,1970-06-20,"R12","Collingwood",8,16,64,"Footscray",7,9,51,"Victoria Park",13,1970,"Regular",12,"Home","Collingwood","Footscray",13
7211,1970-06-20,"R12","Fitzroy",12,11,83,"Richmond",8,9,57,"Junction Oval",26,1970,"Regular",12,"Home","Fitzroy","Richmond",26
7212,1970-06-20,"R12","Geelong",14,15,99,"Hawthorn",10,11,71,"Kardinia Park",28,1970,"Regular",12,"Home","Geelong","Hawthorn",28
7213,1970-06-20,"R12","Melbourne",12,6,78,"Sydney",12,10,82,"Waverley Park",-4,1970,"Regular",12,"Away","Sydney","Melbourne",4
7214,1970-06-20,"R12","North Melbourne",5,10,40,"St Kilda",11,5,71,"Arden St",-31,1970,"Regular",12,"Away","St Kilda","North Melbourne",31
7215,1970-06-27,"R13","Carlton",12,21,93,"Geelong",11,14,80,"Princes Park",13,1970,"Regular",13,"Home","Carlton","Geelong",13
7216,1970-06-27,"R13","Richmond",11,13,79,"Collingwood",9,13,67,"Waverley Park",12,1970,"Regular",13,"Home","Richmond","Collingwood",12
7217,1970-06-27,"R13","Footscray",11,12,78,"Essendon",9,8,62,"Western Oval",16,1970,"Regular",13,"Home","Footscray","Essendon",16
7218,1970-06-27,"R13","St Kilda",11,14,80,"Fitzroy",8,11,59,"Moorabbin Oval",21,1970,"Regular",13,"Home","St Kilda","Fitzroy",21
7219,1970-06-27,"R13","Hawthorn",16,17,113,"Melbourne",11,8,74,"Glenferrie Oval",39,1970,"Regular",13,"Home","Hawthorn","Melbourne",39
7220,1970-06-27,"R13","Sydney",16,9,105,"North Melbourne",14,12,96,"Lake Oval",9,1970,"Regular",13,"Home","Sydney","North Melbourne",9
7221,1970-07-04,"R14","Carlton",11,12,78,"Richmond",7,7,49,"Princes Park",29,1970,"Regular",14,"Home","Carlton","Richmond",29
7222,1970-07-04,"R14","Hawthorn",18,7,115,"Collingwood",13,13,91,"Glenferrie Oval",24,1970,"Regular",14,"Home","Hawthorn","Collingwood",24
7223,1970-07-04,"R14","Essendon",5,10,40,"Sydney",11,5,71,"Waverley Park",-31,1970,"Regular",14,"Away","Sydney","Essendon",31
7224,1970-07-04,"R14","Geelong",20,8,128,"Fitzroy",13,16,94,"Kardinia Park",34,1970,"Regular",14,"Home","Geelong","Fitzroy",34
7225,1970-07-04,"R14","St Kilda",6,16,52,"Footscray",6,10,46,"Moorabbin Oval",6,1970,"Regular",14,"Home","St Kilda","Footscray",6
7226,1970-07-04,"R14","Melbourne",11,19,85,"North Melbourne",11,11,77,"M.C.G.",8,1970,"Regular",14,"Home","Melbourne","North Melbourne",8
7227,1970-07-11,"R15","North Melbourne",4,7,31,"Carlton",13,21,99,"Waverley Park",-68,1970,"Regular",15,"Away","Carlton","North Melbourne",68
7228,1970-07-11,"R15","Collingwood",13,15,93,"Geelong",8,16,64,"Victoria Park",29,1970,"Regular",15,"Home","Collingwood","Geelong",29
7229,1970-07-11,"R15","Essendon",9,8,62,"Hawthorn",21,4,130,"Windy Hill",-68,1970,"Regular",15,"Away","Hawthorn","Essendon",68
7230,1970-07-11,"R15","Fitzroy",12,18,90,"Melbourne",8,14,62,"Junction Oval",28,1970,"Regular",15,"Home","Fitzroy","Melbourne",28
7231,1970-07-11,"R15","Footscray",6,4,40,"Sydney",13,10,88,"Western Oval",-48,1970,"Regular",15,"Away","Sydney","Footscray",48
7232,1970-07-11,"R15","Richmond",11,15,81,"St Kilda",7,21,63,"M.C.G.",18,1970,"Regular",15,"Home","Richmond","St Kilda",18
7233,1970-07-18,"R16","Carlton",16,14,110,"St Kilda",10,11,71,"Princes Park",39,1970,"Regular",16,"Home","Carlton","St Kilda",39
7234,1970-07-18,"R16","Melbourne",7,19,61,"Collingwood",10,16,76,"M.C.G.",-15,1970,"Regular",16,"Away","Collingwood","Melbourne",15
7235,1970-07-18,"R16","Geelong",15,16,106,"Essendon",8,17,65,"Kardinia Park",41,1970,"Regular",16,"Home","Geelong","Essendon",41
7236,1970-07-18,"R16","North Melbourne",13,17,95,"Fitzroy",18,14,122,"Arden St",-27,1970,"Regular",16,"Away","Fitzroy","North Melbourne",27
7237,1970-07-18,"R16","Hawthorn",23,9,147,"Footscray",6,12,48,"Waverley Park",99,1970,"Regular",16,"Home","Hawthorn","Footscray",99
7238,1970-07-18,"R16","Sydney",11,9,75,"Richmond",12,17,89,"Lake Oval",-14,1970,"Regular",16,"Away","Richmond","Sydney",14
7239,1970-07-25,"R17","Fitzroy",9,7,61,"Carlton",10,11,71,"Waverley Park",-10,1970,"Regular",17,"Away","Carlton","Fitzroy",10
7240,1970-07-25,"R17","Collingwood",14,21,105,"North Melbourne",8,8,56,"Victoria Park",49,1970,"Regular",17,"Home","Collingwood","North Melbourne",49
7241,1970-07-25,"R17","Essendon",18,17,125,"Melbourne",12,17,89,"Windy Hill",36,1970,"Regular",17,"Home","Essendon","Melbourne",36
7242,1970-07-25,"R17","Footscray",12,15,87,"Geelong",7,14,56,"Western Oval",31,1970,"Regular",17,"Home","Footscray","Geelong",31
7243,1970-07-25,"R17","Richmond",15,15,105,"Hawthorn",11,17,83,"M.C.G.",22,1970,"Regular",17,"Home","Richmond","Hawthorn",22
7244,1970-07-25,"R17","St Kilda",13,14,92,"Sydney",11,6,72,"Moorabbin Oval",20,1970,"Regular",17,"Home","St Kilda","Sydney",20
7245,1970-08-01,"R18","Carlton",11,17,83,"Sydney",10,19,79,"Princes Park",4,1970,"Regular",18,"Home","Carlton","Sydney",4
7246,1970-08-01,"R18","Fitzroy",11,9,75,"Collingwood",17,15,117,"Junction Oval",-42,1970,"Regular",18,"Away","Collingwood","Fitzroy",42
7247,1970-08-01,"R18","North Melbourne",13,13,91,"Essendon",16,22,118,"Arden St",-27,1970,"Regular",18,"Away","Essendon","North Melbourne",27
7248,1970-08-01,"R18","Melbourne",8,13,61,"Footscray",10,15,75,"M.C.G.",-14,1970,"Regular",18,"Away","Footscray","Melbourne",14
7249,1970-08-01,"R18","Geelong",13,10,88,"Richmond",8,13,61,"Waverley Park",27,1970,"Regular",18,"Home","Geelong","Richmond",27
7250,1970-08-01,"R18","Hawthorn",11,11,77,"St Kilda",14,18,102,"Glenferrie Oval",-25,1970,"Regular",18,"Away","St Kilda","Hawthorn",25
7251,1970-08-08,"R19","Collingwood",13,23,101,"Carlton",2,12,24,"Victoria Park",77,1970,"Regular",19,"Home","Collingwood","Carlton",77
7252,1970-08-08,"R19","Essendon",12,16,88,"Fitzroy",14,10,94,"Windy Hill",-6,1970,"Regular",19,"Away","Fitzroy","Essendon",6
7253,1970-08-08,"R19","Footscray",10,23,83,"North Melbourne",11,15,81,"Western Oval",2,1970,"Regular",19,"Home","Footscray","North Melbourne",2
7254,1970-08-08,"R19","St Kilda",12,16,88,"Geelong",5,7,37,"Waverley Park",51,1970,"Regular",19,"Home","St Kilda","Geelong",51
7255,1970-08-08,"R19","Sydney",16,7,103,"Hawthorn",13,8,86,"Lake Oval",17,1970,"Regular",19,"Home","Sydney","Hawthorn",17
7256,1970-08-08,"R19","Richmond",9,10,64,"Melbourne",18,10,118,"M.C.G.",-54,1970,"Regular",19,"Away","Melbourne","Richmond",54
7257,1970-08-15,"R20","Hawthorn",13,9,87,"Carlton",18,9,117,"Glenferrie Oval",-30,1970,"Regular",20,"Away","Carlton","Hawthorn",30
7258,1970-08-15,"R20","Collingwood",24,16,160,"Essendon",11,13,79,"Victoria Park",81,1970,"Regular",20,"Home","Collingwood","Essendon",81
7259,1970-08-15,"R20","Fitzroy",12,10,82,"Footscray",11,14,80,"Junction Oval",2,1970,"Regular",20,"Home","Fitzroy","Footscray",2
7260,1970-08-15,"R20","Geelong",10,14,74,"Sydney",11,15,81,"Kardinia Park",-7,1970,"Regular",20,"Away","Sydney","Geelong",7
7261,1970-08-15,"R20","Melbourne",7,14,56,"St Kilda",17,14,116,"Waverley Park",-60,1970,"Regular",20,"Away","St Kilda","Melbourne",60
7262,1970-08-15,"R20","North Melbourne",7,6,48,"Richmond",16,10,106,"Arden St",-58,1970,"Regular",20,"Away","Richmond","North Melbourne",58
7263,1970-08-22,"R21","Carlton",18,14,122,"Footscray",17,6,108,"Princes Park",14,1970,"Regular",21,"Home","Carlton","Footscray",14
7264,1970-08-22,"R21","St Kilda",14,14,98,"Collingwood",16,12,108,"Moorabbin Oval",-10,1970,"Regular",21,"Away","Collingwood","St Kilda",10
7265,1970-08-22,"R21","Richmond",23,13,151,"Essendon",11,11,77,"M.C.G.",74,1970,"Regular",21,"Home","Richmond","Essendon",74
7266,1970-08-22,"R21","Sydney",14,15,99,"Fitzroy",10,20,80,"Lake Oval",19,1970,"Regular",21,"Home","Sydney","Fitzroy",19
7267,1970-08-22,"R21","Geelong",16,12,108,"Melbourne",13,18,96,"Kardinia Park",12,1970,"Regular",21,"Home","Geelong","Melbourne",12
7268,1970-08-22,"R21","Hawthorn",21,14,140,"North Melbourne",9,20,74,"Glenferrie Oval",66,1970,"Regular",21,"Home","Hawthorn","North Melbourne",66
7269,1970-08-29,"R22","Melbourne",12,15,87,"Carlton",14,17,101,"M.C.G.",-14,1970,"Regular",22,"Away","Carlton","Melbourne",14
7270,1970-08-29,"R22","Collingwood",22,15,147,"Sydney",7,9,51,"Victoria Park",96,1970,"Regular",22,"Home","Collingwood","Sydney",96
7271,1970-08-29,"R22","Essendon",8,11,59,"St Kilda",14,19,103,"Windy Hill",-44,1970,"Regular",22,"Away","St Kilda","Essendon",44
7272,1970-08-29,"R22","Fitzroy",9,11,65,"Hawthorn",18,16,124,"Junction Oval",-59,1970,"Regular",22,"Away","Hawthorn","Fitzroy",59
7273,1970-08-29,"R22","Footscray",12,10,82,"Richmond",10,12,72,"Western Oval",10,1970,"Regular",22,"Home","Footscray","Richmond",10
7274,1970-08-29,"R22","North Melbourne",12,11,83,"Geelong",6,6,42,"Arden St",41,1970,"Regular",22,"Home","North Melbourne","Geelong",41
7275,1970-09-05,"SF","St Kilda",22,11,143,"Sydney",13,12,90,"M.C.G.",53,1970,"Finals",23,"Home","St Kilda","Sydney",53
7276,1970-09-12,"SF","Collingwood",17,16,118,"Carlton",17,6,108,"M.C.G.",10,1970,"Finals",23,"Home","Collingwood","Carlton",10
7277,1970-09-19,"PF","Carlton",17,21,123,"St Kilda",7,19,61,"M.C.G.",62,1970,"Finals",24,"Home","Carlton","St Kilda",62
7278,1970-09-26,"GF","Collingwood",14,17,101,"Carlton",17,9,111,"M.C.G.",-10,1970,"Finals",25,"Away","Carlton","Collingwood",10
7279,1971-04-03,"R1","North Melbourne",18,16,124,"Carlton",14,14,98,"Arden St",26,1971,"Regular",1,"Home","North Melbourne","Carlton",26
7280,1971-04-03,"R1","Collingwood",25,10,160,"Footscray",11,11,77,"Victoria Park",83,1971,"Regular",1,"Home","Collingwood","Footscray",83
7281,1971-04-03,"R1","Essendon",10,12,72,"Hawthorn",13,18,96,"Windy Hill",-24,1971,"Regular",1,"Away","Hawthorn","Essendon",24
7282,1971-04-03,"R1","Fitzroy",14,15,99,"Richmond",22,18,150,"Junction Oval",-51,1971,"Regular",1,"Away","Richmond","Fitzroy",51
7283,1971-04-03,"R1","Geelong",8,9,57,"St Kilda",21,25,151,"Kardinia Park",-94,1971,"Regular",1,"Away","St Kilda","Geelong",94
7284,1971-04-03,"R1","Melbourne",24,21,165,"Sydney",7,18,60,"M.C.G.",105,1971,"Regular",1,"Home","Melbourne","Sydney",105
7285,1971-04-10,"R2","Carlton",20,9,129,"Essendon",9,15,69,"Princes Park",60,1971,"Regular",2,"Home","Carlton","Essendon",60
7286,1971-04-10,"R2","Hawthorn",14,13,97,"Fitzroy",7,11,53,"Glenferrie Oval",44,1971,"Regular",2,"Home","Hawthorn","Fitzroy",44
7287,1971-04-10,"R2","Sydney",12,20,92,"Geelong",16,14,110,"Lake Oval",-18,1971,"Regular",2,"Away","Geelong","Sydney",18
7288,1971-04-12,"R2","Richmond",10,9,69,"Collingwood",16,10,106,"M.C.G.",-37,1971,"Regular",2,"Away","Collingwood","Richmond",37
7289,1971-04-12,"R2","Footscray",8,15,63,"Melbourne",16,11,107,"Western Oval",-44,1971,"Regular",2,"Away","Melbourne","Footscray",44
7290,1971-04-12,"R2","St Kilda",16,12,108,"North Melbourne",12,8,80,"Moorabbin Oval",28,1971,"Regular",2,"Home","St Kilda","North Melbourne",28
7291,1971-04-17,"R3","Melbourne",19,13,127,"Carlton",15,10,100,"M.C.G.",27,1971,"Regular",3,"Home","Melbourne","Carlton",27
7292,1971-04-17,"R3","Essendon",9,12,66,"Collingwood",9,12,66,"Windy Hill",0,1971,"Regular",3,"Home","Essendon","Collingwood",0
7293,1971-04-17,"R3","Fitzroy",17,26,128,"North Melbourne",14,10,94,"Junction Oval",34,1971,"Regular",3,"Home","Fitzroy","North Melbourne",34
7294,1971-04-17,"R3","Footscray",14,15,99,"Sydney",14,9,93,"Western Oval",6,1971,"Regular",3,"Home","Footscray","Sydney",6
7295,1971-04-17,"R3","Hawthorn",16,19,115,"Geelong",16,11,107,"Glenferrie Oval",8,1971,"Regular",3,"Home","Hawthorn","Geelong",8
7296,1971-04-17,"R3","Richmond",10,8,68,"St Kilda",6,13,49,"Waverley Park",19,1971,"Regular",3,"Home","Richmond","St Kilda",19
7297,1971-04-24,"R4","Geelong",13,8,86,"Carlton",13,21,99,"Kardinia Park",-13,1971,"Regular",4,"Away","Carlton","Geelong",13
7298,1971-04-24,"R4","Collingwood",19,20,134,"Fitzroy",12,9,81,"Victoria Park",53,1971,"Regular",4,"Home","Collingwood","Fitzroy",53
7299,1971-04-24,"R4","Melbourne",10,18,78,"Essendon",6,7,43,"Waverley Park",35,1971,"Regular",4,"Home","Melbourne","Essendon",35
7300,1971-04-24,"R4","North Melbourne",14,15,99,"Footscray",13,14,92,"Arden St",7,1971,"Regular",4,"Home","North Melbourne","Footscray",7
7301,1971-04-24,"R4","St Kilda",10,9,69,"Hawthorn",18,19,127,"Moorabbin Oval",-58,1971,"Regular",4,"Away","Hawthorn","St Kilda",58
7302,1971-04-24,"R4","Sydney",5,9,39,"Richmond",20,13,133,"Lake Oval",-94,1971,"Regular",4,"Away","Richmond","Sydney",94
7303,1971-05-01,"R5","Carlton",13,18,96,"St Kilda",11,17,83,"Princes Park",13,1971,"Regular",5,"Home","Carlton","St Kilda",13
7304,1971-05-01,"R5","Collingwood",16,15,111,"North Melbourne",10,11,71,"Victoria Park",40,1971,"Regular",5,"Home","Collingwood","North Melbourne",40
7305,1971-05-01,"R5","Essendon",21,15,141,"Geelong",16,12,108,"Windy Hill",33,1971,"Regular",5,"Home","Essendon","Geelong",33
7306,1971-05-01,"R5","Fitzroy",14,8,92,"Melbourne",17,18,120,"Junction Oval",-28,1971,"Regular",5,"Away","Melbourne","Fitzroy",28
7307,1971-05-01,"R5","Richmond",14,17,101,"Footscray",17,19,121,"M.C.G.",-20,1971,"Regular",5,"Away","Footscray","Richmond",20
7308,1971-05-01,"R5","Hawthorn",12,21,93,"Sydney",6,9,45,"Waverley Park",48,1971,"Regular",5,"Home","Hawthorn","Sydney",48
7309,1971-05-08,"R6","Sydney",13,14,92,"Carlton",14,10,94,"Lake Oval",-2,1971,"Regular",6,"Away","Carlton","Sydney",2
7310,1971-05-08,"R6","Melbourne",10,12,72,"Collingwood",18,19,127,"M.C.G.",-55,1971,"Regular",6,"Away","Collingwood","Melbourne",55
7311,1971-05-08,"R6","St Kilda",14,25,109,"Essendon",9,11,65,"Moorabbin Oval",44,1971,"Regular",6,"Home","St Kilda","Essendon",44
7312,1971-05-08,"R6","Geelong",13,13,91,"Fitzroy",20,16,136,"Waverley Park",-45,1971,"Regular",6,"Away","Fitzroy","Geelong",45
7313,1971-05-08,"R6","Footscray",18,5,113,"Hawthorn",16,11,107,"Western Oval",6,1971,"Regular",6,"Home","Footscray","Hawthorn",6
7314,1971-05-08,"R6","North Melbourne",12,12,84,"Richmond",22,14,146,"Arden St",-62,1971,"Regular",6,"Away","Richmond","North Melbourne",62
7315,1971-05-15,"R7","Carlton",12,19,91,"Footscray",11,13,79,"Waverley Park",12,1971,"Regular",7,"Home","Carlton","Footscray",12
7316,1971-05-15,"R7","Collingwood",15,16,106,"Geelong",14,8,92,"Victoria Park",14,1971,"Regular",7,"Home","Collingwood","Geelong",14
7317,1971-05-15,"R7","Essendon",12,17,89,"Sydney",16,9,105,"Windy Hill",-16,1971,"Regular",7,"Away","Sydney","Essendon",16
7318,1971-05-15,"R7","Fitzroy",11,16,82,"St Kilda",13,14,92,"Junction Oval",-10,1971,"Regular",7,"Away","St Kilda","Fitzroy",10
7319,1971-05-15,"R7","Hawthorn",21,19,145,"Richmond",12,6,78,"Glenferrie Oval",67,1971,"Regular",7,"Home","Hawthorn","Richmond",67
7320,1971-05-15,"R7","Melbourne",22,17,149,"North Melbourne",15,14,104,"M.C.G.",45,1971,"Regular",7,"Home","Melbourne","North Melbourne",45
7321,1971-05-22,"R8","Richmond",16,26,122,"Carlton",9,16,70,"M.C.G.",52,1971,"Regular",8,"Home","Richmond","Carlton",52
7322,1971-05-22,"R8","St Kilda",20,15,135,"Collingwood",13,10,88,"Moorabbin Oval",47,1971,"Regular",8,"Home","St Kilda","Collingwood",47
7323,1971-05-22,"R8","Footscray",17,17,119,"Essendon",12,7,79,"Western Oval",40,1971,"Regular",8,"Home","Footscray","Essendon",40
7324,1971-05-22,"R8","Sydney",13,11,89,"Fitzroy",19,19,133,"Lake Oval",-44,1971,"Regular",8,"Away","Fitzroy","Sydney",44
7325,1971-05-22,"R8","Geelong",10,12,72,"Melbourne",14,22,106,"Kardinia Park",-34,1971,"Regular",8,"Away","Melbourne","Geelong",34
7326,1971-05-22,"R8","North Melbourne",7,10,52,"Hawthorn",22,15,147,"Waverley Park",-95,1971,"Regular",8,"Away","Hawthorn","North Melbourne",95
7327,1971-05-29,"R9","Carlton",4,12,36,"Hawthorn",14,12,96,"Princes Park",-60,1971,"Regular",9,"Away","Hawthorn","Carlton",60
7328,1971-05-29,"R9","Collingwood",15,10,100,"Sydney",10,6,66,"Victoria Park",34,1971,"Regular",9,"Home","Collingwood","Sydney",34
7329,1971-05-29,"R9","Essendon",13,11,89,"Richmond",17,11,113,"Waverley Park",-24,1971,"Regular",9,"Away","Richmond","Essendon",24
7330,1971-05-29,"R9","Fitzroy",17,17,119,"Footscray",10,18,78,"Junction Oval",41,1971,"Regular",9,"Home","Fitzroy","Footscray",41
7331,1971-05-29,"R9","North Melbourne",16,28,124,"Geelong",16,13,109,"Arden St",15,1971,"Regular",9,"Home","North Melbourne","Geelong",15
7332,1971-05-29,"R9","Melbourne",10,10,70,"St Kilda",10,7,67,"M.C.G.",3,1971,"Regular",9,"Home","Melbourne","St Kilda",3
7333,1971-06-05,"R10","Carlton",13,12,90,"Fitzroy",10,15,75,"Princes Park",15,1971,"Regular",10,"Home","Carlton","Fitzroy",15
7334,1971-06-05,"R10","Hawthorn",15,17,107,"Collingwood",7,13,55,"Glenferrie Oval",52,1971,"Regular",10,"Home","Hawthorn","Collingwood",52
7335,1971-06-05,"R10","Essendon",13,18,96,"North Melbourne",8,15,63,"Windy Hill",33,1971,"Regular",10,"Home","Essendon","North Melbourne",33
7336,1971-06-05,"R10","Footscray",19,10,124,"Geelong",18,14,122,"Waverley Park",2,1971,"Regular",10,"Home","Footscray","Geelong",2
7337,1971-06-05,"R10","Richmond",15,16,106,"Melbourne",11,9,75,"M.C.G.",31,1971,"Regular",10,"Home","Richmond","Melbourne",31
7338,1971-06-05,"R10","Sydney",9,6,60,"St Kilda",18,23,131,"Lake Oval",-71,1971,"Regular",10,"Away","St Kilda","Sydney",71
7339,1971-06-14,"R11","Collingwood",24,14,158,"Carlton",11,7,73,"Waverley Park",85,1971,"Regular",11,"Home","Collingwood","Carlton",85
7340,1971-06-14,"R11","Fitzroy",17,13,115,"Essendon",8,9,57,"Junction Oval",58,1971,"Regular",11,"Home","Fitzroy","Essendon",58
7341,1971-06-14,"R11","St Kilda",17,16,118,"Footscray",9,5,59,"Moorabbin Oval",59,1971,"Regular",11,"Home","St Kilda","Footscray",59
7342,1971-06-14,"R11","Geelong",12,11,83,"Richmond",20,13,133,"Kardinia Park",-50,1971,"Regular",11,"Away","Richmond","Geelong",50
7343,1971-06-14,"R11","Melbourne",10,14,74,"Hawthorn",14,10,94,"M.C.G.",-20,1971,"Regular",11,"Away","Hawthorn","Melbourne",20
7344,1971-06-14,"R11","North Melbourne",12,17,89,"Sydney",13,20,98,"Arden St",-9,1971,"Regular",11,"Away","Sydney","North Melbourne",9
7345,1971-06-19,"R12","Carlton",16,18,114,"North Melbourne",3,5,23,"Princes Park",91,1971,"Regular",12,"Home","Carlton","North Melbourne",91
7346,1971-06-19,"R12","Footscray",8,15,63,"Collingwood",6,10,46,"Western Oval",17,1971,"Regular",12,"Home","Footscray","Collingwood",17
7347,1971-06-19,"R12","Hawthorn",14,20,104,"Essendon",11,5,71,"Glenferrie Oval",33,1971,"Regular",12,"Home","Hawthorn","Essendon",33
7348,1971-06-19,"R12","Richmond",6,11,47,"Fitzroy",8,17,65,"M.C.G.",-18,1971,"Regular",12,"Away","Fitzroy","Richmond",18
7349,1971-06-19,"R12","St Kilda",14,15,99,"Geelong",3,3,21,"Moorabbin Oval",78,1971,"Regular",12,"Home","St Kilda","Geelong",78
7350,1971-06-19,"R12","Sydney",2,6,18,"Melbourne",6,13,49,"Waverley Park",-31,1971,"Regular",12,"Away","Melbourne","Sydney",31
7351,1971-06-26,"R13","Essendon",13,6,84,"Carlton",14,14,98,"Windy Hill",-14,1971,"Regular",13,"Away","Carlton","Essendon",14
7352,1971-06-26,"R13","Collingwood",18,16,124,"Richmond",12,12,84,"Victoria Park",40,1971,"Regular",13,"Home","Collingwood","Richmond",40
7353,1971-06-26,"R13","Fitzroy",7,16,58,"Hawthorn",14,9,93,"Waverley Park",-35,1971,"Regular",13,"Away","Hawthorn","Fitzroy",35
7354,1971-06-26,"R13","Melbourne",11,13,79,"Footscray",12,8,80,"M.C.G.",-1,1971,"Regular",13,"Away","Footscray","Melbourne",1
7355,1971-06-26,"R13","Geelong",13,9,87,"Sydney",9,12,66,"Kardinia Park",21,1971,"Regular",13,"Home","Geelong","Sydney",21
7356,1971-06-26,"R13","North Melbourne",6,16,52,"St Kilda",16,15,111,"Arden St",-59,1971,"Regular",13,"Away","St Kilda","North Melbourne",59
7357,1971-07-03,"R14","Carlton",12,16,88,"Melbourne",11,6,72,"Waverley Park",16,1971,"Regular",14,"Home","Carlton","Melbourne",16
7358,1971-07-03,"R14","Collingwood",30,20,200,"Essendon",7,11,53,"Victoria Park",147,1971,"Regular",14,"Home","Collingwood","Essendon",147
7359,1971-07-03,"R14","North Melbourne",13,11,89,"Fitzroy",11,16,82,"Arden St",7,1971,"Regular",14,"Home","North Melbourne","Fitzroy",7
7360,1971-07-03,"R14","Sydney",18,15,123,"Footscray",19,11,125,"Lake Oval",-2,1971,"Regular",14,"Away","Footscray","Sydney",2
7361,1971-07-03,"R14","Geelong",13,6,84,"Hawthorn",15,13,103,"Kardinia Park",-19,1971,"Regular",14,"Away","Hawthorn","Geelong",19
7362,1971-07-03,"R14","St Kilda",13,9,87,"Richmond",13,12,90,"Moorabbin Oval",-3,1971,"Regular",14,"Away","Richmond","St Kilda",3
7363,1971-07-10,"R15","Carlton",21,15,141,"Geelong",15,14,104,"Princes Park",37,1971,"Regular",15,"Home","Carlton","Geelong",37
7364,1971-07-10,"R15","Fitzroy",11,18,84,"Collingwood",16,6,102,"Junction Oval",-18,1971,"Regular",15,"Away","Collingwood","Fitzroy",18
7365,1971-07-10,"R15","Essendon",11,12,78,"Melbourne",12,17,89,"Windy Hill",-11,1971,"Regular",15,"Away","Melbourne","Essendon",11
7366,1971-07-10,"R15","Footscray",22,31,163,"North Melbourne",11,5,71,"Waverley Park",92,1971,"Regular",15,"Home","Footscray","North Melbourne",92
7367,1971-07-10,"R15","Hawthorn",20,5,125,"St Kilda",15,12,102,"Glenferrie Oval",23,1971,"Regular",15,"Home","Hawthorn","St Kilda",23
7368,1971-07-10,"R15","Richmond",12,18,90,"Sydney",11,13,79,"M.C.G.",11,1971,"Regular",15,"Home","Richmond","Sydney",11
7369,1971-07-17,"R16","St Kilda",13,19,97,"Carlton",8,6,54,"Moorabbin Oval",43,1971,"Regular",16,"Home","St Kilda","Carlton",43
7370,1971-07-17,"R16","North Melbourne",6,9,45,"Collingwood",8,12,60,"Arden St",-15,1971,"Regular",16,"Away","Collingwood","North Melbourne",15
7371,1971-07-17,"R16","Geelong",13,7,85,"Essendon",16,18,114,"Waverley Park",-29,1971,"Regular",16,"Away","Essendon","Geelong",29
7372,1971-07-17,"R16","Melbourne",4,10,34,"Fitzroy",7,7,49,"M.C.G.",-15,1971,"Regular",16,"Away","Fitzroy","Melbourne",15
7373,1971-07-17,"R16","Footscray",13,8,86,"Richmond",6,15,51,"Western Oval",35,1971,"Regular",16,"Home","Footscray","Richmond",35
7374,1971-07-17,"R16","Sydney",3,15,33,"Hawthorn",11,16,82,"Lake Oval",-49,1971,"Regular",16,"Away","Hawthorn","Sydney",49
7375,1971-07-24,"R17","Carlton",24,16,160,"Sydney",11,7,73,"Princes Park",87,1971,"Regular",17,"Home","Carlton","Sydney",87
7376,1971-07-24,"R17","Collingwood",12,12,84,"Melbourne",11,12,78,"Victoria Park",6,1971,"Regular",17,"Home","Collingwood","Melbourne",6
7377,1971-07-24,"R17","Essendon",7,8,50,"St Kilda",14,15,99,"Windy Hill",-49,1971,"Regular",17,"Away","St Kilda","Essendon",49
7378,1971-07-24,"R17","Fitzroy",20,19,139,"Geelong",11,10,76,"Junction Oval",63,1971,"Regular",17,"Home","Fitzroy","Geelong",63
7379,1971-07-24,"R17","Hawthorn",23,16,154,"Footscray",4,15,39,"Glenferrie Oval",115,1971,"Regular",17,"Home","Hawthorn","Footscray",115
7380,1971-07-24,"R17","Richmond",25,19,169,"North Melbourne",12,7,79,"Waverley Park",90,1971,"Regular",17,"Home","Richmond","North Melbourne",90
7381,1971-07-31,"R18","Footscray",11,10,76,"Carlton",15,16,106,"Western Oval",-30,1971,"Regular",18,"Away","Carlton","Footscray",30
7382,1971-07-31,"R18","Geelong",21,11,137,"Collingwood",19,14,128,"Kardinia Park",9,1971,"Regular",18,"Home","Geelong","Collingwood",9
7383,1971-07-31,"R18","Sydney",13,8,86,"Essendon",13,18,96,"Lake Oval",-10,1971,"Regular",18,"Away","Essendon","Sydney",10
7384,1971-07-31,"R18","St Kilda",13,5,83,"Fitzroy",9,10,64,"Waverley Park",19,1971,"Regular",18,"Home","St Kilda","Fitzroy",19
7385,1971-07-31,"R18","Richmond",16,12,108,"Hawthorn",11,10,76,"M.C.G.",32,1971,"Regular",18,"Home","Richmond","Hawthorn",32
7386,1971-07-31,"R18","North Melbourne",8,14,62,"Melbourne",9,8,62,"Arden St",0,1971,"Regular",18,"Home","North Melbourne","Melbourne",0
7387,1971-08-07,"R19","Carlton",8,10,58,"Richmond",14,17,101,"Princes Park",-43,1971,"Regular",19,"Away","Richmond","Carlton",43
7388,1971-08-07,"R19","Collingwood",8,10,58,"St Kilda",12,7,79,"Waverley Park",-21,1971,"Regular",19,"Away","St Kilda","Collingwood",21
7389,1971-08-07,"R19","Essendon",7,23,65,"Footscray",9,12,66,"Windy Hill",-1,1971,"Regular",19,"Away","Footscray","Essendon",1
7390,1971-08-07,"R19","Fitzroy",11,17,83,"Sydney",8,10,58,"Junction Oval",25,1971,"Regular",19,"Home","Fitzroy","Sydney",25
7391,1971-08-07,"R19","Melbourne",18,17,125,"Geelong",9,8,62,"M.C.G.",63,1971,"Regular",19,"Home","Melbourne","Geelong",63
7392,1971-08-07,"R19","Hawthorn",23,16,154,"North Melbourne",9,8,62,"Glenferrie Oval",92,1971,"Regular",19,"Home","Hawthorn","North Melbourne",92
7393,1971-08-14,"R20","Hawthorn",11,15,81,"Carlton",19,6,120,"Glenferrie Oval",-39,1971,"Regular",20,"Away","Carlton","Hawthorn",39
7394,1971-08-14,"R20","Sydney",9,8,62,"Collingwood",18,18,126,"Waverley Park",-64,1971,"Regular",20,"Away","Collingwood","Sydney",64
7395,1971-08-14,"R20","Richmond",18,18,126,"Essendon",10,12,72,"M.C.G.",54,1971,"Regular",20,"Home","Richmond","Essendon",54
7396,1971-08-14,"R20","Footscray",11,9,75,"Fitzroy",15,20,110,"Western Oval",-35,1971,"Regular",20,"Away","Fitzroy","Footscray",35
7397,1971-08-14,"R20","Geelong",24,7,151,"North Melbourne",11,10,76,"Kardinia Park",75,1971,"Regular",20,"Home","Geelong","North Melbourne",75
7398,1971-08-14,"R20","St Kilda",14,11,95,"Melbourne",9,10,64,"Moorabbin Oval",31,1971,"Regular",20,"Home","St Kilda","Melbourne",31
7399,1971-08-21,"R21","Collingwood",15,15,105,"Hawthorn",20,20,140,"Victoria Park",-35,1971,"Regular",21,"Away","Hawthorn","Collingwood",35
7400,1971-08-21,"R21","North Melbourne",15,13,103,"Essendon",10,12,72,"Arden St",31,1971,"Regular",21,"Home","North Melbourne","Essendon",31
7401,1971-08-21,"R21","Geelong",18,18,126,"Footscray",15,5,95,"Kardinia Park",31,1971,"Regular",21,"Home","Geelong","Footscray",31
7402,1971-08-21,"R21","Melbourne",15,12,102,"Richmond",19,9,123,"M.C.G.",-21,1971,"Regular",21,"Away","Richmond","Melbourne",21
7403,1971-08-21,"R21","St Kilda",18,14,122,"Sydney",6,14,50,"Moorabbin Oval",72,1971,"Regular",21,"Home","St Kilda","Sydney",72
7404,1971-08-21,"R21","Fitzroy",15,15,105,"Carlton",11,16,82,"Junction Oval",23,1971,"Regular",21,"Home","Fitzroy","Carlton",23
7405,1971-08-28,"R22","Carlton",16,10,106,"Collingwood",13,9,87,"Princes Park",19,1971,"Regular",22,"Home","Carlton","Collingwood",19
7406,1971-08-28,"R22","Essendon",12,12,84,"Fitzroy",13,17,95,"Windy Hill",-11,1971,"Regular",22,"Away","Fitzroy","Essendon",11
7407,1971-08-28,"R22","Footscray",10,14,74,"St Kilda",12,18,90,"Western Oval",-16,1971,"Regular",22,"Away","St Kilda","Footscray",16
7408,1971-08-28,"R22","Richmond",16,14,110,"Geelong",14,18,102,"M.C.G.",8,1971,"Regular",22,"Home","Richmond","Geelong",8
7409,1971-08-28,"R22","Hawthorn",18,16,124,"Melbourne",8,17,65,"Glenferrie Oval",59,1971,"Regular",22,"Home","Hawthorn","Melbourne",59
7410,1971-08-28,"R22","Sydney",19,17,131,"North Melbourne",8,11,59,"Lake Oval",72,1971,"Regular",22,"Home","Sydney","North Melbourne",72
7411,1971-09-04,"SF","Richmond",18,13,121,"Collingwood",11,11,77,"M.C.G.",44,1971,"Finals",23,"Home","Richmond","Collingwood",44
7412,1971-09-11,"SF","Hawthorn",12,18,90,"St Kilda",12,16,88,"M.C.G.",2,1971,"Finals",23,"Home","Hawthorn","St Kilda",2
7413,1971-09-18,"PF","St Kilda",16,12,108,"Richmond",12,6,78,"M.C.G.",30,1971,"Finals",24,"Home","St Kilda","Richmond",30
7414,1971-09-25,"GF","Hawthorn",12,10,82,"St Kilda",11,9,75,"M.C.G.",7,1971,"Finals",25,"Home","Hawthorn","St Kilda",7
7415,1972-04-01,"R1","Carlton",11,15,81,"Fitzroy",10,10,70,"Princes Park",11,1972,"Regular",1,"Home","Carlton","Fitzroy",11
7416,1972-04-01,"R1","Hawthorn",15,14,104,"Melbourne",10,15,75,"Glenferrie Oval",29,1972,"Regular",1,"Home","Hawthorn","Melbourne",29
7417,1972-04-01,"R1","St Kilda",20,14,134,"North Melbourne",11,10,76,"Moorabbin Oval",58,1972,"Regular",1,"Home","St Kilda","North Melbourne",58
7418,1972-04-03,"R1","Richmond",16,9,105,"Collingwood",14,17,101,"M.C.G.",4,1972,"Regular",1,"Home","Richmond","Collingwood",4
7419,1972-04-03,"R1","Footscray",9,13,67,"Essendon",18,20,128,"Western Oval",-61,1972,"Regular",1,"Away","Essendon","Footscray",61
7420,1972-04-03,"R1","Sydney",10,13,73,"Geelong",9,7,61,"Lake Oval",12,1972,"Regular",1,"Home","Sydney","Geelong",12
7421,1972-04-08,"R2","Collingwood",10,15,75,"Carlton",11,9,75,"Victoria Park",0,1972,"Regular",2,"Home","Collingwood","Carlton",0
7422,1972-04-08,"R2","Essendon",16,11,107,"Sydney",7,18,60,"Windy Hill",47,1972,"Regular",2,"Home","Essendon","Sydney",47
7423,1972-04-08,"R2","Fitzroy",12,16,88,"St Kilda",12,8,80,"Junction Oval",8,1972,"Regular",2,"Home","Fitzroy","St Kilda",8
7424,1972-04-08,"R2","Melbourne",11,18,84,"Footscray",15,15,105,"M.C.G.",-21,1972,"Regular",2,"Away","Footscray","Melbourne",21
7425,1972-04-08,"R2","Geelong",10,3,63,"Richmond",22,17,149,"Kardinia Park",-86,1972,"Regular",2,"Away","Richmond","Geelong",86
7426,1972-04-08,"R2","North Melbourne",11,10,76,"Hawthorn",19,24,138,"Arden St",-62,1972,"Regular",2,"Away","Hawthorn","North Melbourne",62
7427,1972-04-15,"R3","Sydney",14,10,94,"Carlton",18,18,126,"Lake Oval",-32,1972,"Regular",3,"Away","Carlton","Sydney",32
7428,1972-04-15,"R3","Collingwood",17,11,113,"Melbourne",6,12,48,"Victoria Park",65,1972,"Regular",3,"Home","Collingwood","Melbourne",65
7429,1972-04-15,"R3","Richmond",16,15,111,"Essendon",19,17,131,"M.C.G.",-20,1972,"Regular",3,"Away","Essendon","Richmond",20
7430,1972-04-15,"R3","North Melbourne",12,14,86,"Fitzroy",16,13,109,"Arden St",-23,1972,"Regular",3,"Away","Fitzroy","North Melbourne",23
7431,1972-04-15,"R3","St Kilda",22,7,139,"Footscray",12,9,81,"Moorabbin Oval",58,1972,"Regular",3,"Home","St Kilda","Footscray",58
7432,1972-04-15,"R3","Geelong",9,11,65,"Hawthorn",15,17,107,"Waverley Park",-42,1972,"Regular",3,"Away","Hawthorn","Geelong",42
7433,1972-04-22,"R4","Carlton",15,14,104,"Richmond",15,19,109,"Princes Park",-5,1972,"Regular",4,"Away","Richmond","Carlton",5
7434,1972-04-22,"R4","Collingwood",9,13,67,"St Kilda",12,15,87,"Waverley Park",-20,1972,"Regular",4,"Away","St Kilda","Collingwood",20
7435,1972-04-22,"R4","Essendon",17,27,129,"Geelong",12,14,86,"Windy Hill",43,1972,"Regular",4,"Home","Essendon","Geelong",43
7436,1972-04-22,"R4","Fitzroy",11,17,83,"Hawthorn",9,10,64,"Junction Oval",19,1972,"Regular",4,"Home","Fitzroy","Hawthorn",19
7437,1972-04-22,"R4","Footscray",15,10,100,"North Melbourne",12,14,86,"Western Oval",14,1972,"Regular",4,"Home","Footscray","North Melbourne",14
7438,1972-04-22,"R4","Melbourne",18,19,127,"Sydney",8,8,56,"M.C.G.",71,1972,"Regular",4,"Home","Melbourne","Sydney",71
7439,1972-04-25,"R5","Essendon",10,13,73,"Carlton",13,10,88,"Waverley Park",-15,1972,"Regular",5,"Away","Carlton","Essendon",15
7440,1972-04-25,"R5","Richmond",13,11,89,"Melbourne",12,12,84,"M.C.G.",5,1972,"Regular",5,"Home","Richmond","Melbourne",5
7441,1972-04-29,"R5","North Melbourne",8,14,62,"Collingwood",22,8,140,"Arden St",-78,1972,"Regular",5,"Away","Collingwood","North Melbourne",78
7442,1972-04-29,"R5","Geelong",11,9,75,"Fitzroy",19,13,127,"Kardinia Park",-52,1972,"Regular",5,"Away","Fitzroy","Geelong",52
7443,1972-04-29,"R5","Hawthorn",14,20,104,"Footscray",11,10,76,"Glenferrie Oval",28,1972,"Regular",5,"Home","Hawthorn","Footscray",28
7444,1972-04-29,"R5","Sydney",5,17,47,"St Kilda",9,16,70,"Lake Oval",-23,1972,"Regular",5,"Away","St Kilda","Sydney",23
7445,1972-05-06,"R6","Carlton",22,15,147,"Geelong",14,14,98,"Princes Park",49,1972,"Regular",6,"Home","Carlton","Geelong",49
7446,1972-05-06,"R6","Collingwood",14,12,96,"Hawthorn",15,11,101,"Victoria Park",-5,1972,"Regular",6,"Away","Hawthorn","Collingwood",5
7447,1972-05-06,"R6","Melbourne",16,13,109,"Essendon",12,13,85,"M.C.G.",24,1972,"Regular",6,"Home","Melbourne","Essendon",24
7448,1972-05-06,"R6","Footscray",16,16,112,"Fitzroy",13,12,90,"Western Oval",22,1972,"Regular",6,"Home","Footscray","Fitzroy",22
7449,1972-05-06,"R6","Sydney",14,22,106,"North Melbourne",13,13,91,"Waverley Park",15,1972,"Regular",6,"Home","Sydney","North Melbourne",15
7450,1972-05-06,"R6","St Kilda",24,21,165,"Richmond",10,16,76,"Moorabbin Oval",89,1972,"Regular",6,"Home","St Kilda","Richmond",89
7451,1972-05-13,"R7","Carlton",10,15,75,"Melbourne",5,8,38,"Waverley Park",37,1972,"Regular",7,"Home","Carlton","Melbourne",37
7452,1972-05-13,"R7","Fitzroy",10,15,75,"Collingwood",15,10,100,"Junction Oval",-25,1972,"Regular",7,"Away","Collingwood","Fitzroy",25
7453,1972-05-13,"R7","Essendon",18,15,123,"St Kilda",10,22,82,"Windy Hill",41,1972,"Regular",7,"Home","Essendon","St Kilda",41
7454,1972-05-13,"R7","Geelong",15,18,108,"Footscray",16,15,111,"Kardinia Park",-3,1972,"Regular",7,"Away","Footscray","Geelong",3
7455,1972-05-13,"R7","Hawthorn",13,14,92,"Sydney",9,20,74,"Glenferrie Oval",18,1972,"Regular",7,"Home","Hawthorn","Sydney",18
7456,1972-05-13,"R7","Richmond",17,19,121,"North Melbourne",13,16,94,"M.C.G.",27,1972,"Regular",7,"Home","Richmond","North Melbourne",27
7457,1972-05-20,"R8","St Kilda",10,12,72,"Carlton",14,15,99,"Moorabbin Oval",-27,1972,"Regular",8,"Away","Carlton","St Kilda",27
7458,1972-05-20,"R8","Collingwood",7,14,56,"Footscray",11,14,80,"Victoria Park",-24,1972,"Regular",8,"Away","Footscray","Collingwood",24
7459,1972-05-20,"R8","North Melbourne",8,13,61,"Essendon",14,12,96,"Arden St",-35,1972,"Regular",8,"Away","Essendon","North Melbourne",35
7460,1972-05-20,"R8","Sydney",9,7,61,"Fitzroy",18,11,119,"Lake Oval",-58,1972,"Regular",8,"Away","Fitzroy","Sydney",58
7461,1972-05-20,"R8","Melbourne",20,14,134,"Geelong",14,17,101,"M.C.G.",33,1972,"Regular",8,"Home","Melbourne","Geelong",33
7462,1972-05-20,"R8","Richmond",11,25,91,"Hawthorn",13,6,84,"Waverley Park",7,1972,"Regular",8,"Home","Richmond","Hawthorn",7
7463,1972-05-27,"R9","Carlton",16,13,109,"North Melbourne",6,11,47,"Princes Park",62,1972,"Regular",9,"Home","Carlton","North Melbourne",62
7464,1972-05-27,"R9","Collingwood",28,16,184,"Geelong",16,13,109,"Victoria Park",75,1972,"Regular",9,"Home","Collingwood","Geelong",75
7465,1972-05-27,"R9","Essendon",15,17,107,"Hawthorn",14,21,105,"Windy Hill",2,1972,"Regular",9,"Home","Essendon","Hawthorn",2
7466,1972-05-27,"R9","Fitzroy",12,25,97,"Richmond",16,9,105,"Junction Oval",-8,1972,"Regular",9,"Away","Richmond","Fitzroy",8
7467,1972-05-27,"R9","Footscray",12,9,81,"Sydney",9,10,64,"Western Oval",17,1972,"Regular",9,"Home","Footscray","Sydney",17
7468,1972-05-27,"R9","Melbourne",5,6,36,"St Kilda",9,19,73,"Waverley Park",-37,1972,"Regular",9,"Away","St Kilda","Melbourne",37
7469,1972-06-03,"R10","Hawthorn",11,22,88,"Carlton",13,7,85,"Glenferrie Oval",3,1972,"Regular",10,"Home","Hawthorn","Carlton",3
7470,1972-06-03,"R10","Sydney",8,11,59,"Collingwood",19,14,128,"Lake Oval",-69,1972,"Regular",10,"Away","Collingwood","Sydney",69
7471,1972-06-03,"R10","Essendon",14,17,101,"Fitzroy",15,9,99,"Waverley Park",2,1972,"Regular",10,"Home","Essendon","Fitzroy",2
7472,1972-06-03,"R10","Richmond",15,14,104,"Footscray",12,14,86,"M.C.G.",18,1972,"Regular",10,"Home","Richmond","Footscray",18
7473,1972-06-03,"R10","Geelong",9,11,65,"St Kilda",11,15,81,"Kardinia Park",-16,1972,"Regular",10,"Away","St Kilda","Geelong",16
7474,1972-06-03,"R10","North Melbourne",6,11,47,"Melbourne",23,17,155,"Arden St",-108,1972,"Regular",10,"Away","Melbourne","North Melbourne",108
7475,1972-06-10,"R11","Footscray",7,9,51,"Carlton",7,15,57,"Western Oval",-6,1972,"Regular",11,"Away","Carlton","Footscray",6
7476,1972-06-10,"R11","St Kilda",17,8,110,"Hawthorn",7,14,56,"Moorabbin Oval",54,1972,"Regular",11,"Home","St Kilda","Hawthorn",54
7477,1972-06-10,"R11","Richmond",14,11,95,"Sydney",2,19,31,"M.C.G.",64,1972,"Regular",11,"Home","Richmond","Sydney",64
7478,1972-06-12,"R11","Collingwood",23,10,148,"Essendon",13,15,93,"Victoria Park",55,1972,"Regular",11,"Home","Collingwood","Essendon",55
7479,1972-06-12,"R11","Fitzroy",12,17,89,"Melbourne",13,10,88,"Junction Oval",1,1972,"Regular",11,"Home","Fitzroy","Melbourne",1
7480,1972-06-12,"R11","North Melbourne",14,11,95,"Geelong",14,20,104,"Waverley Park",-9,1972,"Regular",11,"Away","Geelong","North Melbourne",9
7481,1972-06-17,"R12","Collingwood",11,24,90,"Richmond",12,13,85,"Victoria Park",5,1972,"Regular",12,"Home","Collingwood","Richmond",5
7482,1972-06-17,"R12","Melbourne",11,10,76,"Hawthorn",11,9,75,"M.C.G.",1,1972,"Regular",12,"Home","Melbourne","Hawthorn",1
7483,1972-06-17,"R12","North Melbourne",7,8,50,"St Kilda",12,19,91,"Arden St",-41,1972,"Regular",12,"Away","St Kilda","North Melbourne",41
7484,1972-06-24,"R12","Fitzroy",8,7,55,"Carlton",13,13,91,"Waverley Park",-36,1972,"Regular",12,"Away","Carlton","Fitzroy",36
7485,1972-06-24,"R12","Essendon",14,15,99,"Footscray",19,19,133,"Windy Hill",-34,1972,"Regular",12,"Away","Footscray","Essendon",34
7486,1972-06-24,"R12","Geelong",15,14,104,"Sydney",10,13,73,"Kardinia Park",31,1972,"Regular",12,"Home","Geelong","Sydney",31
7487,1972-07-01,"R13","Carlton",10,10,70,"Collingwood",9,8,62,"Princes Park",8,1972,"Regular",13,"Home","Carlton","Collingwood",8
7488,1972-07-01,"R13","Sydney",12,12,84,"Essendon",13,9,87,"Lake Oval",-3,1972,"Regular",13,"Away","Essendon","Sydney",3
7489,1972-07-01,"R13","St Kilda",13,10,88,"Fitzroy",6,17,53,"Moorabbin Oval",35,1972,"Regular",13,"Home","St Kilda","Fitzroy",35
7490,1972-07-01,"R13","Footscray",11,8,74,"Melbourne",16,15,111,"Waverley Park",-37,1972,"Regular",13,"Away","Melbourne","Footscray",37
7491,1972-07-01,"R13","Richmond",14,8,92,"Geelong",25,18,168,"M.C.G.",-76,1972,"Regular",13,"Away","Geelong","Richmond",76
7492,1972-07-01,"R13","Hawthorn",21,14,140,"North Melbourne",10,16,76,"Glenferrie Oval",64,1972,"Regular",13,"Home","Hawthorn","North Melbourne",64
7493,1972-07-08,"R14","Richmond",17,17,119,"Carlton",13,10,88,"M.C.G.",31,1972,"Regular",14,"Home","Richmond","Carlton",31
7494,1972-07-08,"R14","St Kilda",4,13,37,"Collingwood",9,13,67,"Moorabbin Oval",-30,1972,"Regular",14,"Away","Collingwood","St Kilda",30
7495,1972-07-08,"R14","Geelong",10,10,70,"Essendon",9,6,60,"Kardinia Park",10,1972,"Regular",14,"Home","Geelong","Essendon",10
7496,1972-07-08,"R14","Hawthorn",19,19,133,"Fitzroy",12,8,80,"Waverley Park",53,1972,"Regular",14,"Home","Hawthorn","Fitzroy",53
7497,1972-07-08,"R14","North Melbourne",8,15,63,"Footscray",14,15,99,"Arden St",-36,1972,"Regular",14,"Away","Footscray","North Melbourne",36
7498,1972-07-08,"R14","Sydney",10,9,69,"Melbourne",14,9,93,"Lake Oval",-24,1972,"Regular",14,"Away","Melbourne","Sydney",24
7499,1972-07-15,"R15","Carlton",20,8,128,"Sydney",8,15,63,"Princes Park",65,1972,"Regular",15,"Home","Carlton","Sydney",65
7500,1972-07-15,"R15","Melbourne",8,10,58,"Collingwood",10,13,73,"Waverley Park",-15,1972,"Regular",15,"Away","Collingwood","Melbourne",15
7501,1972-07-15,"R15","Essendon",13,12,90,"Richmond",17,9,111,"Windy Hill",-21,1972,"Regular",15,"Away","Richmond","Essendon",21
7502,1972-07-15,"R15","Fitzroy",16,14,110,"North Melbourne",9,12,66,"Junction Oval",44,1972,"Regular",15,"Home","Fitzroy","North Melbourne",44
7503,1972-07-15,"R15","Footscray",14,7,91,"St Kilda",9,11,65,"Western Oval",26,1972,"Regular",15,"Home","Footscray","St Kilda",26
7504,1972-07-15,"R15","Hawthorn",19,14,128,"Geelong",15,8,98,"Glenferrie Oval",30,1972,"Regular",15,"Home","Hawthorn","Geelong",30
7505,1972-07-22,"R16","Carlton",20,13,133,"Essendon",17,15,117,"Princes Park",16,1972,"Regular",16,"Home","Carlton","Essendon",16
7506,1972-07-22,"R16","Collingwood",17,6,108,"North Melbourne",11,14,80,"Victoria Park",28,1972,"Regular",16,"Home","Collingwood","North Melbourne",28
7507,1972-07-22,"R16","Fitzroy",10,9,69,"Geelong",12,13,85,"Junction Oval",-16,1972,"Regular",16,"Away","Geelong","Fitzroy",16
7508,1972-07-22,"R16","Footscray",13,11,89,"Hawthorn",19,16,130,"Western Oval",-41,1972,"Regular",16,"Away","Hawthorn","Footscray",41
7509,1972-07-22,"R16","Melbourne",11,18,84,"Richmond",19,9,123,"M.C.G.",-39,1972,"Regular",16,"Away","Richmond","Melbourne",39
7510,1972-07-22,"R16","St Kilda",14,11,95,"Sydney",9,5,59,"Waverley Park",36,1972,"Regular",16,"Home","St Kilda","Sydney",36
7511,1972-07-29,"R17","Geelong",9,13,67,"Carlton",17,17,119,"Kardinia Park",-52,1972,"Regular",17,"Away","Carlton","Geelong",52
7512,1972-07-29,"R17","Hawthorn",11,16,82,"Collingwood",19,13,127,"Glenferrie Oval",-45,1972,"Regular",17,"Away","Collingwood","Hawthorn",45
7513,1972-07-29,"R17","Essendon",21,14,140,"Melbourne",14,11,95,"Windy Hill",45,1972,"Regular",17,"Home","Essendon","Melbourne",45
7514,1972-07-29,"R17","Fitzroy",15,12,102,"Footscray",11,15,81,"Waverley Park",21,1972,"Regular",17,"Home","Fitzroy","Footscray",21
7515,1972-07-29,"R17","North Melbourne",12,15,87,"Sydney",11,12,78,"Arden St",9,1972,"Regular",17,"Home","North Melbourne","Sydney",9
7516,1972-07-29,"R17","Richmond",23,15,153,"St Kilda",11,15,81,"M.C.G.",72,1972,"Regular",17,"Home","Richmond","St Kilda",72
7517,1972-08-05,"R18","Melbourne",8,18,66,"Carlton",11,11,77,"M.C.G.",-11,1972,"Regular",18,"Away","Carlton","Melbourne",11
7518,1972-08-05,"R18","Collingwood",19,15,129,"Fitzroy",12,13,85,"Victoria Park",44,1972,"Regular",18,"Home","Collingwood","Fitzroy",44
7519,1972-08-05,"R18","St Kilda",12,9,81,"Essendon",12,16,88,"Moorabbin Oval",-7,1972,"Regular",18,"Away","Essendon","St Kilda",7
7520,1972-08-05,"R18","Footscray",9,19,73,"Geelong",10,9,69,"Western Oval",4,1972,"Regular",18,"Home","Footscray","Geelong",4
7521,1972-08-05,"R18","Sydney",13,11,89,"Hawthorn",23,10,148,"Lake Oval",-59,1972,"Regular",18,"Away","Hawthorn","Sydney",59
7522,1972-08-05,"R18","North Melbourne",6,14,50,"Richmond",13,20,98,"Waverley Park",-48,1972,"Regular",18,"Away","Richmond","North Melbourne",48
7523,1972-08-12,"R19","Carlton",13,16,94,"St Kilda",10,11,71,"Princes Park",23,1972,"Regular",19,"Home","Carlton","St Kilda",23
7524,1972-08-12,"R19","Footscray",7,13,55,"Collingwood",15,12,102,"Waverley Park",-47,1972,"Regular",19,"Away","Collingwood","Footscray",47
7525,1972-08-12,"R19","Essendon",21,14,140,"North Melbourne",14,11,95,"Windy Hill",45,1972,"Regular",19,"Home","Essendon","North Melbourne",45
7526,1972-08-12,"R19","Fitzroy",14,14,98,"Sydney",6,17,53,"Junction Oval",45,1972,"Regular",19,"Home","Fitzroy","Sydney",45
7527,1972-08-12,"R19","Geelong",11,19,85,"Melbourne",21,16,142,"Kardinia Park",-57,1972,"Regular",19,"Away","Melbourne","Geelong",57
7528,1972-08-12,"R19","Hawthorn",15,12,102,"Richmond",17,11,113,"Glenferrie Oval",-11,1972,"Regular",19,"Away","Richmond","Hawthorn",11
7529,1972-08-19,"R20","North Melbourne",8,12,60,"Carlton",23,11,149,"Arden St",-89,1972,"Regular",20,"Away","Carlton","North Melbourne",89
7530,1972-08-19,"R20","Geelong",17,10,112,"Collingwood",17,9,111,"Kardinia Park",1,1972,"Regular",20,"Home","Geelong","Collingwood",1
7531,1972-08-19,"R20","Hawthorn",15,16,106,"Essendon",12,15,87,"Waverley Park",19,1972,"Regular",20,"Home","Hawthorn","Essendon",19
7532,1972-08-19,"R20","Richmond",20,17,137,"Fitzroy",13,22,100,"M.C.G.",37,1972,"Regular",20,"Home","Richmond","Fitzroy",37
7533,1972-08-19,"R20","Sydney",9,12,66,"Footscray",11,13,79,"Lake Oval",-13,1972,"Regular",20,"Away","Footscray","Sydney",13
7534,1972-08-19,"R20","St Kilda",13,12,90,"Melbourne",13,11,89,"Moorabbin Oval",1,1972,"Regular",20,"Home","St Kilda","Melbourne",1
7535,1972-08-26,"R21","Carlton",24,12,156,"Hawthorn",11,22,88,"Princes Park",68,1972,"Regular",21,"Home","Carlton","Hawthorn",68
7536,1972-08-26,"R21","Collingwood",22,17,149,"Sydney",11,6,72,"Victoria Park",77,1972,"Regular",21,"Home","Collingwood","Sydney",77
7537,1972-08-26,"R21","Fitzroy",14,20,104,"Essendon",18,11,119,"Junction Oval",-15,1972,"Regular",21,"Away","Essendon","Fitzroy",15
7538,1972-08-26,"R21","Footscray",17,21,123,"Richmond",18,17,125,"Western Oval",-2,1972,"Regular",21,"Away","Richmond","Footscray",2
7539,1972-08-26,"R21","St Kilda",11,10,76,"Geelong",8,13,61,"Waverley Park",15,1972,"Regular",21,"Home","St Kilda","Geelong",15
7540,1972-08-26,"R21","Melbourne",17,22,124,"North Melbourne",14,7,91,"M.C.G.",33,1972,"Regular",21,"Home","Melbourne","North Melbourne",33
7541,1972-09-02,"R22","Carlton",13,8,86,"Footscray",11,17,83,"Princes Park",3,1972,"Regular",22,"Home","Carlton","Footscray",3
7542,1972-09-02,"R22","Essendon",17,15,117,"Collingwood",17,10,112,"Windy Hill",5,1972,"Regular",22,"Home","Essendon","Collingwood",5
7543,1972-09-02,"R22","Melbourne",18,19,127,"Fitzroy",14,11,95,"M.C.G.",32,1972,"Regular",22,"Home","Melbourne","Fitzroy",32
7544,1972-09-02,"R22","Geelong",20,20,140,"North Melbourne",13,11,89,"Kardinia Park",51,1972,"Regular",22,"Home","Geelong","North Melbourne",51
7545,1972-09-02,"R22","Hawthorn",15,12,102,"St Kilda",18,13,121,"Glenferrie Oval",-19,1972,"Regular",22,"Away","St Kilda","Hawthorn",19
7546,1972-09-02,"R22","Sydney",12,10,82,"Richmond",23,20,158,"Waverley Park",-76,1972,"Regular",22,"Away","Richmond","Sydney",76
7547,1972-09-09,"QF","Richmond",25,14,164,"Collingwood",18,12,120,"M.C.G.",44,1972,"Finals",23,"Home","Richmond","Collingwood",44
7548,1972-09-09,"EF","St Kilda",18,16,124,"Essendon",10,11,71,"Waverley Park",53,1972,"Finals",23,"Home","St Kilda","Essendon",53
7549,1972-09-16,"SF","Carlton",8,13,61,"Richmond",8,13,61,"Waverley Park",0,1972,"Finals",24,"Home","Carlton","Richmond",0
7550,1972-09-16,"SF","Collingwood",8,17,65,"St Kilda",11,17,83,"M.C.G.",-18,1972,"Finals",24,"Away","St Kilda","Collingwood",18
7551,1972-09-23,"SF","Carlton",9,15,69,"Richmond",15,20,110,"M.C.G.",-41,1972,"Finals",24,"Away","Richmond","Carlton",41
7552,1972-09-30,"PF","Carlton",16,13,109,"St Kilda",13,15,93,"M.C.G.",16,1972,"Finals",25,"Home","Carlton","St Kilda",16
7553,1972-10-07,"GF","Carlton",28,9,177,"Richmond",22,18,150,"M.C.G.",27,1972,"Finals",26,"Home","Carlton","Richmond",27
7554,1973-04-07,"R1","Geelong",10,8,68,"Carlton",18,16,124,"Kardinia Park",-56,1973,"Regular",1,"Away","Carlton","Geelong",56
7555,1973-04-07,"R1","Collingwood",17,22,124,"Sydney",6,12,48,"Victoria Park",76,1973,"Regular",1,"Home","Collingwood","Sydney",76
7556,1973-04-07,"R1","Essendon",19,13,127,"Richmond",19,15,129,"Windy Hill",-2,1973,"Regular",1,"Away","Richmond","Essendon",2
7557,1973-04-07,"R1","Fitzroy",20,17,137,"Footscray",12,15,87,"Junction Oval",50,1973,"Regular",1,"Home","Fitzroy","Footscray",50
7558,1973-04-07,"R1","North Melbourne",14,14,98,"Hawthorn",9,16,70,"Arden St",28,1973,"Regular",1,"Home","North Melbourne","Hawthorn",28
7559,1973-04-07,"R1","Melbourne",9,12,66,"St Kilda",14,14,98,"M.C.G.",-32,1973,"Regular",1,"Away","St Kilda","Melbourne",32
7560,1973-04-14,"R2","Carlton",18,15,123,"North Melbourne",14,12,96,"Princes Park",27,1973,"Regular",2,"Home","Carlton","North Melbourne",27
7561,1973-04-14,"R2","Footscray",11,16,82,"Collingwood",14,18,102,"Western Oval",-20,1973,"Regular",2,"Away","Collingwood","Footscray",20
7562,1973-04-14,"R2","Sydney",15,19,109,"Essendon",21,20,146,"Lake Oval",-37,1973,"Regular",2,"Away","Essendon","Sydney",37
7563,1973-04-14,"R2","St Kilda",20,8,128,"Fitzroy",10,11,71,"Moorabbin Oval",57,1973,"Regular",2,"Home","St Kilda","Fitzroy",57
7564,1973-04-14,"R2","Richmond",18,19,127,"Geelong",16,14,110,"M.C.G.",17,1973,"Regular",2,"Home","Richmond","Geelong",17
7565,1973-04-14,"R2","Hawthorn",14,14,98,"Melbourne",13,22,100,"Glenferrie Oval",-2,1973,"Regular",2,"Away","Melbourne","Hawthorn",2
7566,1973-04-21,"R3","Collingwood",21,23,149,"Geelong",11,13,79,"Victoria Park",70,1973,"Regular",3,"Home","Collingwood","Geelong",70
7567,1973-04-21,"R3","North Melbourne",11,18,84,"Fitzroy",10,18,78,"Arden St",6,1973,"Regular",3,"Home","North Melbourne","Fitzroy",6
7568,1973-04-21,"R3","St Kilda",12,9,81,"Richmond",17,8,110,"Moorabbin Oval",-29,1973,"Regular",3,"Away","Richmond","St Kilda",29
7569,1973-04-23,"R3","Melbourne",11,9,75,"Carlton",11,16,82,"M.C.G.",-7,1973,"Regular",3,"Away","Carlton","Melbourne",7
7570,1973-04-23,"R3","Hawthorn",27,8,170,"Essendon",15,12,102,"Waverley Park",68,1973,"Regular",3,"Home","Hawthorn","Essendon",68
7571,1973-04-23,"R3","Sydney",17,16,118,"Footscray",20,15,135,"Lake Oval",-17,1973,"Regular",3,"Away","Footscray","Sydney",17
7572,1973-04-25,"R4","St Kilda",8,12,60,"Collingwood",19,16,130,"Waverley Park",-70,1973,"Regular",4,"Away","Collingwood","St Kilda",70
7573,1973-04-25,"R4","Richmond",11,18,84,"North Melbourne",14,20,104,"M.C.G.",-20,1973,"Regular",4,"Away","North Melbourne","Richmond",20
7574,1973-04-28,"R4","Carlton",14,11,95,"Hawthorn",12,11,83,"Princes Park",12,1973,"Regular",4,"Home","Carlton","Hawthorn",12
7575,1973-04-28,"R4","Footscray",8,19,67,"Essendon",17,13,115,"Western Oval",-48,1973,"Regular",4,"Away","Essendon","Footscray",48
7576,1973-04-28,"R4","Fitzroy",13,9,87,"Melbourne",13,16,94,"Junction Oval",-7,1973,"Regular",4,"Away","Melbourne","Fitzroy",7
7577,1973-04-28,"R4","Geelong",17,16,118,"Sydney",12,14,86,"Kardinia Park",32,1973,"Regular",4,"Home","Geelong","Sydney",32
7578,1973-05-05,"R5","Carlton",15,15,105,"Fitzroy",10,8,68,"Waverley Park",37,1973,"Regular",5,"Home","Carlton","Fitzroy",37
7579,1973-05-05,"R5","North Melbourne",13,20,98,"Collingwood",15,19,109,"Arden St",-11,1973,"Regular",5,"Away","Collingwood","North Melbourne",11
7580,1973-05-05,"R5","Essendon",16,26,122,"Geelong",15,16,106,"Windy Hill",16,1973,"Regular",5,"Home","Essendon","Geelong",16
7581,1973-05-05,"R5","Hawthorn",18,16,124,"Footscray",16,12,108,"Glenferrie Oval",16,1973,"Regular",5,"Home","Hawthorn","Footscray",16
7582,1973-05-05,"R5","Melbourne",13,13,91,"Richmond",16,14,110,"M.C.G.",-19,1973,"Regular",5,"Away","Richmond","Melbourne",19
7583,1973-05-05,"R5","Sydney",6,12,48,"St Kilda",10,16,76,"Lake Oval",-28,1973,"Regular",5,"Away","St Kilda","Sydney",28
7584,1973-05-12,"R6","Richmond",18,20,128,"Carlton",15,12,102,"M.C.G.",26,1973,"Regular",6,"Home","Richmond","Carlton",26
7585,1973-05-12,"R6","Collingwood",15,10,100,"Melbourne",10,16,76,"Victoria Park",24,1973,"Regular",6,"Home","Collingwood","Melbourne",24
7586,1973-05-12,"R6","St Kilda",18,13,121,"Essendon",21,14,140,"Moorabbin Oval",-19,1973,"Regular",6,"Away","Essendon","St Kilda",19
7587,1973-05-12,"R6","Fitzroy",15,17,107,"Hawthorn",12,13,85,"Junction Oval",22,1973,"Regular",6,"Home","Fitzroy","Hawthorn",22
7588,1973-05-12,"R6","Geelong",11,14,80,"Footscray",14,14,98,"Kardinia Park",-18,1973,"Regular",6,"Away","Footscray","Geelong",18
7589,1973-05-12,"R6","North Melbourne",18,16,124,"Sydney",11,14,80,"Waverley Park",44,1973,"Regular",6,"Home","North Melbourne","Sydney",44
7590,1973-05-19,"R7","Carlton",16,23,119,"Collingwood",8,12,60,"Princes Park",59,1973,"Regular",7,"Home","Carlton","Collingwood",59
7591,1973-05-19,"R7","Essendon",20,24,144,"North Melbourne",11,8,74,"Windy Hill",70,1973,"Regular",7,"Home","Essendon","North Melbourne",70
7592,1973-05-19,"R7","Fitzroy",12,8,80,"Richmond",16,21,117,"Waverley Park",-37,1973,"Regular",7,"Away","Richmond","Fitzroy",37
7593,1973-05-19,"R7","Footscray",14,9,93,"St Kilda",13,12,90,"Western Oval",3,1973,"Regular",7,"Home","Footscray","St Kilda",3
7594,1973-05-19,"R7","Hawthorn",19,15,129,"Geelong",9,14,68,"Glenferrie Oval",61,1973,"Regular",7,"Home","Hawthorn","Geelong",61
7595,1973-05-19,"R7","Melbourne",17,10,112,"Sydney",12,11,83,"M.C.G.",29,1973,"Regular",7,"Home","Melbourne","Sydney",29
7596,1973-05-26,"R8","Sydney",7,9,51,"Carlton",19,16,130,"Lake Oval",-79,1973,"Regular",8,"Away","Carlton","Sydney",79
7597,1973-05-26,"R8","Collingwood",15,13,103,"Fitzroy",10,8,68,"Victoria Park",35,1973,"Regular",8,"Home","Collingwood","Fitzroy",35
7598,1973-05-26,"R8","Melbourne",10,11,71,"Essendon",12,9,81,"Waverley Park",-10,1973,"Regular",8,"Away","Essendon","Melbourne",10
7599,1973-05-26,"R8","North Melbourne",8,8,56,"Footscray",8,8,56,"Arden St",0,1973,"Regular",8,"Home","North Melbourne","Footscray",0
7600,1973-05-26,"R8","St Kilda",16,10,106,"Geelong",8,12,60,"Moorabbin Oval",46,1973,"Regular",8,"Home","St Kilda","Geelong",46
7601,1973-05-26,"R8","Richmond",10,22,82,"Hawthorn",16,23,119,"M.C.G.",-37,1973,"Regular",8,"Away","Hawthorn","Richmond",37
7602,1973-06-04,"R9","Carlton",19,19,133,"Essendon",13,14,92,"Princes Park",41,1973,"Regular",9,"Home","Carlton","Essendon",41
7603,1973-06-04,"R9","Richmond",10,6,66,"Collingwood",15,15,105,"Waverley Park",-39,1973,"Regular",9,"Away","Collingwood","Richmond",39
7604,1973-06-04,"R9","Fitzroy",16,8,104,"Sydney",7,15,57,"Junction Oval",47,1973,"Regular",9,"Home","Fitzroy","Sydney",47
7605,1973-06-04,"R9","Footscray",9,14,68,"Melbourne",10,14,74,"Western Oval",-6,1973,"Regular",9,"Away","Melbourne","Footscray",6
7606,1973-06-04,"R9","Geelong",14,6,90,"North Melbourne",18,13,121,"Kardinia Park",-31,1973,"Regular",9,"Away","North Melbourne","Geelong",31
7607,1973-06-04,"R9","St Kilda",11,12,78,"Hawthorn",8,16,64,"Moorabbin Oval",14,1973,"Regular",9,"Home","St Kilda","Hawthorn",14
7608,1973-06-09,"R10","Carlton",13,13,91,"Footscray",9,11,65,"Waverley Park",26,1973,"Regular",10,"Home","Carlton","Footscray",26
7609,1973-06-09,"R10","Hawthorn",14,11,95,"Collingwood",15,18,108,"Glenferrie Oval",-13,1973,"Regular",10,"Away","Collingwood","Hawthorn",13
7610,1973-06-09,"R10","Essendon",15,17,107,"Fitzroy",14,13,97,"Windy Hill",10,1973,"Regular",10,"Home","Essendon","Fitzroy",10
7611,1973-06-09,"R10","Melbourne",20,19,139,"Geelong",11,15,81,"M.C.G.",58,1973,"Regular",10,"Home","Melbourne","Geelong",58
7612,1973-06-09,"R10","North Melbourne",11,14,80,"St Kilda",7,12,54,"Arden St",26,1973,"Regular",10,"Home","North Melbourne","St Kilda",26
7613,1973-06-09,"R10","Sydney",9,8,62,"Richmond",13,14,92,"Lake Oval",-30,1973,"Regular",10,"Away","Richmond","Sydney",30
7614,1973-06-16,"R11","St Kilda",13,13,91,"Carlton",9,13,67,"Moorabbin Oval",24,1973,"Regular",11,"Home","St Kilda","Carlton",24
7615,1973-06-16,"R11","Collingwood",23,16,154,"Essendon",16,16,112,"Victoria Park",42,1973,"Regular",11,"Home","Collingwood","Essendon",42
7616,1973-06-16,"R11","Geelong",16,8,104,"Fitzroy",11,15,81,"Kardinia Park",23,1973,"Regular",11,"Home","Geelong","Fitzroy",23
7617,1973-06-16,"R11","Footscray",7,16,58,"Richmond",17,7,109,"Western Oval",-51,1973,"Regular",11,"Away","Richmond","Footscray",51
7618,1973-06-16,"R11","Sydney",11,10,76,"Hawthorn",17,17,119,"Waverley Park",-43,1973,"Regular",11,"Away","Hawthorn","Sydney",43
7619,1973-06-16,"R11","Melbourne",13,12,90,"North Melbourne",12,9,81,"M.C.G.",9,1973,"Regular",11,"Home","Melbourne","North Melbourne",9
7620,1973-06-23,"R12","Carlton",17,12,114,"Geelong",9,13,67,"Princes Park",47,1973,"Regular",12,"Home","Carlton","Geelong",47
7621,1973-06-23,"R12","Sydney",12,5,77,"Collingwood",15,9,99,"Lake Oval",-22,1973,"Regular",12,"Away","Collingwood","Sydney",22
7622,1973-06-23,"R12","Richmond",15,21,111,"Essendon",13,17,95,"M.C.G.",16,1973,"Regular",12,"Home","Richmond","Essendon",16
7623,1973-06-23,"R12","Footscray",10,15,75,"Fitzroy",13,11,89,"Waverley Park",-14,1973,"Regular",12,"Away","Fitzroy","Footscray",14
7624,1973-06-23,"R12","Hawthorn",12,13,85,"North Melbourne",10,10,70,"Glenferrie Oval",15,1973,"Regular",12,"Home","Hawthorn","North Melbourne",15
7625,1973-06-23,"R12","St Kilda",11,14,80,"Melbourne",6,18,54,"Moorabbin Oval",26,1973,"Regular",12,"Home","St Kilda","Melbourne",26
7626,1973-06-30,"R13","North Melbourne",16,19,115,"Carlton",16,11,107,"Arden St",8,1973,"Regular",13,"Home","North Melbourne","Carlton",8
7627,1973-06-30,"R13","Collingwood",13,17,95,"Footscray",14,6,90,"Victoria Park",5,1973,"Regular",13,"Home","Collingwood","Footscray",5
7628,1973-06-30,"R13","Essendon",20,19,139,"Sydney",16,14,110,"Windy Hill",29,1973,"Regular",13,"Home","Essendon","Sydney",29
7629,1973-06-30,"R13","Fitzroy",10,11,71,"St Kilda",20,11,131,"Junction Oval",-60,1973,"Regular",13,"Away","St Kilda","Fitzroy",60
7630,1973-06-30,"R13","Geelong",13,11,89,"Richmond",21,7,133,"Waverley Park",-44,1973,"Regular",13,"Away","Richmond","Geelong",44
7631,1973-06-30,"R13","Melbourne",15,15,105,"Hawthorn",15,22,112,"M.C.G.",-7,1973,"Regular",13,"Away","Hawthorn","Melbourne",7
7632,1973-07-07,"R14","Hawthorn",14,24,108,"Carlton",12,14,86,"Glenferrie Oval",22,1973,"Regular",14,"Home","Hawthorn","Carlton",22
7633,1973-07-07,"R14","Collingwood",15,13,103,"St Kilda",12,10,82,"Victoria Park",21,1973,"Regular",14,"Home","Collingwood","St Kilda",21
7634,1973-07-07,"R14","Essendon",21,6,132,"Footscray",13,19,97,"Waverley Park",35,1973,"Regular",14,"Home","Essendon","Footscray",35
7635,1973-07-07,"R14","Melbourne",19,20,134,"Fitzroy",14,13,97,"M.C.G.",37,1973,"Regular",14,"Home","Melbourne","Fitzroy",37
7636,1973-07-07,"R14","Sydney",18,15,123,"Geelong",12,6,78,"Lake Oval",45,1973,"Regular",14,"Home","Sydney","Geelong",45
7637,1973-07-07,"R14","North Melbourne",11,12,78,"Richmond",17,15,117,"Arden St",-39,1973,"Regular",14,"Away","Richmond","North Melbourne",39
7638,1973-07-14,"R15","Carlton",18,14,122,"Melbourne",12,9,81,"Princes Park",41,1973,"Regular",15,"Home","Carlton","Melbourne",41
7639,1973-07-14,"R15","Geelong",13,10,88,"Collingwood",13,18,96,"Kardinia Park",-8,1973,"Regular",15,"Away","Collingwood","Geelong",8
7640,1973-07-14,"R15","Essendon",23,13,151,"Hawthorn",18,8,116,"Windy Hill",35,1973,"Regular",15,"Home","Essendon","Hawthorn",35
7641,1973-07-14,"R15","Fitzroy",16,12,108,"North Melbourne",13,18,96,"Junction Oval",12,1973,"Regular",15,"Home","Fitzroy","North Melbourne",12
7642,1973-07-14,"R15","Footscray",12,7,79,"Sydney",20,21,141,"Western Oval",-62,1973,"Regular",15,"Away","Sydney","Footscray",62
7643,1973-07-14,"R15","Richmond",13,12,90,"St Kilda",11,11,77,"Waverley Park",13,1973,"Regular",15,"Home","Richmond","St Kilda",13
7644,1973-07-21,"R16","Fitzroy",12,19,91,"Carlton",11,14,80,"Junction Oval",11,1973,"Regular",16,"Home","Fitzroy","Carlton",11
7645,1973-07-21,"R16","Collingwood",10,11,71,"North Melbourne",11,10,76,"Waverley Park",-5,1973,"Regular",16,"Away","North Melbourne","Collingwood",5
7646,1973-07-21,"R16","Geelong",12,10,82,"Essendon",11,15,81,"Kardinia Park",1,1973,"Regular",16,"Home","Geelong","Essendon",1
7647,1973-07-21,"R16","Footscray",6,9,45,"Hawthorn",9,11,65,"Western Oval",-20,1973,"Regular",16,"Away","Hawthorn","Footscray",20
7648,1973-07-21,"R16","Richmond",16,14,110,"Melbourne",9,19,73,"M.C.G.",37,1973,"Regular",16,"Home","Richmond","Melbourne",37
7649,1973-07-21,"R16","St Kilda",14,16,100,"Sydney",13,15,93,"Moorabbin Oval",7,1973,"Regular",16,"Home","St Kilda","Sydney",7
7650,1973-07-28,"R17","Carlton",15,17,107,"Richmond",10,21,81,"Princes Park",26,1973,"Regular",17,"Home","Carlton","Richmond",26
7651,1973-07-28,"R17","Melbourne",12,15,87,"Collingwood",17,24,126,"M.C.G.",-39,1973,"Regular",17,"Away","Collingwood","Melbourne",39
7652,1973-07-28,"R17","Essendon",15,12,102,"St Kilda",10,19,79,"Windy Hill",23,1973,"Regular",17,"Home","Essendon","St Kilda",23
7653,1973-07-28,"R17","Hawthorn",15,10,100,"Fitzroy",9,9,63,"Glenferrie Oval",37,1973,"Regular",17,"Home","Hawthorn","Fitzroy",37
7654,1973-07-28,"R17","Footscray",21,15,141,"Geelong",13,14,92,"Waverley Park",49,1973,"Regular",17,"Home","Footscray","Geelong",49
7655,1973-07-28,"R17","Sydney",19,16,130,"North Melbourne",14,7,91,"Lake Oval",39,1973,"Regular",17,"Home","Sydney","North Melbourne",39
7656,1973-08-04,"R18","Collingwood",19,7,121,"Carlton",15,16,106,"Victoria Park",15,1973,"Regular",18,"Home","Collingwood","Carlton",15
7657,1973-08-04,"R18","North Melbourne",13,13,91,"Essendon",14,10,94,"Arden St",-3,1973,"Regular",18,"Away","Essendon","North Melbourne",3
7658,1973-08-04,"R18","Richmond",15,14,104,"Fitzroy",13,14,92,"M.C.G.",12,1973,"Regular",18,"Home","Richmond","Fitzroy",12
7659,1973-08-04,"R18","St Kilda",15,20,110,"Footscray",12,14,86,"Moorabbin Oval",24,1973,"Regular",18,"Home","St Kilda","Footscray",24
7660,1973-08-04,"R18","Geelong",14,11,95,"Hawthorn",14,10,94,"Kardinia Park",1,1973,"Regular",18,"Home","Geelong","Hawthorn",1
7661,1973-08-04,"R18","Sydney",12,14,86,"Melbourne",11,12,78,"Waverley Park",8,1973,"Regular",18,"Home","Sydney","Melbourne",8
7662,1973-08-11,"R19","Carlton",20,17,137,"Sydney",11,14,80,"Princes Park",57,1973,"Regular",19,"Home","Carlton","Sydney",57
7663,1973-08-11,"R19","Fitzroy",10,19,79,"Collingwood",19,10,124,"Junction Oval",-45,1973,"Regular",19,"Away","Collingwood","Fitzroy",45
7664,1973-08-11,"R19","Essendon",17,13,115,"Melbourne",15,11,101,"Windy Hill",14,1973,"Regular",19,"Home","Essendon","Melbourne",14
7665,1973-08-11,"R19","Footscray",10,8,68,"North Melbourne",10,14,74,"Western Oval",-6,1973,"Regular",19,"Away","North Melbourne","Footscray",6
7666,1973-08-11,"R19","Geelong",13,8,86,"St Kilda",11,17,83,"Waverley Park",3,1973,"Regular",19,"Home","Geelong","St Kilda",3
7667,1973-08-11,"R19","Hawthorn",11,11,77,"Richmond",12,10,82,"Glenferrie Oval",-5,1973,"Regular",19,"Away","Richmond","Hawthorn",5
7668,1973-08-18,"R20","Essendon",10,7,67,"Carlton",17,9,111,"Waverley Park",-44,1973,"Regular",20,"Away","Carlton","Essendon",44
7669,1973-08-18,"R20","Collingwood",8,11,59,"Richmond",14,16,100,"Victoria Park",-41,1973,"Regular",20,"Away","Richmond","Collingwood",41
7670,1973-08-18,"R20","Sydney",15,11,101,"Fitzroy",14,21,105,"Lake Oval",-4,1973,"Regular",20,"Away","Fitzroy","Sydney",4
7671,1973-08-18,"R20","Melbourne",10,13,73,"Footscray",17,8,110,"M.C.G.",-37,1973,"Regular",20,"Away","Footscray","Melbourne",37
7672,1973-08-18,"R20","North Melbourne",9,10,64,"Geelong",7,6,48,"Arden St",16,1973,"Regular",20,"Home","North Melbourne","Geelong",16
7673,1973-08-18,"R20","Hawthorn",11,11,77,"St Kilda",15,8,98,"Glenferrie Oval",-21,1973,"Regular",20,"Away","St Kilda","Hawthorn",21
7674,1973-08-25,"R21","Footscray",10,15,75,"Carlton",9,12,66,"Western Oval",9,1973,"Regular",21,"Home","Footscray","Carlton",9
7675,1973-08-25,"R21","Collingwood",16,10,106,"Hawthorn",13,10,88,"Waverley Park",18,1973,"Regular",21,"Home","Collingwood","Hawthorn",18
7676,1973-08-25,"R21","Fitzroy",13,22,100,"Essendon",9,23,77,"Junction Oval",23,1973,"Regular",21,"Home","Fitzroy","Essendon",23
7677,1973-08-25,"R21","Geelong",17,11,113,"Melbourne",14,14,98,"Kardinia Park",15,1973,"Regular",21,"Home","Geelong","Melbourne",15
7678,1973-08-25,"R21","St Kilda",16,18,114,"North Melbourne",14,12,96,"Moorabbin Oval",18,1973,"Regular",21,"Home","St Kilda","North Melbourne",18
7679,1973-08-25,"R21","Richmond",22,11,143,"Sydney",13,16,94,"M.C.G.",49,1973,"Regular",21,"Home","Richmond","Sydney",49
7680,1973-09-01,"R22","Carlton",20,15,135,"St Kilda",13,9,87,"Princes Park",48,1973,"Regular",22,"Home","Carlton","St Kilda",48
7681,1973-09-01,"R22","Essendon",16,6,102,"Collingwood",17,10,112,"Windy Hill",-10,1973,"Regular",22,"Away","Collingwood","Essendon",10
7682,1973-09-01,"R22","Fitzroy",17,15,117,"Geelong",14,17,101,"Junction Oval",16,1973,"Regular",22,"Home","Fitzroy","Geelong",16
7683,1973-09-01,"R22","Richmond",10,16,76,"Footscray",11,11,77,"M.C.G.",-1,1973,"Regular",22,"Away","Footscray","Richmond",1
7684,1973-09-01,"R22","Hawthorn",16,20,116,"Sydney",11,13,79,"Glenferrie Oval",37,1973,"Regular",22,"Home","Hawthorn","Sydney",37
7685,1973-09-01,"R22","North Melbourne",11,5,71,"Melbourne",9,12,66,"Waverley Park",5,1973,"Regular",22,"Home","North Melbourne","Melbourne",5
7686,1973-09-08,"QF","Richmond",10,11,71,"Carlton",13,13,91,"M.C.G.",-20,1973,"Finals",23,"Away","Carlton","Richmond",20
7687,1973-09-08,"EF","Essendon",13,13,91,"St Kilda",24,14,158,"Waverley Park",-67,1973,"Finals",23,"Away","St Kilda","Essendon",67
7688,1973-09-15,"SF","Collingwood",12,15,87,"Carlton",15,17,107,"Waverley Park",-20,1973,"Finals",24,"Away","Carlton","Collingwood",20
7689,1973-09-15,"SF","Richmond",15,18,108,"St Kilda",9,14,68,"M.C.G.",40,1973,"Finals",24,"Home","Richmond","St Kilda",40
7690,1973-09-22,"PF","Collingwood",14,14,98,"Richmond",15,15,105,"M.C.G.",-7,1973,"Finals",25,"Away","Richmond","Collingwood",7
7691,1973-09-29,"GF","Richmond",16,20,116,"Carlton",12,14,86,"M.C.G.",30,1973,"Finals",26,"Home","Richmond","Carlton",30
7692,1974-04-06,"R1","Carlton",14,13,97,"Melbourne",6,12,48,"Princes Park",49,1974,"Regular",1,"Home","Carlton","Melbourne",49
7693,1974-04-06,"R1","Collingwood",17,15,117,"Essendon",15,10,100,"Victoria Park",17,1974,"Regular",1,"Home","Collingwood","Essendon",17
7694,1974-04-06,"R1","St Kilda",11,17,83,"Fitzroy",6,7,43,"Moorabbin Oval",40,1974,"Regular",1,"Home","St Kilda","Fitzroy",40
7695,1974-04-06,"R1","Footscray",16,14,110,"Geelong",9,11,65,"Western Oval",45,1974,"Regular",1,"Home","Footscray","Geelong",45
7696,1974-04-06,"R1","Richmond",12,16,88,"Hawthorn",15,14,104,"M.C.G.",-16,1974,"Regular",1,"Away","Hawthorn","Richmond",16
7697,1974-04-06,"R1","Sydney",15,10,100,"North Melbourne",11,14,80,"Lake Oval",20,1974,"Regular",1,"Home","Sydney","North Melbourne",20
7698,1974-04-13,"R2","Geelong",15,7,97,"Carlton",12,16,88,"Kardinia Park",9,1974,"Regular",2,"Home","Geelong","Carlton",9
7699,1974-04-13,"R2","Hawthorn",6,12,48,"Collingwood",10,11,71,"Princes Park",-23,1974,"Regular",2,"Away","Collingwood","Hawthorn",23
7700,1974-04-13,"R2","Fitzroy",9,13,67,"Richmond",15,26,116,"Junction Oval",-49,1974,"Regular",2,"Away","Richmond","Fitzroy",49
7701,1974-04-15,"R2","Essendon",21,24,150,"Sydney",10,18,78,"Windy Hill",72,1974,"Regular",2,"Home","Essendon","Sydney",72
7702,1974-04-15,"R2","North Melbourne",20,12,132,"Footscray",11,9,75,"Arden St",57,1974,"Regular",2,"Home","North Melbourne","Footscray",57
7703,1974-04-15,"R2","Melbourne",11,20,86,"St Kilda",14,16,100,"M.C.G.",-14,1974,"Regular",2,"Away","St Kilda","Melbourne",14
7704,1974-04-20,"R3","Carlton",11,15,81,"Richmond",18,11,119,"Princes Park",-38,1974,"Regular",3,"Away","Richmond","Carlton",38
7705,1974-04-20,"R3","Collingwood",16,16,112,"Footscray",14,15,99,"Victoria Park",13,1974,"Regular",3,"Home","Collingwood","Footscray",13
7706,1974-04-20,"R3","Essendon",16,14,110,"St Kilda",15,15,105,"Waverley Park",5,1974,"Regular",3,"Home","Essendon","St Kilda",5
7707,1974-04-20,"R3","North Melbourne",17,18,120,"Fitzroy",7,11,53,"Arden St",67,1974,"Regular",3,"Home","North Melbourne","Fitzroy",67
7708,1974-04-20,"R3","Melbourne",16,10,106,"Geelong",16,14,110,"M.C.G.",-4,1974,"Regular",3,"Away","Geelong","Melbourne",4
7709,1974-04-20,"R3","Sydney",8,18,66,"Hawthorn",20,15,135,"Lake Oval",-69,1974,"Regular",3,"Away","Hawthorn","Sydney",69
7710,1974-04-25,"R4","North Melbourne",19,9,123,"Carlton",6,15,51,"Waverley Park",72,1974,"Regular",4,"Home","North Melbourne","Carlton",72
7711,1974-04-25,"R4","Fitzroy",18,12,120,"Collingwood",17,9,111,"Junction Oval",9,1974,"Regular",4,"Home","Fitzroy","Collingwood",9
7712,1974-04-27,"R4","Hawthorn",9,15,69,"Essendon",5,13,43,"Princes Park",26,1974,"Regular",4,"Home","Hawthorn","Essendon",26
7713,1974-04-27,"R4","Footscray",15,6,96,"Sydney",7,9,51,"Western Oval",45,1974,"Regular",4,"Home","Footscray","Sydney",45
7714,1974-04-27,"R4","Geelong",6,9,45,"St Kilda",8,13,61,"Kardinia Park",-16,1974,"Regular",4,"Away","St Kilda","Geelong",16
7715,1974-04-27,"R4","Richmond",13,16,94,"Melbourne",9,15,69,"M.C.G.",25,1974,"Regular",4,"Home","Richmond","Melbourne",25
7716,1974-05-04,"R5","Collingwood",13,14,92,"Carlton",10,14,74,"Victoria Park",18,1974,"Regular",5,"Home","Collingwood","Carlton",18
7717,1974-05-04,"R5","Essendon",12,26,98,"Geelong",10,14,74,"Windy Hill",24,1974,"Regular",5,"Home","Essendon","Geelong",24
7718,1974-05-04,"R5","Sydney",14,16,100,"Fitzroy",15,10,100,"Lake Oval",0,1974,"Regular",5,"Home","Sydney","Fitzroy",0
7719,1974-05-04,"R5","Hawthorn",8,14,62,"Footscray",11,19,85,"Waverley Park",-23,1974,"Regular",5,"Away","Footscray","Hawthorn",23
7720,1974-05-04,"R5","Melbourne",13,11,89,"North Melbourne",19,15,129,"M.C.G.",-40,1974,"Regular",5,"Away","North Melbourne","Melbourne",40
7721,1974-05-04,"R5","St Kilda",13,12,90,"Richmond",15,20,110,"Moorabbin Oval",-20,1974,"Regular",5,"Away","Richmond","St Kilda",20
7722,1974-05-11,"R6","Carlton",19,21,135,"Sydney",12,9,81,"Princes Park",54,1974,"Regular",6,"Home","Carlton","Sydney",54
7723,1974-05-11,"R6","Collingwood",13,11,89,"Melbourne",12,7,79,"Waverley Park",10,1974,"Regular",6,"Home","Collingwood","Melbourne",10
7724,1974-05-11,"R6","Footscray",17,12,114,"Essendon",8,16,64,"Western Oval",50,1974,"Regular",6,"Home","Footscray","Essendon",50
7725,1974-05-11,"R6","Fitzroy",18,16,124,"Hawthorn",13,16,94,"Junction Oval",30,1974,"Regular",6,"Home","Fitzroy","Hawthorn",30
7726,1974-05-11,"R6","Richmond",17,11,113,"Geelong",18,15,123,"M.C.G.",-10,1974,"Regular",6,"Away","Geelong","Richmond",10
7727,1974-05-11,"R6","North Melbourne",22,20,152,"St Kilda",9,5,59,"Arden St",93,1974,"Regular",6,"Home","North Melbourne","St Kilda",93
7728,1974-05-18,"R7","Hawthorn",13,22,100,"Carlton",8,12,60,"Princes Park",40,1974,"Regular",7,"Home","Hawthorn","Carlton",40
7729,1974-05-18,"R7","St Kilda",12,10,82,"Collingwood",11,22,88,"Moorabbin Oval",-6,1974,"Regular",7,"Away","Collingwood","St Kilda",6
7730,1974-05-18,"R7","Essendon",15,15,105,"Richmond",16,19,115,"Windy Hill",-10,1974,"Regular",7,"Away","Richmond","Essendon",10
7731,1974-05-18,"R7","Footscray",12,15,87,"Fitzroy",8,12,60,"Waverley Park",27,1974,"Regular",7,"Home","Footscray","Fitzroy",27
7732,1974-05-18,"R7","Geelong",9,5,59,"North Melbourne",13,12,90,"Kardinia Park",-31,1974,"Regular",7,"Away","North Melbourne","Geelong",31
7733,1974-05-18,"R7","Sydney",13,16,94,"Melbourne",11,10,76,"Lake Oval",18,1974,"Regular",7,"Home","Sydney","Melbourne",18
7734,1974-05-25,"R8","Carlton",9,12,66,"Footscray",9,12,66,"Princes Park",0,1974,"Regular",8,"Home","Carlton","Footscray",0
7735,1974-05-25,"R8","Collingwood",11,14,80,"Geelong",18,13,121,"Victoria Park",-41,1974,"Regular",8,"Away","Geelong","Collingwood",41
7736,1974-05-25,"R8","Fitzroy",16,11,107,"Essendon",14,15,99,"Junction Oval",8,1974,"Regular",8,"Home","Fitzroy","Essendon",8
7737,1974-05-25,"R8","Melbourne",6,15,51,"Hawthorn",13,21,99,"M.C.G.",-48,1974,"Regular",8,"Away","Hawthorn","Melbourne",48
7738,1974-05-25,"R8","North Melbourne",9,16,70,"Richmond",13,17,95,"Arden St",-25,1974,"Regular",8,"Away","Richmond","North Melbourne",25
7739,1974-05-25,"R8","Sydney",8,9,57,"St Kilda",10,10,70,"Waverley Park",-13,1974,"Regular",8,"Away","St Kilda","Sydney",13
7740,1974-06-01,"R9","Fitzroy",7,10,52,"Carlton",16,15,111,"Waverley Park",-59,1974,"Regular",9,"Away","Carlton","Fitzroy",59
7741,1974-06-01,"R9","Richmond",9,20,74,"Collingwood",21,17,143,"M.C.G.",-69,1974,"Regular",9,"Away","Collingwood","Richmond",69
7742,1974-06-01,"R9","North Melbourne",11,15,81,"Essendon",16,15,111,"Arden St",-30,1974,"Regular",9,"Away","Essendon","North Melbourne",30
7743,1974-06-01,"R9","Footscray",13,16,94,"Melbourne",8,8,56,"Western Oval",38,1974,"Regular",9,"Home","Footscray","Melbourne",38
7744,1974-06-01,"R9","Geelong",16,12,108,"Sydney",17,7,109,"Kardinia Park",-1,1974,"Regular",9,"Away","Sydney","Geelong",1
7745,1974-06-01,"R9","Hawthorn",18,15,123,"St Kilda",10,16,76,"Princes Park",47,1974,"Regular",9,"Home","Hawthorn","St Kilda",47
7746,1974-06-08,"R10","Essendon",9,14,68,"Carlton",16,7,103,"Windy Hill",-35,1974,"Regular",10,"Away","Carlton","Essendon",35
7747,1974-06-08,"R10","Collingwood",12,10,82,"North Melbourne",8,15,63,"Victoria Park",19,1974,"Regular",10,"Home","Collingwood","North Melbourne",19
7748,1974-06-08,"R10","Melbourne",19,10,124,"Fitzroy",13,15,93,"M.C.G.",31,1974,"Regular",10,"Home","Melbourne","Fitzroy",31
7749,1974-06-08,"R10","St Kilda",9,9,63,"Footscray",11,10,76,"Moorabbin Oval",-13,1974,"Regular",10,"Away","Footscray","St Kilda",13
7750,1974-06-08,"R10","Hawthorn",14,13,97,"Geelong",10,6,66,"Waverley Park",31,1974,"Regular",10,"Home","Hawthorn","Geelong",31
7751,1974-06-08,"R10","Sydney",9,13,67,"Richmond",23,9,147,"Lake Oval",-80,1974,"Regular",10,"Away","Richmond","Sydney",80
7752,1974-06-15,"R11","Carlton",20,13,133,"St Kilda",13,10,88,"Princes Park",45,1974,"Regular",11,"Home","Carlton","St Kilda",45
7753,1974-06-15,"R11","Sydney",10,13,73,"Collingwood",15,14,104,"Lake Oval",-31,1974,"Regular",11,"Away","Collingwood","Sydney",31
7754,1974-06-15,"R11","Melbourne",10,10,70,"Essendon",15,15,105,"Waverley Park",-35,1974,"Regular",11,"Away","Essendon","Melbourne",35
7755,1974-06-17,"R11","Geelong",10,15,75,"Fitzroy",10,13,73,"Kardinia Park",2,1974,"Regular",11,"Home","Geelong","Fitzroy",2
7756,1974-06-17,"R11","Richmond",19,19,133,"Footscray",15,11,101,"M.C.G.",32,1974,"Regular",11,"Home","Richmond","Footscray",32
7757,1974-06-17,"R11","North Melbourne",14,11,95,"Hawthorn",9,21,75,"Arden St",20,1974,"Regular",11,"Home","North Melbourne","Hawthorn",20
7758,1974-06-22,"R12","Melbourne",11,13,79,"Carlton",15,18,108,"M.C.G.",-29,1974,"Regular",12,"Away","Carlton","Melbourne",29
7759,1974-06-22,"R12","Essendon",13,12,90,"Collingwood",19,9,123,"Windy Hill",-33,1974,"Regular",12,"Away","Collingwood","Essendon",33
7760,1974-06-22,"R12","Fitzroy",13,14,92,"St Kilda",12,15,87,"Junction Oval",5,1974,"Regular",12,"Home","Fitzroy","St Kilda",5
7761,1974-06-22,"R12","Geelong",13,14,92,"Footscray",8,10,58,"Waverley Park",34,1974,"Regular",12,"Home","Geelong","Footscray",34
7762,1974-06-22,"R12","Hawthorn",19,17,131,"Richmond",15,18,108,"Princes Park",23,1974,"Regular",12,"Home","Hawthorn","Richmond",23
7763,1974-06-22,"R12","North Melbourne",28,17,185,"Sydney",12,7,79,"Arden St",106,1974,"Regular",12,"Home","North Melbourne","Sydney",106
7764,1974-06-29,"R13","Carlton",20,19,139,"Geelong",10,6,66,"Princes Park",73,1974,"Regular",13,"Home","Carlton","Geelong",73
7765,1974-06-29,"R13","Collingwood",13,18,96,"Hawthorn",13,12,90,"Victoria Park",6,1974,"Regular",13,"Home","Collingwood","Hawthorn",6
7766,1974-06-29,"R13","Sydney",11,16,82,"Essendon",14,12,96,"Lake Oval",-14,1974,"Regular",13,"Away","Essendon","Sydney",14
7767,1974-06-29,"R13","Richmond",29,21,195,"Fitzroy",9,12,66,"Waverley Park",129,1974,"Regular",13,"Home","Richmond","Fitzroy",129
7768,1974-06-29,"R13","Footscray",11,14,80,"North Melbourne",19,10,124,"Western Oval",-44,1974,"Regular",13,"Away","North Melbourne","Footscray",44
7769,1974-06-29,"R13","St Kilda",11,13,79,"Melbourne",13,10,88,"Moorabbin Oval",-9,1974,"Regular",13,"Away","Melbourne","St Kilda",9
7770,1974-07-06,"R14","Carlton",10,12,72,"North Melbourne",18,13,121,"Princes Park",-49,1974,"Regular",14,"Away","North Melbourne","Carlton",49
7771,1974-07-06,"R14","Collingwood",24,14,158,"Fitzroy",19,13,127,"Victoria Park",31,1974,"Regular",14,"Home","Collingwood","Fitzroy",31
7772,1974-07-06,"R14","Essendon",11,9,75,"Hawthorn",23,17,155,"Windy Hill",-80,1974,"Regular",14,"Away","Hawthorn","Essendon",80
7773,1974-07-06,"R14","Sydney",19,27,141,"Footscray",12,19,91,"Lake Oval",50,1974,"Regular",14,"Home","Sydney","Footscray",50
7774,1974-07-06,"R14","St Kilda",12,20,92,"Geelong",11,12,78,"Waverley Park",14,1974,"Regular",14,"Home","St Kilda","Geelong",14
7775,1974-07-06,"R14","Melbourne",11,24,90,"Richmond",23,15,153,"M.C.G.",-63,1974,"Regular",14,"Away","Richmond","Melbourne",63
7776,1974-07-13,"R15","Richmond",15,15,105,"Carlton",11,9,75,"M.C.G.",30,1974,"Regular",15,"Home","Richmond","Carlton",30
7777,1974-07-13,"R15","Footscray",6,10,46,"Collingwood",7,12,54,"Western Oval",-8,1974,"Regular",15,"Away","Collingwood","Footscray",8
7778,1974-07-13,"R15","St Kilda",16,13,109,"Essendon",10,8,68,"Moorabbin Oval",41,1974,"Regular",15,"Home","St Kilda","Essendon",41
7779,1974-07-13,"R15","Fitzroy",8,7,55,"North Melbourne",10,8,68,"Waverley Park",-13,1974,"Regular",15,"Away","North Melbourne","Fitzroy",13
7780,1974-07-13,"R15","Geelong",12,11,83,"Melbourne",9,9,63,"Kardinia Park",20,1974,"Regular",15,"Home","Geelong","Melbourne",20
7781,1974-07-13,"R15","Hawthorn",16,14,110,"Sydney",4,7,31,"Princes Park",79,1974,"Regular",15,"Home","Hawthorn","Sydney",79
7782,1974-07-20,"R16","Carlton",18,10,118,"Collingwood",13,4,82,"Waverley Park",36,1974,"Regular",16,"Home","Carlton","Collingwood",36
7783,1974-07-20,"R16","Geelong",11,11,77,"Essendon",14,9,93,"Kardinia Park",-16,1974,"Regular",16,"Away","Essendon","Geelong",16
7784,1974-07-20,"R16","Fitzroy",10,13,73,"Sydney",19,19,133,"Junction Oval",-60,1974,"Regular",16,"Away","Sydney","Fitzroy",60
7785,1974-07-20,"R16","Footscray",8,12,60,"Hawthorn",12,9,81,"Western Oval",-21,1974,"Regular",16,"Away","Hawthorn","Footscray",21
7786,1974-07-20,"R16","North Melbourne",19,14,128,"Melbourne",9,10,64,"Arden St",64,1974,"Regular",16,"Home","North Melbourne","Melbourne",64
7787,1974-07-20,"R16","Richmond",15,24,114,"St Kilda",11,13,79,"M.C.G.",35,1974,"Regular",16,"Home","Richmond","St Kilda",35
7788,1974-07-27,"R17","Sydney",14,17,101,"Carlton",11,14,80,"Lake Oval",21,1974,"Regular",17,"Home","Sydney","Carlton",21
7789,1974-07-27,"R17","Melbourne",15,21,111,"Collingwood",17,13,115,"M.C.G.",-4,1974,"Regular",17,"Away","Collingwood","Melbourne",4
7790,1974-07-27,"R17","Essendon",9,10,64,"Footscray",13,15,93,"Windy Hill",-29,1974,"Regular",17,"Away","Footscray","Essendon",29
7791,1974-07-27,"R17","Hawthorn",13,28,106,"Fitzroy",8,10,58,"Princes Park",48,1974,"Regular",17,"Home","Hawthorn","Fitzroy",48
7792,1974-07-27,"R17","Geelong",8,9,57,"Richmond",13,15,93,"Waverley Park",-36,1974,"Regular",17,"Away","Richmond","Geelong",36
7793,1974-07-27,"R17","St Kilda",10,13,73,"North Melbourne",11,16,82,"Moorabbin Oval",-9,1974,"Regular",17,"Away","North Melbourne","St Kilda",9
7794,1974-08-03,"R18","Carlton",14,12,96,"Hawthorn",18,12,120,"Princes Park",-24,1974,"Regular",18,"Away","Hawthorn","Carlton",24
7795,1974-08-03,"R18","Collingwood",13,10,88,"St Kilda",13,16,94,"Victoria Park",-6,1974,"Regular",18,"Away","St Kilda","Collingwood",6
7796,1974-08-03,"R18","Richmond",20,15,135,"Essendon",12,16,88,"M.C.G.",47,1974,"Regular",18,"Home","Richmond","Essendon",47
7797,1974-08-03,"R18","Fitzroy",9,16,70,"Footscray",14,9,93,"Junction Oval",-23,1974,"Regular",18,"Away","Footscray","Fitzroy",23
7798,1974-08-03,"R18","North Melbourne",15,9,99,"Geelong",15,15,105,"Arden St",-6,1974,"Regular",18,"Away","Geelong","North Melbourne",6
7799,1974-08-03,"R18","Melbourne",11,17,83,"Sydney",14,13,97,"Waverley Park",-14,1974,"Regular",18,"Away","Sydney","Melbourne",14
7800,1974-08-10,"R19","Footscray",10,8,68,"Carlton",4,20,44,"Western Oval",24,1974,"Regular",19,"Home","Footscray","Carlton",24
7801,1974-08-10,"R19","Geelong",8,8,56,"Collingwood",10,19,79,"Kardinia Park",-23,1974,"Regular",19,"Away","Collingwood","Geelong",23
7802,1974-08-10,"R19","Essendon",24,15,159,"Fitzroy",8,13,61,"Windy Hill",98,1974,"Regular",19,"Home","Essendon","Fitzroy",98
7803,1974-08-10,"R19","Hawthorn",17,20,122,"Melbourne",14,13,97,"Princes Park",25,1974,"Regular",19,"Home","Hawthorn","Melbourne",25
7804,1974-08-10,"R19","Richmond",15,12,102,"North Melbourne",11,11,77,"Waverley Park",25,1974,"Regular",19,"Home","Richmond","North Melbourne",25
7805,1974-08-10,"R19","St Kilda",9,13,67,"Sydney",13,15,93,"Moorabbin Oval",-26,1974,"Regular",19,"Away","Sydney","St Kilda",26
7806,1974-08-17,"R20","Carlton",17,14,116,"Fitzroy",10,15,75,"Princes Park",41,1974,"Regular",20,"Home","Carlton","Fitzroy",41
7807,1974-08-17,"R20","Collingwood",10,20,80,"Richmond",16,11,107,"Victoria Park",-27,1974,"Regular",20,"Away","Richmond","Collingwood",27
7808,1974-08-17,"R20","Essendon",14,14,98,"North Melbourne",16,12,108,"Windy Hill",-10,1974,"Regular",20,"Away","North Melbourne","Essendon",10
7809,1974-08-17,"R20","Melbourne",10,15,75,"Footscray",23,21,159,"M.C.G.",-84,1974,"Regular",20,"Away","Footscray","Melbourne",84
7810,1974-08-17,"R20","Sydney",13,7,85,"Geelong",12,14,86,"Lake Oval",-1,1974,"Regular",20,"Away","Geelong","Sydney",1
7811,1974-08-17,"R20","St Kilda",11,9,75,"Hawthorn",16,12,108,"Waverley Park",-33,1974,"Regular",20,"Away","Hawthorn","St Kilda",33
7812,1974-08-24,"R21","Carlton",12,11,83,"Essendon",12,17,89,"Waverley Park",-6,1974,"Regular",21,"Away","Essendon","Carlton",6
7813,1974-08-24,"R21","North Melbourne",25,15,165,"Collingwood",10,14,74,"Arden St",91,1974,"Regular",21,"Home","North Melbourne","Collingwood",91
7814,1974-08-24,"R21","Fitzroy",14,16,100,"Melbourne",20,13,133,"Junction Oval",-33,1974,"Regular",21,"Away","Melbourne","Fitzroy",33
7815,1974-08-24,"R21","Footscray",7,19,61,"St Kilda",7,15,57,"Western Oval",4,1974,"Regular",21,"Home","Footscray","St Kilda",4
7816,1974-08-24,"R21","Geelong",15,12,102,"Hawthorn",9,8,62,"Kardinia Park",40,1974,"Regular",21,"Home","Geelong","Hawthorn",40
7817,1974-08-24,"R21","Richmond",23,24,162,"Sydney",17,27,129,"M.C.G.",33,1974,"Regular",21,"Home","Richmond","Sydney",33
7818,1974-08-31,"R22","St Kilda",15,11,101,"Carlton",19,9,123,"Moorabbin Oval",-22,1974,"Regular",22,"Away","Carlton","St Kilda",22
7819,1974-08-31,"R22","Collingwood",13,15,93,"Sydney",15,10,100,"Waverley Park",-7,1974,"Regular",22,"Away","Sydney","Collingwood",7
7820,1974-08-31,"R22","Essendon",20,17,137,"Melbourne",15,13,103,"Windy Hill",34,1974,"Regular",22,"Home","Essendon","Melbourne",34
7821,1974-08-31,"R22","Fitzroy",15,11,101,"Geelong",17,11,113,"Junction Oval",-12,1974,"Regular",22,"Away","Geelong","Fitzroy",12
7822,1974-08-31,"R22","Footscray",13,9,87,"Richmond",11,14,80,"Western Oval",7,1974,"Regular",22,"Home","Footscray","Richmond",7
7823,1974-08-31,"R22","Hawthorn",10,17,77,"North Melbourne",16,10,106,"Princes Park",-29,1974,"Regular",22,"Away","North Melbourne","Hawthorn",29
7824,1974-09-07,"EF","Collingwood",19,10,124,"Footscray",6,19,55,"Waverley Park",69,1974,"Finals",23,"Home","Collingwood","Footscray",69
7825,1974-09-07,"QF","North Melbourne",15,13,103,"Hawthorn",8,17,65,"M.C.G.",38,1974,"Finals",23,"Home","North Melbourne","Hawthorn",38
7826,1974-09-14,"SF","Hawthorn",21,12,138,"Collingwood",13,10,88,"M.C.G.",50,1974,"Finals",24,"Home","Hawthorn","Collingwood",50
7827,1974-09-14,"SF","Richmond",10,13,73,"North Melbourne",6,16,52,"Waverley Park",21,1974,"Finals",24,"Home","Richmond","North Melbourne",21
7828,1974-09-21,"PF","North Melbourne",8,8,56,"Hawthorn",7,9,51,"M.C.G.",5,1974,"Finals",25,"Home","North Melbourne","Hawthorn",5
7829,1974-09-28,"GF","Richmond",18,20,128,"North Melbourne",13,9,87,"M.C.G.",41,1974,"Finals",26,"Home","Richmond","North Melbourne",41
7830,1975-04-05,"R1","Geelong",8,14,62,"Carlton",13,16,94,"Kardinia Park",-32,1975,"Regular",1,"Away","Carlton","Geelong",32
7831,1975-04-05,"R1","Collingwood",12,19,91,"Sydney",8,7,55,"Victoria Park",36,1975,"Regular",1,"Home","Collingwood","Sydney",36
7832,1975-04-05,"R1","Essendon",21,10,136,"St Kilda",9,13,67,"Windy Hill",69,1975,"Regular",1,"Home","Essendon","St Kilda",69
7833,1975-04-05,"R1","Fitzroy",14,14,98,"Richmond",15,13,103,"Junction Oval",-5,1975,"Regular",1,"Away","Richmond","Fitzroy",5
7834,1975-04-05,"R1","Melbourne",17,9,111,"Footscray",15,10,100,"M.C.G.",11,1975,"Regular",1,"Home","Melbourne","Footscray",11
7835,1975-04-05,"R1","Hawthorn",15,15,105,"North Melbourne",11,10,76,"Princes Park",29,1975,"Regular",1,"Home","Hawthorn","North Melbourne",29
7836,1975-04-12,"R2","Carlton",27,10,172,"Collingwood",10,19,79,"Princes Park",93,1975,"Regular",2,"Home","Carlton","Collingwood",93
7837,1975-04-12,"R2","Sydney",15,12,102,"Essendon",19,17,131,"Lake Oval",-29,1975,"Regular",2,"Away","Essendon","Sydney",29
7838,1975-04-12,"R2","Footscray",17,14,116,"Fitzroy",11,17,83,"Western Oval",33,1975,"Regular",2,"Home","Footscray","Fitzroy",33
7839,1975-04-12,"R2","Richmond",15,22,112,"Geelong",10,12,72,"M.C.G.",40,1975,"Regular",2,"Home","Richmond","Geelong",40
7840,1975-04-12,"R2","St Kilda",11,15,81,"Hawthorn",17,19,121,"Moorabbin Oval",-40,1975,"Regular",2,"Away","Hawthorn","St Kilda",40
7841,1975-04-12,"R2","North Melbourne",15,13,103,"Melbourne",16,9,105,"Arden St",-2,1975,"Regular",2,"Away","Melbourne","North Melbourne",2
7842,1975-04-19,"R3","Carlton",14,18,102,"North Melbourne",9,12,66,"Princes Park",36,1975,"Regular",3,"Home","Carlton","North Melbourne",36
7843,1975-04-19,"R3","Fitzroy",12,13,85,"Collingwood",12,15,87,"Junction Oval",-2,1975,"Regular",3,"Away","Collingwood","Fitzroy",2
7844,1975-04-19,"R3","Essendon",16,21,117,"Melbourne",15,10,100,"Windy Hill",17,1975,"Regular",3,"Home","Essendon","Melbourne",17
7845,1975-04-19,"R3","Geelong",13,12,90,"Footscray",14,14,98,"Kardinia Park",-8,1975,"Regular",3,"Away","Footscray","Geelong",8
7846,1975-04-19,"R3","Richmond",12,15,87,"Hawthorn",17,14,116,"Waverley Park",-29,1975,"Regular",3,"Away","Hawthorn","Richmond",29
7847,1975-04-19,"R3","St Kilda",11,21,87,"Sydney",9,17,71,"Moorabbin Oval",16,1975,"Regular",3,"Home","St Kilda","Sydney",16
7848,1975-04-25,"R4","Carlton",12,15,87,"Essendon",16,8,104,"Waverley Park",-17,1975,"Regular",4,"Away","Essendon","Carlton",17
7849,1975-04-25,"R4","Melbourne",12,8,80,"St Kilda",18,25,133,"M.C.G.",-53,1975,"Regular",4,"Away","St Kilda","Melbourne",53
7850,1975-04-26,"R4","Collingwood",17,10,112,"Geelong",14,15,99,"Victoria Park",13,1975,"Regular",4,"Home","Collingwood","Geelong",13
7851,1975-04-26,"R4","North Melbourne",11,19,85,"Fitzroy",17,13,115,"Arden St",-30,1975,"Regular",4,"Away","Fitzroy","North Melbourne",30
7852,1975-04-26,"R4","Footscray",16,13,109,"Richmond",4,19,43,"Western Oval",66,1975,"Regular",4,"Home","Footscray","Richmond",66
7853,1975-04-26,"R4","Sydney",9,15,69,"Hawthorn",13,21,99,"Lake Oval",-30,1975,"Regular",4,"Away","Hawthorn","Sydney",30
7854,1975-05-03,"R5","St Kilda",7,16,58,"Carlton",12,19,91,"Moorabbin Oval",-33,1975,"Regular",5,"Away","Carlton","St Kilda",33
7855,1975-05-03,"R5","Footscray",12,9,81,"Collingwood",9,16,70,"Waverley Park",11,1975,"Regular",5,"Home","Footscray","Collingwood",11
7856,1975-05-03,"R5","Fitzroy",19,11,125,"Essendon",15,17,107,"Junction Oval",18,1975,"Regular",5,"Home","Fitzroy","Essendon",18
7857,1975-05-03,"R5","Geelong",11,5,71,"North Melbourne",12,15,87,"Kardinia Park",-16,1975,"Regular",5,"Away","North Melbourne","Geelong",16
7858,1975-05-03,"R5","Hawthorn",19,22,136,"Melbourne",11,15,81,"Princes Park",55,1975,"Regular",5,"Home","Hawthorn","Melbourne",55
7859,1975-05-03,"R5","Richmond",19,23,137,"Sydney",12,14,86,"M.C.G.",51,1975,"Regular",5,"Home","Richmond","Sydney",51
7860,1975-05-10,"R6","Carlton",16,15,111,"Hawthorn",12,13,85,"Princes Park",26,1975,"Regular",6,"Home","Carlton","Hawthorn",26
7861,1975-05-10,"R6","Collingwood",14,12,96,"Richmond",22,14,146,"Victoria Park",-50,1975,"Regular",6,"Away","Richmond","Collingwood",50
7862,1975-05-10,"R6","Essendon",12,21,93,"Geelong",15,14,104,"Windy Hill",-11,1975,"Regular",6,"Away","Geelong","Essendon",11
7863,1975-05-10,"R6","Fitzroy",9,20,74,"St Kilda",11,16,82,"Waverley Park",-8,1975,"Regular",6,"Away","St Kilda","Fitzroy",8
7864,1975-05-10,"R6","North Melbourne",18,11,119,"Footscray",9,12,66,"Arden St",53,1975,"Regular",6,"Home","North Melbourne","Footscray",53
7865,1975-05-10,"R6","Melbourne",22,23,155,"Sydney",13,12,90,"M.C.G.",65,1975,"Regular",6,"Home","Melbourne","Sydney",65
7866,1975-05-17,"R7","Sydney",11,11,77,"Carlton",19,14,128,"Lake Oval",-51,1975,"Regular",7,"Away","Carlton","Sydney",51
7867,1975-05-17,"R7","Collingwood",12,18,90,"North Melbourne",12,9,81,"Waverley Park",9,1975,"Regular",7,"Home","Collingwood","North Melbourne",9
7868,1975-05-17,"R7","Footscray",8,12,60,"Essendon",14,17,101,"Western Oval",-41,1975,"Regular",7,"Away","Essendon","Footscray",41
7869,1975-05-17,"R7","Hawthorn",19,16,130,"Fitzroy",13,12,90,"Princes Park",40,1975,"Regular",7,"Home","Hawthorn","Fitzroy",40
7870,1975-05-17,"R7","Geelong",13,10,88,"St Kilda",11,14,80,"Kardinia Park",8,1975,"Regular",7,"Home","Geelong","St Kilda",8
7871,1975-05-17,"R7","Richmond",19,18,132,"Melbourne",10,18,78,"M.C.G.",54,1975,"Regular",7,"Home","Richmond","Melbourne",54
7872,1975-05-24,"R8","Carlton",16,14,110,"Melbourne",11,15,81,"Princes Park",29,1975,"Regular",8,"Home","Carlton","Melbourne",29
7873,1975-05-24,"R8","Essendon",7,13,55,"Collingwood",12,9,81,"Windy Hill",-26,1975,"Regular",8,"Away","Collingwood","Essendon",26
7874,1975-05-24,"R8","Fitzroy",13,13,91,"Sydney",11,12,78,"Junction Oval",13,1975,"Regular",8,"Home","Fitzroy","Sydney",13
7875,1975-05-24,"R8","St Kilda",7,23,65,"Footscray",7,12,54,"Moorabbin Oval",11,1975,"Regular",8,"Home","St Kilda","Footscray",11
7876,1975-05-24,"R8","Geelong",5,10,40,"Hawthorn",17,11,113,"Waverley Park",-73,1975,"Regular",8,"Away","Hawthorn","Geelong",73
7877,1975-05-24,"R8","North Melbourne",11,8,74,"Richmond",9,12,66,"Arden St",8,1975,"Regular",8,"Home","North Melbourne","Richmond",8
7878,1975-05-31,"R9","Carlton",16,19,115,"Richmond",9,13,67,"Princes Park",48,1975,"Regular",9,"Home","Carlton","Richmond",48
7879,1975-05-31,"R9","Collingwood",15,8,98,"St Kilda",13,11,89,"Victoria Park",9,1975,"Regular",9,"Home","Collingwood","St Kilda",9
7880,1975-05-31,"R9","North Melbourne",11,17,83,"Essendon",15,8,98,"Waverley Park",-15,1975,"Regular",9,"Away","Essendon","North Melbourne",15
7881,1975-05-31,"R9","Melbourne",18,15,123,"Fitzroy",17,10,112,"M.C.G.",11,1975,"Regular",9,"Home","Melbourne","Fitzroy",11
7882,1975-05-31,"R9","Footscray",8,10,58,"Hawthorn",20,14,134,"Western Oval",-76,1975,"Regular",9,"Away","Hawthorn","Footscray",76
7883,1975-05-31,"R9","Sydney",11,26,92,"Geelong",7,13,55,"Lake Oval",37,1975,"Regular",9,"Home","Sydney","Geelong",37
7884,1975-06-07,"R10","Fitzroy",15,7,97,"Carlton",16,10,106,"Junction Oval",-9,1975,"Regular",10,"Away","Carlton","Fitzroy",9
7885,1975-06-07,"R10","Hawthorn",19,24,138,"Collingwood",13,11,89,"Princes Park",49,1975,"Regular",10,"Home","Hawthorn","Collingwood",49
7886,1975-06-07,"R10","Richmond",19,14,128,"Essendon",12,9,81,"M.C.G.",47,1975,"Regular",10,"Home","Richmond","Essendon",47
7887,1975-06-07,"R10","Footscray",13,11,89,"Sydney",12,15,87,"Waverley Park",2,1975,"Regular",10,"Home","Footscray","Sydney",2
7888,1975-06-07,"R10","Geelong",14,20,104,"Melbourne",14,14,98,"Kardinia Park",6,1975,"Regular",10,"Home","Geelong","Melbourne",6
7889,1975-06-07,"R10","St Kilda",15,9,99,"North Melbourne",17,19,121,"Moorabbin Oval",-22,1975,"Regular",10,"Away","North Melbourne","St Kilda",22
7890,1975-06-16,"R11","Carlton",19,13,127,"Footscray",17,13,115,"Princes Park",12,1975,"Regular",11,"Home","Carlton","Footscray",12
7891,1975-06-16,"R11","Melbourne",14,11,95,"Collingwood",9,19,73,"M.C.G.",22,1975,"Regular",11,"Home","Melbourne","Collingwood",22
7892,1975-06-16,"R11","Essendon",13,12,90,"Hawthorn",21,20,146,"Windy Hill",-56,1975,"Regular",11,"Away","Hawthorn","Essendon",56
7893,1975-06-16,"R11","Geelong",13,19,97,"Fitzroy",14,11,95,"Kardinia Park",2,1975,"Regular",11,"Home","Geelong","Fitzroy",2
7894,1975-06-16,"R11","Sydney",12,16,88,"North Melbourne",16,12,108,"Lake Oval",-20,1975,"Regular",11,"Away","North Melbourne","Sydney",20
7895,1975-06-16,"R11","St Kilda",14,18,102,"Richmond",13,12,90,"Waverley Park",12,1975,"Regular",11,"Home","St Kilda","Richmond",12
7896,1975-06-21,"R12","Carlton",23,19,157,"Geelong",12,14,86,"Princes Park",71,1975,"Regular",12,"Home","Carlton","Geelong",71
7897,1975-06-21,"R12","Sydney",11,11,77,"Collingwood",12,13,85,"Waverley Park",-8,1975,"Regular",12,"Away","Collingwood","Sydney",8
7898,1975-06-21,"R12","St Kilda",21,15,141,"Essendon",11,7,73,"Moorabbin Oval",68,1975,"Regular",12,"Home","St Kilda","Essendon",68
7899,1975-06-21,"R12","Richmond",13,18,96,"Fitzroy",13,20,98,"M.C.G.",-2,1975,"Regular",12,"Away","Fitzroy","Richmond",2
7900,1975-06-21,"R12","Footscray",20,11,131,"Melbourne",14,8,92,"Western Oval",39,1975,"Regular",12,"Home","Footscray","Melbourne",39
7901,1975-06-21,"R12","North Melbourne",13,17,95,"Hawthorn",18,12,120,"Arden St",-25,1975,"Regular",12,"Away","Hawthorn","North Melbourne",25
7902,1975-06-28,"R13","Collingwood",9,12,66,"Carlton",12,10,82,"Victoria Park",-16,1975,"Regular",13,"Away","Carlton","Collingwood",16
7903,1975-06-28,"R13","Essendon",19,18,132,"Sydney",17,12,114,"Windy Hill",18,1975,"Regular",13,"Home","Essendon","Sydney",18
7904,1975-06-28,"R13","Fitzroy",11,10,76,"Footscray",12,17,89,"Junction Oval",-13,1975,"Regular",13,"Away","Footscray","Fitzroy",13
7905,1975-06-28,"R13","Geelong",8,13,61,"Richmond",13,14,92,"Kardinia Park",-31,1975,"Regular",13,"Away","Richmond","Geelong",31
7906,1975-06-28,"R13","Hawthorn",11,19,85,"St Kilda",7,19,61,"Princes Park",24,1975,"Regular",13,"Home","Hawthorn","St Kilda",24
7907,1975-06-28,"R13","Melbourne",6,10,46,"North Melbourne",11,14,80,"Waverley Park",-34,1975,"Regular",13,"Away","North Melbourne","Melbourne",34
7908,1975-07-05,"R14","Essendon",15,5,95,"Carlton",27,13,175,"Windy Hill",-80,1975,"Regular",14,"Away","Carlton","Essendon",80
7909,1975-07-05,"R14","Geelong",14,12,96,"Collingwood",9,11,65,"Kardinia Park",31,1975,"Regular",14,"Home","Geelong","Collingwood",31
7910,1975-07-05,"R14","Fitzroy",14,12,96,"North Melbourne",15,15,105,"Junction Oval",-9,1975,"Regular",14,"Away","North Melbourne","Fitzroy",9
7911,1975-07-05,"R14","Richmond",17,18,120,"Footscray",12,10,82,"M.C.G.",38,1975,"Regular",14,"Home","Richmond","Footscray",38
7912,1975-07-05,"R14","Hawthorn",9,10,64,"Sydney",5,9,39,"Waverley Park",25,1975,"Regular",14,"Home","Hawthorn","Sydney",25
7913,1975-07-05,"R14","St Kilda",15,11,101,"Melbourne",6,13,49,"Moorabbin Oval",52,1975,"Regular",14,"Home","St Kilda","Melbourne",52
7914,1975-07-12,"R15","North Melbourne",9,11,65,"Carlton",5,14,44,"Waverley Park",21,1975,"Regular",15,"Home","North Melbourne","Carlton",21
7915,1975-07-12,"R15","Collingwood",16,19,115,"Fitzroy",11,7,73,"Victoria Park",42,1975,"Regular",15,"Home","Collingwood","Fitzroy",42
7916,1975-07-12,"R15","Melbourne",19,20,134,"Essendon",16,13,109,"M.C.G.",25,1975,"Regular",15,"Home","Melbourne","Essendon",25
7917,1975-07-12,"R15","Footscray",13,15,93,"Geelong",7,7,49,"Western Oval",44,1975,"Regular",15,"Home","Footscray","Geelong",44
7918,1975-07-12,"R15","Hawthorn",14,10,94,"Richmond",2,20,32,"Princes Park",62,1975,"Regular",15,"Home","Hawthorn","Richmond",62
7919,1975-07-12,"R15","Sydney",10,10,70,"St Kilda",19,16,130,"Lake Oval",-60,1975,"Regular",15,"Away","St Kilda","Sydney",60
7920,1975-07-19,"R16","Carlton",11,22,88,"St Kilda",8,27,75,"Princes Park",13,1975,"Regular",16,"Home","Carlton","St Kilda",13
7921,1975-07-19,"R16","Collingwood",16,14,110,"Footscray",16,7,103,"Victoria Park",7,1975,"Regular",16,"Home","Collingwood","Footscray",7
7922,1975-07-19,"R16","Essendon",11,11,77,"Fitzroy",16,19,115,"Waverley Park",-38,1975,"Regular",16,"Away","Fitzroy","Essendon",38
7923,1975-07-19,"R16","North Melbourne",14,25,109,"Geelong",6,19,55,"Arden St",54,1975,"Regular",16,"Home","North Melbourne","Geelong",54
7924,1975-07-19,"R16","Melbourne",15,17,107,"Hawthorn",17,17,119,"M.C.G.",-12,1975,"Regular",16,"Away","Hawthorn","Melbourne",12
7925,1975-07-19,"R16","Sydney",8,12,60,"Richmond",26,11,167,"Lake Oval",-107,1975,"Regular",16,"Away","Richmond","Sydney",107
7926,1975-07-26,"R17","Hawthorn",15,15,105,"Carlton",15,11,101,"Princes Park",4,1975,"Regular",17,"Home","Hawthorn","Carlton",4
7927,1975-07-26,"R17","Richmond",16,19,115,"Collingwood",10,9,69,"M.C.G.",46,1975,"Regular",17,"Home","Richmond","Collingwood",46
7928,1975-07-26,"R17","Geelong",13,16,94,"Essendon",16,13,109,"Kardinia Park",-15,1975,"Regular",17,"Away","Essendon","Geelong",15
7929,1975-07-26,"R17","St Kilda",12,15,87,"Fitzroy",7,14,56,"Moorabbin Oval",31,1975,"Regular",17,"Home","St Kilda","Fitzroy",31
7930,1975-07-26,"R17","Footscray",9,14,68,"North Melbourne",17,15,117,"Western Oval",-49,1975,"Regular",17,"Away","North Melbourne","Footscray",49
7931,1975-07-26,"R17","Sydney",11,9,75,"Melbourne",13,13,91,"Waverley Park",-16,1975,"Regular",17,"Away","Melbourne","Sydney",16
7932,1975-08-02,"R18","Carlton",19,17,131,"Sydney",15,13,103,"Princes Park",28,1975,"Regular",18,"Home","Carlton","Sydney",28
7933,1975-08-02,"R18","North Melbourne",15,20,110,"Collingwood",8,10,58,"Arden St",52,1975,"Regular",18,"Home","North Melbourne","Collingwood",52
7934,1975-08-02,"R18","Essendon",11,17,83,"Footscray",19,13,127,"Windy Hill",-44,1975,"Regular",18,"Away","Footscray","Essendon",44
7935,1975-08-02,"R18","Fitzroy",15,23,113,"Hawthorn",10,19,79,"Junction Oval",34,1975,"Regular",18,"Home","Fitzroy","Hawthorn",34
7936,1975-08-02,"R18","St Kilda",11,18,84,"Geelong",11,14,80,"Waverley Park",4,1975,"Regular",18,"Home","St Kilda","Geelong",4
7937,1975-08-02,"R18","Melbourne",19,13,127,"Richmond",12,18,90,"M.C.G.",37,1975,"Regular",18,"Home","Melbourne","Richmond",37
7938,1975-08-09,"R19","Melbourne",11,23,89,"Carlton",7,9,51,"Waverley Park",38,1975,"Regular",19,"Home","Melbourne","Carlton",38
7939,1975-08-09,"R19","Collingwood",20,18,138,"Essendon",15,9,99,"Victoria Park",39,1975,"Regular",19,"Home","Collingwood","Essendon",39
7940,1975-08-09,"R19","Sydney",13,20,98,"Fitzroy",16,19,115,"Lake Oval",-17,1975,"Regular",19,"Away","Fitzroy","Sydney",17
7941,1975-08-09,"R19","Footscray",5,16,46,"St Kilda",16,18,114,"Western Oval",-68,1975,"Regular",19,"Away","St Kilda","Footscray",68
7942,1975-08-09,"R19","Hawthorn",25,23,173,"Geelong",8,7,55,"Princes Park",118,1975,"Regular",19,"Home","Hawthorn","Geelong",118
7943,1975-08-09,"R19","Richmond",13,18,96,"North Melbourne",13,23,101,"M.C.G.",-5,1975,"Regular",19,"Away","North Melbourne","Richmond",5
7944,1975-08-16,"R20","Richmond",13,20,98,"Carlton",14,11,95,"M.C.G.",3,1975,"Regular",20,"Home","Richmond","Carlton",3
7945,1975-08-16,"R20","St Kilda",20,17,137,"Collingwood",24,12,156,"Moorabbin Oval",-19,1975,"Regular",20,"Away","Collingwood","St Kilda",19
7946,1975-08-16,"R20","Essendon",15,15,105,"North Melbourne",13,13,91,"Windy Hill",14,1975,"Regular",20,"Home","Essendon","North Melbourne",14
7947,1975-08-16,"R20","Fitzroy",13,22,100,"Melbourne",13,11,89,"Junction Oval",11,1975,"Regular",20,"Home","Fitzroy","Melbourne",11
7948,1975-08-16,"R20","Hawthorn",13,13,91,"Footscray",14,9,93,"Waverley Park",-2,1975,"Regular",20,"Away","Footscray","Hawthorn",2
7949,1975-08-16,"R20","Geelong",12,16,88,"Sydney",15,15,105,"Kardinia Park",-17,1975,"Regular",20,"Away","Sydney","Geelong",17
7950,1975-08-23,"R21","Carlton",10,14,74,"Fitzroy",11,13,79,"Princes Park",-5,1975,"Regular",21,"Away","Fitzroy","Carlton",5
7951,1975-08-23,"R21","Collingwood",7,15,57,"Hawthorn",3,9,27,"Victoria Park",30,1975,"Regular",21,"Home","Collingwood","Hawthorn",30
7952,1975-08-23,"R21","Essendon",17,15,117,"Richmond",20,16,136,"Waverley Park",-19,1975,"Regular",21,"Away","Richmond","Essendon",19
7953,1975-08-23,"R21","Sydney",10,15,75,"Footscray",18,7,115,"Lake Oval",-40,1975,"Regular",21,"Away","Footscray","Sydney",40
7954,1975-08-23,"R21","Melbourne",8,16,64,"Geelong",10,10,70,"M.C.G.",-6,1975,"Regular",21,"Away","Geelong","Melbourne",6
7955,1975-08-23,"R21","North Melbourne",16,15,111,"St Kilda",6,5,41,"Arden St",70,1975,"Regular",21,"Home","North Melbourne","St Kilda",70
7956,1975-08-30,"R22","Footscray",10,15,75,"Carlton",18,11,119,"Western Oval",-44,1975,"Regular",22,"Away","Carlton","Footscray",44
7957,1975-08-30,"R22","Collingwood",14,14,98,"Melbourne",15,7,97,"Victoria Park",1,1975,"Regular",22,"Home","Collingwood","Melbourne",1
7958,1975-08-30,"R22","Hawthorn",14,19,103,"Essendon",17,8,110,"Princes Park",-7,1975,"Regular",22,"Away","Essendon","Hawthorn",7
7959,1975-08-30,"R22","Fitzroy",14,9,93,"Geelong",18,11,119,"Waverley Park",-26,1975,"Regular",22,"Away","Geelong","Fitzroy",26
7960,1975-08-30,"R22","North Melbourne",15,19,109,"Sydney",12,15,87,"Arden St",22,1975,"Regular",22,"Home","North Melbourne","Sydney",22
7961,1975-08-30,"R22","Richmond",17,14,116,"St Kilda",8,20,68,"M.C.G.",48,1975,"Regular",22,"Home","Richmond","St Kilda",48
7962,1975-09-06,"QF","Carlton",12,4,76,"North Melbourne",14,12,96,"M.C.G.",-20,1975,"Finals",23,"Away","North Melbourne","Carlton",20
7963,1975-09-06,"EF","Richmond",11,11,77,"Collingwood",10,13,73,"Waverley Park",4,1975,"Finals",23,"Home","Richmond","Collingwood",4
7964,1975-09-13,"SF","Carlton",9,8,62,"Richmond",9,17,71,"M.C.G.",-9,1975,"Finals",24,"Away","Richmond","Carlton",9
7965,1975-09-13,"SF","Hawthorn",12,10,82,"North Melbourne",10,11,71,"Waverley Park",11,1975,"Finals",24,"Home","Hawthorn","North Melbourne",11
7966,1975-09-20,"PF","North Melbourne",10,16,76,"Richmond",8,11,59,"Waverley Park",17,1975,"Finals",25,"Home","North Melbourne","Richmond",17
7967,1975-09-27,"GF","Hawthorn",9,13,67,"North Melbourne",19,8,122,"M.C.G.",-55,1975,"Finals",26,"Away","North Melbourne","Hawthorn",55
7968,1976-04-03,"R1","Carlton",18,22,130,"Collingwood",10,13,73,"Princes Park",57,1976,"Regular",1,"Home","Carlton","Collingwood",57
7969,1976-04-03,"R1","Footscray",16,16,112,"Essendon",16,17,113,"Western Oval",-1,1976,"Regular",1,"Away","Essendon","Footscray",1
7970,1976-04-03,"R1","Richmond",16,21,117,"Fitzroy",14,14,98,"M.C.G.",19,1976,"Regular",1,"Home","Richmond","Fitzroy",19
7971,1976-04-03,"R1","Sydney",23,15,153,"Geelong",25,7,157,"Lake Oval",-4,1976,"Regular",1,"Away","Geelong","Sydney",4
7972,1976-04-03,"R1","St Kilda",13,11,89,"Hawthorn",16,15,111,"Moorabbin Oval",-22,1976,"Regular",1,"Away","Hawthorn","St Kilda",22
7973,1976-04-03,"R1","North Melbourne",9,10,64,"Melbourne",11,21,87,"Arden St",-23,1976,"Regular",1,"Away","Melbourne","North Melbourne",23
7974,1976-04-10,"R2","Essendon",12,16,88,"Carlton",14,16,100,"Windy Hill",-12,1976,"Regular",2,"Away","Carlton","Essendon",12
7975,1976-04-10,"R2","Collingwood",16,27,123,"Sydney",20,14,134,"Victoria Park",-11,1976,"Regular",2,"Away","Sydney","Collingwood",11
7976,1976-04-10,"R2","Fitzroy",14,17,101,"St Kilda",15,15,105,"Junction Oval",-4,1976,"Regular",2,"Away","St Kilda","Fitzroy",4
7977,1976-04-10,"R2","Melbourne",16,9,105,"Footscray",23,15,153,"M.C.G.",-48,1976,"Regular",2,"Away","Footscray","Melbourne",48
7978,1976-04-10,"R2","Geelong",22,11,143,"Richmond",14,11,95,"Kardinia Park",48,1976,"Regular",2,"Home","Geelong","Richmond",48
7979,1976-04-10,"R2","Hawthorn",20,11,131,"North Melbourne",16,13,109,"Princes Park",22,1976,"Regular",2,"Home","Hawthorn","North Melbourne",22
7980,1976-04-17,"R3","Fitzroy",6,12,48,"Carlton",14,13,97,"Waverley Park",-49,1976,"Regular",3,"Away","Carlton","Fitzroy",49
7981,1976-04-17,"R3","Hawthorn",25,22,172,"Collingwood",12,12,84,"Princes Park",88,1976,"Regular",3,"Home","Hawthorn","Collingwood",88
7982,1976-04-17,"R3","Footscray",20,14,134,"Sydney",14,11,95,"Western Oval",39,1976,"Regular",3,"Home","Footscray","Sydney",39
7983,1976-04-19,"R3","Essendon",15,8,98,"Melbourne",20,13,133,"Windy Hill",-35,1976,"Regular",3,"Away","Melbourne","Essendon",35
7984,1976-04-19,"R3","St Kilda",16,10,106,"Geelong",12,14,86,"Moorabbin Oval",20,1976,"Regular",3,"Home","St Kilda","Geelong",20
7985,1976-04-19,"R3","Richmond",14,18,102,"North Melbourne",12,11,83,"M.C.G.",19,1976,"Regular",3,"Home","Richmond","North Melbourne",19
7986,1976-04-24,"R4","Melbourne",17,12,114,"Carlton",24,13,157,"M.C.G.",-43,1976,"Regular",4,"Away","Carlton","Melbourne",43
7987,1976-04-24,"R4","Collingwood",16,18,114,"Richmond",15,9,99,"Victoria Park",15,1976,"Regular",4,"Home","Collingwood","Richmond",15
7988,1976-04-24,"R4","Sydney",22,11,143,"Essendon",16,13,109,"Lake Oval",34,1976,"Regular",4,"Home","Sydney","Essendon",34
7989,1976-04-24,"R4","Geelong",19,12,126,"Fitzroy",13,13,91,"Kardinia Park",35,1976,"Regular",4,"Home","Geelong","Fitzroy",35
7990,1976-04-24,"R4","Hawthorn",14,20,104,"Footscray",14,8,92,"Waverley Park",12,1976,"Regular",4,"Home","Hawthorn","Footscray",12
7991,1976-04-24,"R4","North Melbourne",17,15,117,"St Kilda",14,12,96,"Arden St",21,1976,"Regular",4,"Home","North Melbourne","St Kilda",21
7992,1976-05-01,"R5","Carlton",8,19,67,"Sydney",9,12,66,"Princes Park",1,1976,"Regular",5,"Home","Carlton","Sydney",1
7993,1976-05-01,"R5","St Kilda",19,19,133,"Collingwood",16,6,102,"Moorabbin Oval",31,1976,"Regular",5,"Home","St Kilda","Collingwood",31
7994,1976-05-01,"R5","Essendon",10,15,75,"Hawthorn",14,10,94,"Windy Hill",-19,1976,"Regular",5,"Away","Hawthorn","Essendon",19
7995,1976-05-01,"R5","Fitzroy",15,13,103,"Melbourne",17,13,115,"Junction Oval",-12,1976,"Regular",5,"Away","Melbourne","Fitzroy",12
7996,1976-05-01,"R5","Richmond",12,17,89,"Footscray",15,20,110,"M.C.G.",-21,1976,"Regular",5,"Away","Footscray","Richmond",21
7997,1976-05-01,"R5","Geelong",15,6,96,"North Melbourne",13,12,90,"Waverley Park",6,1976,"Regular",5,"Home","Geelong","North Melbourne",6
7998,1976-05-08,"R6","Hawthorn",7,20,62,"Carlton",15,12,102,"Princes Park",-40,1976,"Regular",6,"Away","Carlton","Hawthorn",40
7999,1976-05-08,"R6","Collingwood",14,13,97,"Geelong",15,13,103,"Victoria Park",-6,1976,"Regular",6,"Away","Geelong","Collingwood",6
8000,1976-05-08,"R6","Richmond",17,17,119,"Essendon",9,10,64,"Waverley Park",55,1976,"Regular",6,"Home","Richmond","Essendon",55
8001,1976-05-08,"R6","North Melbourne",19,21,135,"Fitzroy",9,9,63,"Arden St",72,1976,"Regular",6,"Home","North Melbourne","Fitzroy",72
8002,1976-05-08,"R6","Footscray",11,9,75,"St Kilda",10,10,70,"Western Oval",5,1976,"Regular",6,"Home","Footscray","St Kilda",5
8003,1976-05-08,"R6","Sydney",16,12,108,"Melbourne",21,10,136,"Lake Oval",-28,1976,"Regular",6,"Away","Melbourne","Sydney",28
8004,1976-05-15,"R7","Carlton",21,14,140,"Richmond",9,15,69,"Princes Park",71,1976,"Regular",7,"Home","Carlton","Richmond",71
8005,1976-05-15,"R7","North Melbourne",5,16,46,"Collingwood",11,9,75,"Waverley Park",-29,1976,"Regular",7,"Away","Collingwood","North Melbourne",29
8006,1976-05-15,"R7","St Kilda",9,15,69,"Essendon",14,13,97,"Moorabbin Oval",-28,1976,"Regular",7,"Away","Essendon","St Kilda",28
8007,1976-05-15,"R7","Fitzroy",11,22,88,"Sydney",12,15,87,"Junction Oval",1,1976,"Regular",7,"Home","Fitzroy","Sydney",1
8008,1976-05-15,"R7","Geelong",13,17,95,"Footscray",14,9,93,"Kardinia Park",2,1976,"Regular",7,"Home","Geelong","Footscray",2
8009,1976-05-15,"R7","Melbourne",14,13,97,"Hawthorn",21,19,145,"M.C.G.",-48,1976,"Regular",7,"Away","Hawthorn","Melbourne",48
8010,1976-05-22,"R8","St Kilda",15,14,104,"Carlton",9,12,66,"Waverley Park",38,1976,"Regular",8,"Home","St Kilda","Carlton",38
8011,1976-05-22,"R8","Collingwood",15,11,101,"Fitzroy",9,19,73,"Victoria Park",28,1976,"Regular",8,"Home","Collingwood","Fitzroy",28
8012,1976-05-22,"R8","Essendon",14,10,94,"Geelong",12,12,84,"Windy Hill",10,1976,"Regular",8,"Home","Essendon","Geelong",10
8013,1976-05-22,"R8","Footscray",7,3,45,"North Melbourne",14,11,95,"Western Oval",-50,1976,"Regular",8,"Away","North Melbourne","Footscray",50
8014,1976-05-22,"R8","Hawthorn",20,16,136,"Sydney",11,10,76,"Princes Park",60,1976,"Regular",8,"Home","Hawthorn","Sydney",60
8015,1976-05-22,"R8","Richmond",14,11,95,"Melbourne",9,15,69,"M.C.G.",26,1976,"Regular",8,"Home","Richmond","Melbourne",26
8016,1976-05-29,"R9","Geelong",14,18,102,"Carlton",12,10,82,"Kardinia Park",20,1976,"Regular",9,"Home","Geelong","Carlton",20
8017,1976-05-29,"R9","Collingwood",10,16,76,"Footscray",13,8,86,"Waverley Park",-10,1976,"Regular",9,"Away","Footscray","Collingwood",10
8018,1976-05-29,"R9","North Melbourne",8,10,58,"Essendon",7,12,54,"Arden St",4,1976,"Regular",9,"Home","North Melbourne","Essendon",4
8019,1976-05-29,"R9","Hawthorn",18,15,123,"Fitzroy",14,12,96,"Princes Park",27,1976,"Regular",9,"Home","Hawthorn","Fitzroy",27
8020,1976-05-29,"R9","Melbourne",15,19,109,"St Kilda",7,13,55,"M.C.G.",54,1976,"Regular",9,"Home","Melbourne","St Kilda",54
8021,1976-05-29,"R9","Sydney",13,18,96,"Richmond",13,10,88,"Lake Oval",8,1976,"Regular",9,"Home","Sydney","Richmond",8
8022,1976-06-05,"R10","Carlton",11,10,76,"North Melbourne",11,15,81,"Princes Park",-5,1976,"Regular",10,"Away","North Melbourne","Carlton",5
8023,1976-06-05,"R10","Essendon",14,19,103,"Collingwood",13,16,94,"Windy Hill",9,1976,"Regular",10,"Home","Essendon","Collingwood",9
8024,1976-06-05,"R10","Fitzroy",12,15,87,"Footscray",13,13,91,"Junction Oval",-4,1976,"Regular",10,"Away","Footscray","Fitzroy",4
8025,1976-06-05,"R10","Geelong",19,8,122,"Melbourne",13,15,93,"Waverley Park",29,1976,"Regular",10,"Home","Geelong","Melbourne",29
8026,1976-06-05,"R10","Richmond",13,10,88,"Hawthorn",15,10,100,"M.C.G.",-12,1976,"Regular",10,"Away","Hawthorn","Richmond",12
8027,1976-06-05,"R10","St Kilda",12,27,99,"Sydney",19,10,124,"Moorabbin Oval",-25,1976,"Regular",10,"Away","Sydney","St Kilda",25
8028,1976-06-12,"R11","Melbourne",12,16,88,"Collingwood",12,18,90,"M.C.G.",-2,1976,"Regular",11,"Away","Collingwood","Melbourne",2
8029,1976-06-12,"R11","Sydney",14,11,95,"North Melbourne",18,13,121,"Lake Oval",-26,1976,"Regular",11,"Away","North Melbourne","Sydney",26
8030,1976-06-12,"R11","St Kilda",19,13,127,"Richmond",15,6,96,"Moorabbin Oval",31,1976,"Regular",11,"Home","St Kilda","Richmond",31
8031,1976-06-14,"R11","Footscray",11,15,81,"Carlton",9,10,64,"Western Oval",17,1976,"Regular",11,"Home","Footscray","Carlton",17
8032,1976-06-14,"R11","Essendon",13,22,100,"Fitzroy",16,14,110,"Waverley Park",-10,1976,"Regular",11,"Away","Fitzroy","Essendon",10
8033,1976-06-14,"R11","Hawthorn",11,22,88,"Geelong",11,10,76,"Princes Park",12,1976,"Regular",11,"Home","Hawthorn","Geelong",12
8034,1976-06-19,"R12","Collingwood",12,10,82,"Carlton",8,8,56,"Victoria Park",26,1976,"Regular",12,"Home","Collingwood","Carlton",26
8035,1976-06-19,"R12","Essendon",12,17,89,"Footscray",12,7,79,"Windy Hill",10,1976,"Regular",12,"Home","Essendon","Footscray",10
8036,1976-06-19,"R12","Fitzroy",22,14,146,"Richmond",13,12,90,"Junction Oval",56,1976,"Regular",12,"Home","Fitzroy","Richmond",56
8037,1976-06-19,"R12","Geelong",23,17,155,"Sydney",6,15,51,"Kardinia Park",104,1976,"Regular",12,"Home","Geelong","Sydney",104
8038,1976-06-19,"R12","Hawthorn",13,19,97,"St Kilda",18,14,122,"Princes Park",-25,1976,"Regular",12,"Away","St Kilda","Hawthorn",25
8039,1976-06-19,"R12","Melbourne",8,13,61,"North Melbourne",22,14,146,"Waverley Park",-85,1976,"Regular",12,"Away","North Melbourne","Melbourne",85
8040,1976-06-26,"R13","Carlton",11,19,85,"Essendon",9,14,68,"Princes Park",17,1976,"Regular",13,"Home","Carlton","Essendon",17
8041,1976-06-26,"R13","Sydney",17,19,121,"Collingwood",11,16,82,"Waverley Park",39,1976,"Regular",13,"Home","Sydney","Collingwood",39
8042,1976-06-26,"R13","St Kilda",11,10,76,"Fitzroy",13,17,95,"Moorabbin Oval",-19,1976,"Regular",13,"Away","Fitzroy","St Kilda",19
8043,1976-06-26,"R13","Footscray",7,10,52,"Melbourne",14,20,104,"Western Oval",-52,1976,"Regular",13,"Away","Melbourne","Footscray",52
8044,1976-06-26,"R13","Richmond",15,12,102,"Geelong",14,14,98,"M.C.G.",4,1976,"Regular",13,"Home","Richmond","Geelong",4
8045,1976-06-26,"R13","North Melbourne",9,13,67,"Hawthorn",10,15,75,"Arden St",-8,1976,"Regular",13,"Away","Hawthorn","North Melbourne",8
8046,1976-07-03,"R14","Carlton",18,7,115,"Melbourne",6,22,58,"Waverley Park",57,1976,"Regular",14,"Home","Carlton","Melbourne",57
8047,1976-07-03,"R14","Richmond",23,13,151,"Collingwood",7,14,56,"M.C.G.",95,1976,"Regular",14,"Home","Richmond","Collingwood",95
8048,1976-07-03,"R14","Essendon",13,15,93,"Sydney",12,6,78,"Windy Hill",15,1976,"Regular",14,"Home","Essendon","Sydney",15
8049,1976-07-03,"R14","Fitzroy",17,17,119,"Geelong",13,18,96,"Junction Oval",23,1976,"Regular",14,"Home","Fitzroy","Geelong",23
8050,1976-07-03,"R14","Footscray",5,7,37,"Hawthorn",17,15,117,"Western Oval",-80,1976,"Regular",14,"Away","Hawthorn","Footscray",80
8051,1976-07-03,"R14","St Kilda",10,12,72,"North Melbourne",13,11,89,"Moorabbin Oval",-17,1976,"Regular",14,"Away","North Melbourne","St Kilda",17
8052,1976-07-10,"R15","Carlton",12,8,80,"Fitzroy",10,16,76,"Princes Park",4,1976,"Regular",15,"Home","Carlton","Fitzroy",4
8053,1976-07-10,"R15","Collingwood",16,11,107,"Hawthorn",18,11,119,"Waverley Park",-12,1976,"Regular",15,"Away","Hawthorn","Collingwood",12
8054,1976-07-10,"R15","Melbourne",15,14,104,"Essendon",18,11,119,"M.C.G.",-15,1976,"Regular",15,"Away","Essendon","Melbourne",15
8055,1976-07-10,"R15","Sydney",20,16,136,"Footscray",17,14,116,"Lake Oval",20,1976,"Regular",15,"Home","Sydney","Footscray",20
8056,1976-07-10,"R15","Geelong",15,12,102,"St Kilda",9,9,63,"Kardinia Park",39,1976,"Regular",15,"Home","Geelong","St Kilda",39
8057,1976-07-10,"R15","North Melbourne",12,10,82,"Richmond",11,11,77,"Arden St",5,1976,"Regular",15,"Home","North Melbourne","Richmond",5
8058,1976-07-17,"R16","Sydney",14,10,94,"Carlton",15,10,100,"Lake Oval",-6,1976,"Regular",16,"Away","Carlton","Sydney",6
8059,1976-07-17,"R16","Collingwood",15,14,104,"St Kilda",18,13,121,"Victoria Park",-17,1976,"Regular",16,"Away","St Kilda","Collingwood",17
8060,1976-07-17,"R16","Hawthorn",15,17,107,"Essendon",18,15,123,"Princes Park",-16,1976,"Regular",16,"Away","Essendon","Hawthorn",16
8061,1976-07-17,"R16","Melbourne",21,20,146,"Fitzroy",15,16,106,"M.C.G.",40,1976,"Regular",16,"Home","Melbourne","Fitzroy",40
8062,1976-07-17,"R16","Footscray",15,6,96,"Richmond",12,19,91,"Waverley Park",5,1976,"Regular",16,"Home","Footscray","Richmond",5
8063,1976-07-17,"R16","North Melbourne",22,13,145,"Geelong",12,6,78,"Arden St",67,1976,"Regular",16,"Home","North Melbourne","Geelong",67
8064,1976-07-24,"R17","Carlton",17,14,116,"Hawthorn",11,19,85,"Princes Park",31,1976,"Regular",17,"Home","Carlton","Hawthorn",31
8065,1976-07-24,"R17","Geelong",15,9,99,"Collingwood",11,27,93,"Kardinia Park",6,1976,"Regular",17,"Home","Geelong","Collingwood",6
8066,1976-07-24,"R17","Essendon",8,15,63,"Richmond",15,16,106,"Windy Hill",-43,1976,"Regular",17,"Away","Richmond","Essendon",43
8067,1976-07-24,"R17","Fitzroy",11,7,73,"North Melbourne",13,14,92,"Junction Oval",-19,1976,"Regular",17,"Away","North Melbourne","Fitzroy",19
8068,1976-07-24,"R17","St Kilda",17,16,118,"Footscray",15,14,104,"Moorabbin Oval",14,1976,"Regular",17,"Home","St Kilda","Footscray",14
8069,1976-07-24,"R17","Melbourne",11,13,79,"Sydney",14,9,93,"Waverley Park",-14,1976,"Regular",17,"Away","Sydney","Melbourne",14
8070,1976-07-31,"R18","Richmond",8,17,65,"Carlton",22,16,148,"M.C.G.",-83,1976,"Regular",18,"Away","Carlton","Richmond",83
8071,1976-07-31,"R18","Collingwood",8,10,58,"North Melbourne",9,8,62,"Victoria Park",-4,1976,"Regular",18,"Away","North Melbourne","Collingwood",4
8072,1976-07-31,"R18","Essendon",12,7,79,"St Kilda",17,15,117,"Waverley Park",-38,1976,"Regular",18,"Away","St Kilda","Essendon",38
8073,1976-07-31,"R18","Sydney",16,11,107,"Fitzroy",11,14,80,"Lake Oval",27,1976,"Regular",18,"Home","Sydney","Fitzroy",27
8074,1976-07-31,"R18","Footscray",13,8,86,"Geelong",10,14,74,"Western Oval",12,1976,"Regular",18,"Home","Footscray","Geelong",12
8075,1976-07-31,"R18","Hawthorn",16,17,113,"Melbourne",14,11,95,"Princes Park",18,1976,"Regular",18,"Home","Hawthorn","Melbourne",18
8076,1976-08-07,"R19","Carlton",22,19,151,"St Kilda",7,8,50,"Princes Park",101,1976,"Regular",19,"Home","Carlton","St Kilda",101
8077,1976-08-07,"R19","Fitzroy",17,15,117,"Collingwood",9,16,70,"Junction Oval",47,1976,"Regular",19,"Home","Fitzroy","Collingwood",47
8078,1976-08-07,"R19","Geelong",18,8,116,"Essendon",18,14,122,"Kardinia Park",-6,1976,"Regular",19,"Away","Essendon","Geelong",6
8079,1976-08-07,"R19","North Melbourne",8,13,61,"Footscray",7,8,50,"Arden St",11,1976,"Regular",19,"Home","North Melbourne","Footscray",11
8080,1976-08-07,"R19","Sydney",12,11,83,"Hawthorn",13,19,97,"Waverley Park",-14,1976,"Regular",19,"Away","Hawthorn","Sydney",14
8081,1976-08-07,"R19","Melbourne",17,17,119,"Richmond",13,11,89,"M.C.G.",30,1976,"Regular",19,"Home","Melbourne","Richmond",30
8082,1976-08-14,"R20","Carlton",11,16,82,"Geelong",5,12,42,"Waverley Park",40,1976,"Regular",20,"Home","Carlton","Geelong",40
8083,1976-08-14,"R20","Footscray",18,16,124,"Collingwood",15,9,99,"Western Oval",25,1976,"Regular",20,"Home","Footscray","Collingwood",25
8084,1976-08-14,"R20","Essendon",10,9,69,"North Melbourne",14,11,95,"Windy Hill",-26,1976,"Regular",20,"Away","North Melbourne","Essendon",26
8085,1976-08-14,"R20","Fitzroy",12,19,91,"Hawthorn",14,10,94,"Junction Oval",-3,1976,"Regular",20,"Away","Hawthorn","Fitzroy",3
8086,1976-08-14,"R20","St Kilda",13,14,92,"Melbourne",18,21,129,"Moorabbin Oval",-37,1976,"Regular",20,"Away","Melbourne","St Kilda",37
8087,1976-08-14,"R20","Richmond",16,14,110,"Sydney",12,12,84,"M.C.G.",26,1976,"Regular",20,"Home","Richmond","Sydney",26
8088,1976-08-21,"R21","North Melbourne",10,15,75,"Carlton",18,16,124,"Arden St",-49,1976,"Regular",21,"Away","Carlton","North Melbourne",49
8089,1976-08-21,"R21","Collingwood",20,20,140,"Essendon",12,17,89,"Victoria Park",51,1976,"Regular",21,"Home","Collingwood","Essendon",51
8090,1976-08-21,"R21","Footscray",4,11,35,"Fitzroy",3,16,34,"Waverley Park",1,1976,"Regular",21,"Home","Footscray","Fitzroy",1
8091,1976-08-21,"R21","Melbourne",22,18,150,"Geelong",16,9,105,"M.C.G.",45,1976,"Regular",21,"Home","Melbourne","Geelong",45
8092,1976-08-21,"R21","Hawthorn",11,16,82,"Richmond",17,12,114,"Princes Park",-32,1976,"Regular",21,"Away","Richmond","Hawthorn",32
8093,1976-08-21,"R21","Sydney",15,18,108,"St Kilda",10,6,66,"Lake Oval",42,1976,"Regular",21,"Home","Sydney","St Kilda",42
8094,1976-08-28,"R22","Carlton",15,17,107,"Footscray",15,17,107,"Princes Park",0,1976,"Regular",22,"Home","Carlton","Footscray",0
8095,1976-08-28,"R22","Collingwood",17,11,113,"Melbourne",18,20,128,"Victoria Park",-15,1976,"Regular",22,"Away","Melbourne","Collingwood",15
8096,1976-08-28,"R22","Fitzroy",15,20,110,"Essendon",10,18,78,"Junction Oval",32,1976,"Regular",22,"Home","Fitzroy","Essendon",32
8097,1976-08-28,"R22","Geelong",13,18,96,"Hawthorn",10,11,71,"Kardinia Park",25,1976,"Regular",22,"Home","Geelong","Hawthorn",25
8098,1976-08-28,"R22","North Melbourne",19,14,128,"Sydney",12,19,91,"Arden St",37,1976,"Regular",22,"Home","North Melbourne","Sydney",37
8099,1976-08-28,"R22","Richmond",21,14,140,"St Kilda",14,22,106,"Waverley Park",34,1976,"Regular",22,"Home","Richmond","St Kilda",34
8100,1976-09-04,"EF","Geelong",14,18,102,"Footscray",14,11,95,"Waverley Park",7,1976,"Finals",23,"Home","Geelong","Footscray",7
8101,1976-09-04,"QF","Hawthorn",14,19,103,"North Melbourne",12,11,83,"M.C.G.",20,1976,"Finals",23,"Home","Hawthorn","North Melbourne",20
8102,1976-09-11,"SF","Carlton",9,16,70,"Hawthorn",12,15,87,"Waverley Park",-17,1976,"Finals",24,"Away","Hawthorn","Carlton",17
8103,1976-09-11,"SF","North Melbourne",14,9,93,"Geelong",8,12,60,"M.C.G.",33,1976,"Finals",24,"Home","North Melbourne","Geelong",33
8104,1976-09-18,"PF","Carlton",9,12,66,"North Melbourne",10,7,67,"Waverley Park",-1,1976,"Finals",25,"Away","North Melbourne","Carlton",1
8105,1976-09-25,"GF","Hawthorn",13,22,100,"North Melbourne",10,10,70,"M.C.G.",30,1976,"Finals",26,"Home","Hawthorn","North Melbourne",30
8106,1977-04-02,"R1","Geelong",6,9,45,"Carlton",17,21,123,"Kardinia Park",-78,1977,"Regular",1,"Away","Carlton","Geelong",78
8107,1977-04-02,"R1","Collingwood",19,16,130,"Footscray",18,11,119,"Victoria Park",11,1977,"Regular",1,"Home","Collingwood","Footscray",11
8108,1977-04-02,"R1","Essendon",14,25,109,"St Kilda",10,17,77,"Windy Hill",32,1977,"Regular",1,"Home","Essendon","St Kilda",32
8109,1977-04-02,"R1","Fitzroy",21,17,143,"Richmond",18,21,129,"Junction Oval",14,1977,"Regular",1,"Home","Fitzroy","Richmond",14
8110,1977-04-02,"R1","Hawthorn",13,14,92,"North Melbourne",23,14,152,"Princes Park",-60,1977,"Regular",1,"Away","North Melbourne","Hawthorn",60
8111,1977-04-02,"R1","Melbourne",10,12,72,"Sydney",21,15,141,"M.C.G.",-69,1977,"Regular",1,"Away","Sydney","Melbourne",69
8112,1977-04-09,"R2","Carlton",16,17,113,"Fitzroy",12,9,81,"Princes Park",32,1977,"Regular",2,"Home","Carlton","Fitzroy",32
8113,1977-04-09,"R2","North Melbourne",16,6,102,"Collingwood",13,15,93,"Arden St",9,1977,"Regular",2,"Home","North Melbourne","Collingwood",9
8114,1977-04-09,"R2","Sydney",27,13,175,"Essendon",15,8,98,"Lake Oval",77,1977,"Regular",2,"Home","Sydney","Essendon",77
8115,1977-04-11,"R2","Footscray",18,8,116,"Melbourne",12,23,95,"Western Oval",21,1977,"Regular",2,"Home","Footscray","Melbourne",21
8116,1977-04-11,"R2","St Kilda",11,17,83,"Geelong",17,17,119,"Moorabbin Oval",-36,1977,"Regular",2,"Away","Geelong","St Kilda",36
8117,1977-04-11,"R2","Richmond",19,6,120,"Hawthorn",17,17,119,"M.C.G.",1,1977,"Regular",2,"Home","Richmond","Hawthorn",1
8118,1977-04-16,"R3","Carlton",24,26,170,"St Kilda",9,9,63,"Princes Park",107,1977,"Regular",3,"Home","Carlton","St Kilda",107
8119,1977-04-16,"R3","Collingwood",24,22,166,"Essendon",16,19,115,"Victoria Park",51,1977,"Regular",3,"Home","Collingwood","Essendon",51
8120,1977-04-16,"R3","Footscray",20,16,136,"Fitzroy",16,12,108,"Waverley Park",28,1977,"Regular",3,"Home","Footscray","Fitzroy",28
8121,1977-04-16,"R3","Geelong",6,14,50,"Hawthorn",15,15,105,"Kardinia Park",-55,1977,"Regular",3,"Away","Hawthorn","Geelong",55
8122,1977-04-16,"R3","Melbourne",14,18,102,"North Melbourne",16,9,105,"M.C.G.",-3,1977,"Regular",3,"Away","North Melbourne","Melbourne",3
8123,1977-04-16,"R3","Sydney",11,13,79,"Richmond",13,13,91,"Lake Oval",-12,1977,"Regular",3,"Away","Richmond","Sydney",12
8124,1977-04-23,"R4","Hawthorn",13,18,96,"Carlton",12,11,83,"Princes Park",13,1977,"Regular",4,"Home","Hawthorn","Carlton",13
8125,1977-04-23,"R4","Essendon",19,10,124,"Melbourne",16,24,120,"Windy Hill",4,1977,"Regular",4,"Home","Essendon","Melbourne",4
8126,1977-04-23,"R4","St Kilda",19,20,134,"Fitzroy",14,14,98,"Moorabbin Oval",36,1977,"Regular",4,"Home","St Kilda","Fitzroy",36
8127,1977-04-23,"R4","North Melbourne",16,21,117,"Footscray",12,10,82,"Arden St",35,1977,"Regular",4,"Home","North Melbourne","Footscray",35
8128,1977-04-25,"R4","Richmond",14,16,100,"Collingwood",17,24,126,"M.C.G.",-26,1977,"Regular",4,"Away","Collingwood","Richmond",26
8129,1977-04-25,"R4","Sydney",12,15,87,"Geelong",16,18,114,"Waverley Park",-27,1977,"Regular",4,"Away","Geelong","Sydney",27
8130,1977-04-30,"R5","Carlton",21,8,134,"Sydney",16,11,107,"Princes Park",27,1977,"Regular",5,"Home","Carlton","Sydney",27
8131,1977-04-30,"R5","Collingwood",18,16,124,"Geelong",15,19,109,"Victoria Park",15,1977,"Regular",5,"Home","Collingwood","Geelong",15
8132,1977-04-30,"R5","North Melbourne",18,17,125,"Essendon",15,15,105,"Waverley Park",20,1977,"Regular",5,"Home","North Melbourne","Essendon",20
8133,1977-04-30,"R5","Fitzroy",12,14,86,"Hawthorn",21,16,142,"Junction Oval",-56,1977,"Regular",5,"Away","Hawthorn","Fitzroy",56
8134,1977-04-30,"R5","Footscray",17,14,116,"St Kilda",17,14,116,"Western Oval",0,1977,"Regular",5,"Home","Footscray","St Kilda",0
8135,1977-04-30,"R5","Melbourne",13,24,102,"Richmond",19,17,131,"M.C.G.",-29,1977,"Regular",5,"Away","Richmond","Melbourne",29
8136,1977-05-07,"R6","Collingwood",22,20,152,"Carlton",7,8,50,"Waverley Park",102,1977,"Regular",6,"Home","Collingwood","Carlton",102
8137,1977-05-07,"R6","Essendon",13,11,89,"Footscray",29,15,189,"Windy Hill",-100,1977,"Regular",6,"Away","Footscray","Essendon",100
8138,1977-05-07,"R6","Sydney",21,19,145,"Fitzroy",19,12,126,"Lake Oval",19,1977,"Regular",6,"Home","Sydney","Fitzroy",19
8139,1977-05-07,"R6","Geelong",21,17,143,"Melbourne",13,15,93,"Kardinia Park",50,1977,"Regular",6,"Home","Geelong","Melbourne",50
8140,1977-05-07,"R6","Hawthorn",25,41,191,"St Kilda",16,7,103,"Princes Park",88,1977,"Regular",6,"Home","Hawthorn","St Kilda",88
8141,1977-05-07,"R6","Richmond",19,15,129,"North Melbourne",14,12,96,"M.C.G.",33,1977,"Regular",6,"Home","Richmond","North Melbourne",33
8142,1977-05-14,"R7","Melbourne",14,12,96,"Carlton",16,20,116,"M.C.G.",-20,1977,"Regular",7,"Away","Carlton","Melbourne",20
8143,1977-05-14,"R7","Fitzroy",11,14,80,"Collingwood",15,23,113,"Junction Oval",-33,1977,"Regular",7,"Away","Collingwood","Fitzroy",33
8144,1977-05-14,"R7","Essendon",15,9,99,"Richmond",14,15,99,"Waverley Park",0,1977,"Regular",7,"Home","Essendon","Richmond",0
8145,1977-05-14,"R7","Footscray",8,13,61,"Hawthorn",20,11,131,"Western Oval",-70,1977,"Regular",7,"Away","Hawthorn","Footscray",70
8146,1977-05-14,"R7","North Melbourne",23,11,149,"Geelong",12,12,84,"Arden St",65,1977,"Regular",7,"Home","North Melbourne","Geelong",65
8147,1977-05-14,"R7","St Kilda",14,14,98,"Sydney",14,14,98,"Moorabbin Oval",0,1977,"Regular",7,"Home","St Kilda","Sydney",0
8148,1977-05-21,"R8","Carlton",8,17,65,"North Melbourne",9,8,62,"Princes Park",3,1977,"Regular",8,"Home","Carlton","North Melbourne",3
8149,1977-05-21,"R8","Collingwood",19,21,135,"St Kilda",11,12,78,"Victoria Park",57,1977,"Regular",8,"Home","Collingwood","St Kilda",57
8150,1977-05-21,"R8","Geelong",13,16,94,"Essendon",13,9,87,"Kardinia Park",7,1977,"Regular",8,"Home","Geelong","Essendon",7
8151,1977-05-21,"R8","Melbourne",19,26,140,"Fitzroy",14,8,92,"Waverley Park",48,1977,"Regular",8,"Home","Melbourne","Fitzroy",48
8152,1977-05-21,"R8","Richmond",16,18,114,"Footscray",13,17,95,"M.C.G.",19,1977,"Regular",8,"Home","Richmond","Footscray",19
8153,1977-05-21,"R8","Sydney",7,13,55,"Hawthorn",18,7,115,"Lake Oval",-60,1977,"Regular",8,"Away","Hawthorn","Sydney",60
8154,1977-05-28,"R9","Essendon",14,12,96,"Carlton",10,17,77,"Windy Hill",19,1977,"Regular",9,"Home","Essendon","Carlton",19
8155,1977-05-28,"R9","Hawthorn",16,12,108,"Collingwood",22,10,142,"Princes Park",-34,1977,"Regular",9,"Away","Collingwood","Hawthorn",34
8156,1977-05-28,"R9","North Melbourne",12,12,84,"Fitzroy",10,14,74,"Arden St",10,1977,"Regular",9,"Home","North Melbourne","Fitzroy",10
8157,1977-05-28,"R9","Sydney",14,14,98,"Footscray",11,13,79,"Lake Oval",19,1977,"Regular",9,"Home","Sydney","Footscray",19
8158,1977-05-28,"R9","Richmond",18,13,121,"Geelong",10,11,71,"Waverley Park",50,1977,"Regular",9,"Home","Richmond","Geelong",50
8159,1977-05-28,"R9","St Kilda",18,19,127,"Melbourne",20,12,132,"Moorabbin Oval",-5,1977,"Regular",9,"Away","Melbourne","St Kilda",5
8160,1977-06-04,"R10","Carlton",16,9,105,"Richmond",19,11,125,"Princes Park",-20,1977,"Regular",10,"Away","Richmond","Carlton",20
8161,1977-06-04,"R10","Collingwood",15,20,110,"Sydney",20,16,136,"Victoria Park",-26,1977,"Regular",10,"Away","Sydney","Collingwood",26
8162,1977-06-04,"R10","Fitzroy",14,16,100,"Essendon",23,16,154,"Junction Oval",-54,1977,"Regular",10,"Away","Essendon","Fitzroy",54
8163,1977-06-04,"R10","Footscray",21,14,140,"Geelong",15,13,103,"Western Oval",37,1977,"Regular",10,"Home","Footscray","Geelong",37
8164,1977-06-04,"R10","Melbourne",16,19,115,"Hawthorn",19,13,127,"M.C.G.",-12,1977,"Regular",10,"Away","Hawthorn","Melbourne",12
8165,1977-06-04,"R10","North Melbourne",21,16,142,"St Kilda",7,15,57,"Waverley Park",85,1977,"Regular",10,"Home","North Melbourne","St Kilda",85
8166,1977-06-11,"R11","Carlton",17,14,116,"Footscray",8,19,67,"Waverley Park",49,1977,"Regular",11,"Home","Carlton","Footscray",49
8167,1977-06-11,"R11","Geelong",20,13,133,"Fitzroy",11,16,82,"Kardinia Park",51,1977,"Regular",11,"Home","Geelong","Fitzroy",51
8168,1977-06-11,"R11","Sydney",12,9,81,"North Melbourne",9,11,65,"Lake Oval",16,1977,"Regular",11,"Home","Sydney","North Melbourne",16
8169,1977-06-13,"R11","Melbourne",11,20,86,"Collingwood",17,17,119,"M.C.G.",-33,1977,"Regular",11,"Away","Collingwood","Melbourne",33
8170,1977-06-13,"R11","Hawthorn",23,25,163,"Essendon",8,9,57,"Princes Park",106,1977,"Regular",11,"Home","Hawthorn","Essendon",106
8171,1977-06-13,"R11","St Kilda",13,10,88,"Richmond",16,5,101,"Moorabbin Oval",-13,1977,"Regular",11,"Away","Richmond","St Kilda",13
8172,1977-06-18,"R12","Carlton",3,13,31,"Geelong",2,12,24,"Princes Park",7,1977,"Regular",12,"Home","Carlton","Geelong",7
8173,1977-06-18,"R12","Footscray",5,6,36,"Collingwood",9,15,69,"Western Oval",-33,1977,"Regular",12,"Away","Collingwood","Footscray",33
8174,1977-06-18,"R12","St Kilda",5,12,42,"Essendon",5,16,46,"Waverley Park",-4,1977,"Regular",12,"Away","Essendon","St Kilda",4
8175,1977-06-18,"R12","Richmond",13,15,93,"Fitzroy",6,5,41,"M.C.G.",52,1977,"Regular",12,"Home","Richmond","Fitzroy",52
8176,1977-06-18,"R12","North Melbourne",6,11,47,"Hawthorn",6,12,48,"Arden St",-1,1977,"Regular",12,"Away","Hawthorn","North Melbourne",1
8177,1977-06-18,"R12","Sydney",8,22,70,"Melbourne",9,10,64,"Lake Oval",6,1977,"Regular",12,"Home","Sydney","Melbourne",6
8178,1977-06-25,"R13","Fitzroy",11,9,75,"Carlton",9,14,68,"Junction Oval",7,1977,"Regular",13,"Home","Fitzroy","Carlton",7
8179,1977-06-25,"R13","Collingwood",13,19,97,"North Melbourne",8,8,56,"Victoria Park",41,1977,"Regular",13,"Home","Collingwood","North Melbourne",41
8180,1977-06-25,"R13","Essendon",9,9,63,"Sydney",6,15,51,"Windy Hill",12,1977,"Regular",13,"Home","Essendon","Sydney",12
8181,1977-06-25,"R13","Melbourne",7,9,51,"Footscray",15,12,102,"M.C.G.",-51,1977,"Regular",13,"Away","Footscray","Melbourne",51
8182,1977-06-25,"R13","Geelong",11,9,75,"St Kilda",12,13,85,"Kardinia Park",-10,1977,"Regular",13,"Away","St Kilda","Geelong",10
8183,1977-06-25,"R13","Hawthorn",9,12,66,"Richmond",7,10,52,"Waverley Park",14,1977,"Regular",13,"Home","Hawthorn","Richmond",14
8184,1977-07-02,"R14","Carlton",9,8,62,"Hawthorn",7,6,48,"Princes Park",14,1977,"Regular",14,"Home","Carlton","Hawthorn",14
8185,1977-07-02,"R14","Collingwood",22,9,141,"Richmond",11,12,78,"Victoria Park",63,1977,"Regular",14,"Home","Collingwood","Richmond",63
8186,1977-07-02,"R14","Melbourne",9,16,70,"Essendon",8,11,59,"M.C.G.",11,1977,"Regular",14,"Home","Melbourne","Essendon",11
8187,1977-07-02,"R14","Fitzroy",10,12,72,"St Kilda",14,12,96,"Waverley Park",-24,1977,"Regular",14,"Away","St Kilda","Fitzroy",24
8188,1977-07-02,"R14","Footscray",9,10,64,"North Melbourne",11,15,81,"Western Oval",-17,1977,"Regular",14,"Away","North Melbourne","Footscray",17
8189,1977-07-02,"R14","Geelong",7,15,57,"Sydney",9,10,64,"Kardinia Park",-7,1977,"Regular",14,"Away","Sydney","Geelong",7
8190,1977-07-09,"R15","St Kilda",17,12,114,"Carlton",18,14,122,"Moorabbin Oval",-8,1977,"Regular",15,"Away","Carlton","St Kilda",8
8191,1977-07-09,"R15","Essendon",14,19,103,"Collingwood",17,12,114,"Windy Hill",-11,1977,"Regular",15,"Away","Collingwood","Essendon",11
8192,1977-07-09,"R15","Fitzroy",15,13,103,"Footscray",11,19,85,"Junction Oval",18,1977,"Regular",15,"Home","Fitzroy","Footscray",18
8193,1977-07-09,"R15","Hawthorn",28,23,191,"Geelong",13,6,84,"Princes Park",107,1977,"Regular",15,"Home","Hawthorn","Geelong",107
8194,1977-07-09,"R15","North Melbourne",18,19,127,"Melbourne",11,10,76,"Arden St",51,1977,"Regular",15,"Home","North Melbourne","Melbourne",51
8195,1977-07-09,"R15","Richmond",14,16,100,"Sydney",10,11,71,"Waverley Park",29,1977,"Regular",15,"Home","Richmond","Sydney",29
8196,1977-07-16,"R16","Sydney",12,4,76,"Carlton",13,7,85,"Lake Oval",-9,1977,"Regular",16,"Away","Carlton","Sydney",9
8197,1977-07-16,"R16","Geelong",16,6,102,"Collingwood",12,25,97,"Waverley Park",5,1977,"Regular",16,"Home","Geelong","Collingwood",5
8198,1977-07-16,"R16","Essendon",17,14,116,"North Melbourne",11,11,77,"Windy Hill",39,1977,"Regular",16,"Home","Essendon","North Melbourne",39
8199,1977-07-16,"R16","Hawthorn",20,14,134,"Fitzroy",11,12,78,"Princes Park",56,1977,"Regular",16,"Home","Hawthorn","Fitzroy",56
8200,1977-07-16,"R16","St Kilda",10,16,76,"Footscray",13,18,96,"Moorabbin Oval",-20,1977,"Regular",16,"Away","Footscray","St Kilda",20
8201,1977-07-16,"R16","Richmond",10,11,71,"Melbourne",13,12,90,"M.C.G.",-19,1977,"Regular",16,"Away","Melbourne","Richmond",19
8202,1977-07-23,"R17","Carlton",11,8,74,"Collingwood",15,16,106,"Princes Park",-32,1977,"Regular",17,"Away","Collingwood","Carlton",32
8203,1977-07-23,"R17","Footscray",12,21,93,"Essendon",11,10,76,"Western Oval",17,1977,"Regular",17,"Home","Footscray","Essendon",17
8204,1977-07-23,"R17","Fitzroy",7,13,55,"Sydney",16,21,117,"Junction Oval",-62,1977,"Regular",17,"Away","Sydney","Fitzroy",62
8205,1977-07-23,"R17","Melbourne",15,18,108,"Geelong",20,14,134,"M.C.G.",-26,1977,"Regular",17,"Away","Geelong","Melbourne",26
8206,1977-07-23,"R17","St Kilda",11,11,77,"Hawthorn",24,19,163,"Waverley Park",-86,1977,"Regular",17,"Away","Hawthorn","St Kilda",86
8207,1977-07-23,"R17","North Melbourne",15,11,101,"Richmond",14,14,98,"Arden St",3,1977,"Regular",17,"Home","North Melbourne","Richmond",3
8208,1977-07-30,"R18","Carlton",17,11,113,"Melbourne",7,4,46,"Waverley Park",67,1977,"Regular",18,"Home","Carlton","Melbourne",67
8209,1977-07-30,"R18","Collingwood",18,14,122,"Fitzroy",13,11,89,"Victoria Park",33,1977,"Regular",18,"Home","Collingwood","Fitzroy",33
8210,1977-07-30,"R18","Richmond",16,15,111,"Essendon",9,11,65,"M.C.G.",46,1977,"Regular",18,"Home","Richmond","Essendon",46
8211,1977-07-30,"R18","Hawthorn",18,10,118,"Footscray",15,14,104,"Princes Park",14,1977,"Regular",18,"Home","Hawthorn","Footscray",14
8212,1977-07-30,"R18","Geelong",6,15,51,"North Melbourne",14,11,95,"Kardinia Park",-44,1977,"Regular",18,"Away","North Melbourne","Geelong",44
8213,1977-07-30,"R18","Sydney",21,12,138,"St Kilda",12,11,83,"Lake Oval",55,1977,"Regular",18,"Home","Sydney","St Kilda",55
8214,1977-08-06,"R19","North Melbourne",8,15,63,"Carlton",6,7,43,"Arden St",20,1977,"Regular",19,"Home","North Melbourne","Carlton",20
8215,1977-08-06,"R19","St Kilda",11,9,75,"Collingwood",14,17,101,"Moorabbin Oval",-26,1977,"Regular",19,"Away","Collingwood","St Kilda",26
8216,1977-08-06,"R19","Essendon",15,20,110,"Geelong",18,16,124,"Windy Hill",-14,1977,"Regular",19,"Away","Geelong","Essendon",14
8217,1977-08-06,"R19","Fitzroy",23,8,146,"Melbourne",12,12,84,"Junction Oval",62,1977,"Regular",19,"Home","Fitzroy","Melbourne",62
8218,1977-08-06,"R19","Footscray",19,15,129,"Richmond",15,11,101,"Western Oval",28,1977,"Regular",19,"Home","Footscray","Richmond",28
8219,1977-08-06,"R19","Hawthorn",10,18,78,"Sydney",16,7,103,"Waverley Park",-25,1977,"Regular",19,"Away","Sydney","Hawthorn",25
8220,1977-08-13,"R20","Carlton",22,14,146,"Essendon",16,15,111,"Princes Park",35,1977,"Regular",20,"Home","Carlton","Essendon",35
8221,1977-08-13,"R20","Collingwood",13,21,99,"Hawthorn",15,15,105,"Victoria Park",-6,1977,"Regular",20,"Away","Hawthorn","Collingwood",6
8222,1977-08-13,"R20","Fitzroy",9,11,65,"North Melbourne",10,19,79,"Waverley Park",-14,1977,"Regular",20,"Away","North Melbourne","Fitzroy",14
8223,1977-08-13,"R20","Footscray",9,19,73,"Sydney",14,12,96,"Western Oval",-23,1977,"Regular",20,"Away","Sydney","Footscray",23
8224,1977-08-13,"R20","Geelong",5,16,46,"Richmond",19,18,132,"Kardinia Park",-86,1977,"Regular",20,"Away","Richmond","Geelong",86
8225,1977-08-13,"R20","Melbourne",27,13,175,"St Kilda",15,14,104,"M.C.G.",71,1977,"Regular",20,"Home","Melbourne","St Kilda",71
8226,1977-08-20,"R21","Richmond",15,13,103,"Carlton",14,16,100,"M.C.G.",3,1977,"Regular",21,"Home","Richmond","Carlton",3
8227,1977-08-20,"R21","Sydney",8,9,57,"Collingwood",12,17,89,"Lake Oval",-32,1977,"Regular",21,"Away","Collingwood","Sydney",32
8228,1977-08-20,"R21","Essendon",10,13,73,"Fitzroy",20,17,137,"Windy Hill",-64,1977,"Regular",21,"Away","Fitzroy","Essendon",64
8229,1977-08-20,"R21","Geelong",10,8,68,"Footscray",11,19,85,"Waverley Park",-17,1977,"Regular",21,"Away","Footscray","Geelong",17
8230,1977-08-20,"R21","Hawthorn",16,14,110,"Melbourne",14,15,99,"Princes Park",11,1977,"Regular",21,"Home","Hawthorn","Melbourne",11
8231,1977-08-20,"R21","St Kilda",11,12,78,"North Melbourne",15,16,106,"Moorabbin Oval",-28,1977,"Regular",21,"Away","North Melbourne","St Kilda",28
8232,1977-08-27,"R22","Footscray",15,13,103,"Carlton",12,13,85,"Western Oval",18,1977,"Regular",22,"Home","Footscray","Carlton",18
8233,1977-08-27,"R22","Collingwood",17,13,115,"Melbourne",14,17,101,"Waverley Park",14,1977,"Regular",22,"Home","Collingwood","Melbourne",14
8234,1977-08-27,"R22","Essendon",19,16,130,"Hawthorn",25,18,168,"Windy Hill",-38,1977,"Regular",22,"Away","Hawthorn","Essendon",38
8235,1977-08-27,"R22","Fitzroy",19,27,141,"Geelong",14,16,100,"Junction Oval",41,1977,"Regular",22,"Home","Fitzroy","Geelong",41
8236,1977-08-27,"R22","North Melbourne",14,9,93,"Sydney",15,13,103,"Arden St",-10,1977,"Regular",22,"Away","Sydney","North Melbourne",10
8237,1977-08-27,"R22","Richmond",25,21,171,"St Kilda",17,10,112,"M.C.G.",59,1977,"Regular",22,"Home","Richmond","St Kilda",59
8238,1977-09-03,"QF","Hawthorn",19,11,125,"North Melbourne",12,15,87,"M.C.G.",38,1977,"Finals",23,"Home","Hawthorn","North Melbourne",38
8239,1977-09-03,"EF","Richmond",13,10,88,"Sydney",7,12,54,"Waverley Park",34,1977,"Finals",23,"Home","Richmond","Sydney",34
8240,1977-09-10,"SF","Collingwood",17,10,112,"Hawthorn",16,14,110,"M.C.G.",2,1977,"Finals",24,"Home","Collingwood","Hawthorn",2
8241,1977-09-10,"SF","North Melbourne",16,14,110,"Richmond",9,9,63,"Waverley Park",47,1977,"Finals",24,"Home","North Melbourne","Richmond",47
8242,1977-09-17,"PF","Hawthorn",5,15,45,"North Melbourne",16,16,112,"Waverley Park",-67,1977,"Finals",25,"Away","North Melbourne","Hawthorn",67
8243,1977-09-24,"GF","Collingwood",10,16,76,"North Melbourne",9,22,76,"M.C.G.",0,1977,"Finals",26,"Home","Collingwood","North Melbourne",0
8244,1977-10-01,"GF","Collingwood",19,10,124,"North Melbourne",21,25,151,"M.C.G.",-27,1977,"Finals",26,"Away","North Melbourne","Collingwood",27
8245,1978-04-01,"R1","Richmond",25,24,174,"Carlton",14,13,97,"M.C.G.",77,1978,"Regular",1,"Home","Richmond","Carlton",77
8246,1978-04-01,"R1","Geelong",11,10,76,"Collingwood",17,16,118,"Kardinia Park",-42,1978,"Regular",1,"Away","Collingwood","Geelong",42
8247,1978-04-01,"R1","Essendon",19,9,123,"Sydney",14,18,102,"Windy Hill",21,1978,"Regular",1,"Home","Essendon","Sydney",21
8248,1978-04-01,"R1","Fitzroy",15,11,101,"St Kilda",16,13,109,"Junction Oval",-8,1978,"Regular",1,"Away","St Kilda","Fitzroy",8
8249,1978-04-01,"R1","Footscray",11,14,80,"North Melbourne",23,11,149,"Western Oval",-69,1978,"Regular",1,"Away","North Melbourne","Footscray",69
8250,1978-04-01,"R1","Hawthorn",22,15,147,"Melbourne",9,14,68,"Princes Park",79,1978,"Regular",1,"Home","Hawthorn","Melbourne",79
8251,1978-04-08,"R2","Carlton",13,17,95,"Geelong",15,19,109,"Princes Park",-14,1978,"Regular",2,"Away","Geelong","Carlton",14
8252,1978-04-08,"R2","Collingwood",22,23,155,"Essendon",12,16,88,"Victoria Park",67,1978,"Regular",2,"Home","Collingwood","Essendon",67
8253,1978-04-08,"R2","Melbourne",24,23,167,"Fitzroy",23,19,157,"M.C.G.",10,1978,"Regular",2,"Home","Melbourne","Fitzroy",10
8254,1978-04-08,"R2","St Kilda",20,17,137,"Footscray",19,16,130,"Moorabbin Oval",7,1978,"Regular",2,"Home","St Kilda","Footscray",7
8255,1978-04-08,"R2","Sydney",16,8,104,"Hawthorn",18,24,132,"Lake Oval",-28,1978,"Regular",2,"Away","Hawthorn","Sydney",28
8256,1978-04-08,"R2","North Melbourne",25,16,166,"Richmond",14,9,93,"Arden St",73,1978,"Regular",2,"Home","North Melbourne","Richmond",73
8257,1978-04-15,"R3","Carlton",13,20,98,"Melbourne",11,19,85,"Princes Park",13,1978,"Regular",3,"Home","Carlton","Melbourne",13
8258,1978-04-15,"R3","Sydney",18,11,119,"Collingwood",14,18,102,"Lake Oval",17,1978,"Regular",3,"Home","Sydney","Collingwood",17
8259,1978-04-15,"R3","Essendon",15,15,105,"Fitzroy",14,17,101,"Windy Hill",4,1978,"Regular",3,"Home","Essendon","Fitzroy",4
8260,1978-04-15,"R3","Footscray",10,16,76,"Geelong",21,14,140,"Western Oval",-64,1978,"Regular",3,"Away","Geelong","Footscray",64
8261,1978-04-15,"R3","North Melbourne",16,15,111,"Hawthorn",12,14,86,"Waverley Park",25,1978,"Regular",3,"Home","North Melbourne","Hawthorn",25
8262,1978-04-15,"R3","Richmond",16,14,110,"St Kilda",15,20,110,"M.C.G.",0,1978,"Regular",3,"Home","Richmond","St Kilda",0
8263,1978-04-22,"R4","Carlton",16,8,104,"Essendon",19,17,131,"Waverley Park",-27,1978,"Regular",4,"Away","Essendon","Carlton",27
8264,1978-04-22,"R4","Collingwood",14,19,103,"Hawthorn",15,15,105,"Victoria Park",-2,1978,"Regular",4,"Away","Hawthorn","Collingwood",2
8265,1978-04-22,"R4","Fitzroy",21,17,143,"Sydney",18,16,124,"Junction Oval",19,1978,"Regular",4,"Home","Fitzroy","Sydney",19
8266,1978-04-22,"R4","Melbourne",18,19,127,"Footscray",18,12,120,"M.C.G.",7,1978,"Regular",4,"Home","Melbourne","Footscray",7
8267,1978-04-22,"R4","Geelong",18,17,125,"Richmond",15,8,98,"Kardinia Park",27,1978,"Regular",4,"Home","Geelong","Richmond",27
8268,1978-04-22,"R4","St Kilda",14,16,100,"North Melbourne",17,17,119,"Moorabbin Oval",-19,1978,"Regular",4,"Away","North Melbourne","St Kilda",19
8269,1978-04-25,"R5","St Kilda",14,14,98,"Geelong",9,11,65,"Waverley Park",33,1978,"Regular",5,"Home","St Kilda","Geelong",33
8270,1978-04-25,"R5","Richmond",19,16,130,"Melbourne",8,11,59,"M.C.G.",71,1978,"Regular",5,"Home","Richmond","Melbourne",71
8271,1978-04-29,"R5","Sydney",18,9,117,"Carlton",17,14,116,"Lake Oval",1,1978,"Regular",5,"Home","Sydney","Carlton",1
8272,1978-04-29,"R5","North Melbourne",19,10,124,"Collingwood",17,13,115,"Arden St",9,1978,"Regular",5,"Home","North Melbourne","Collingwood",9
8273,1978-04-29,"R5","Footscray",15,20,110,"Essendon",13,15,93,"Western Oval",17,1978,"Regular",5,"Home","Footscray","Essendon",17
8274,1978-04-29,"R5","Hawthorn",14,17,101,"Fitzroy",15,12,102,"Princes Park",-1,1978,"Regular",5,"Away","Fitzroy","Hawthorn",1
8275,1978-05-06,"R6","Carlton",19,12,126,"Hawthorn",24,13,157,"Princes Park",-31,1978,"Regular",6,"Away","Hawthorn","Carlton",31
8276,1978-05-06,"R6","Fitzroy",14,12,96,"Collingwood",22,16,148,"Junction Oval",-52,1978,"Regular",6,"Away","Collingwood","Fitzroy",52
8277,1978-05-06,"R6","Essendon",22,18,150,"Richmond",19,15,129,"Windy Hill",21,1978,"Regular",6,"Home","Essendon","Richmond",21
8278,1978-05-06,"R6","Footscray",16,9,105,"Sydney",18,15,123,"Waverley Park",-18,1978,"Regular",6,"Away","Sydney","Footscray",18
8279,1978-05-06,"R6","Geelong",12,16,88,"North Melbourne",16,14,110,"Kardinia Park",-22,1978,"Regular",6,"Away","North Melbourne","Geelong",22
8280,1978-05-06,"R6","Melbourne",21,15,141,"St Kilda",31,18,204,"M.C.G.",-63,1978,"Regular",6,"Away","St Kilda","Melbourne",63
8281,1978-05-13,"R7","Collingwood",9,14,68,"Carlton",12,13,85,"Victoria Park",-17,1978,"Regular",7,"Away","Carlton","Collingwood",17
8282,1978-05-13,"R7","St Kilda",17,11,113,"Essendon",16,11,107,"Moorabbin Oval",6,1978,"Regular",7,"Home","St Kilda","Essendon",6
8283,1978-05-13,"R7","North Melbourne",14,14,98,"Fitzroy",14,11,95,"Arden St",3,1978,"Regular",7,"Home","North Melbourne","Fitzroy",3
8284,1978-05-13,"R7","Hawthorn",27,15,177,"Footscray",13,13,91,"Princes Park",86,1978,"Regular",7,"Home","Hawthorn","Footscray",86
8285,1978-05-13,"R7","Geelong",18,18,126,"Melbourne",21,13,139,"Waverley Park",-13,1978,"Regular",7,"Away","Melbourne","Geelong",13
8286,1978-05-13,"R7","Richmond",14,14,98,"Sydney",19,11,125,"M.C.G.",-27,1978,"Regular",7,"Away","Sydney","Richmond",27
8287,1978-05-20,"R8","Carlton",8,15,63,"Fitzroy",9,7,61,"Princes Park",2,1978,"Regular",8,"Home","Carlton","Fitzroy",2
8288,1978-05-20,"R8","Footscray",14,5,89,"Collingwood",14,9,93,"Western Oval",-4,1978,"Regular",8,"Away","Collingwood","Footscray",4
8289,1978-05-20,"R8","Essendon",11,10,76,"Geelong",7,18,60,"Windy Hill",16,1978,"Regular",8,"Home","Essendon","Geelong",16
8290,1978-05-20,"R8","Richmond",9,16,70,"Hawthorn",14,15,99,"Waverley Park",-29,1978,"Regular",8,"Away","Hawthorn","Richmond",29
8291,1978-05-20,"R8","Melbourne",8,13,61,"North Melbourne",20,17,137,"M.C.G.",-76,1978,"Regular",8,"Away","North Melbourne","Melbourne",76
8292,1978-05-20,"R8","Sydney",20,16,136,"St Kilda",4,13,37,"Lake Oval",99,1978,"Regular",8,"Home","Sydney","St Kilda",99
8293,1978-05-27,"R9","Carlton",18,9,117,"North Melbourne",8,11,59,"Princes Park",58,1978,"Regular",9,"Home","Carlton","North Melbourne",58
8294,1978-05-27,"R9","Collingwood",12,20,92,"Richmond",10,16,76,"Victoria Park",16,1978,"Regular",9,"Home","Collingwood","Richmond",16
8295,1978-05-27,"R9","Melbourne",8,12,60,"Essendon",15,12,102,"Waverley Park",-42,1978,"Regular",9,"Away","Essendon","Melbourne",42
8296,1978-05-27,"R9","Fitzroy",13,14,92,"Footscray",18,9,117,"Junction Oval",-25,1978,"Regular",9,"Away","Footscray","Fitzroy",25
8297,1978-05-27,"R9","Geelong",16,13,109,"Sydney",14,11,95,"Kardinia Park",14,1978,"Regular",9,"Home","Geelong","Sydney",14
8298,1978-05-27,"R9","St Kilda",8,9,57,"Hawthorn",13,19,97,"Moorabbin Oval",-40,1978,"Regular",9,"Away","Hawthorn","St Kilda",40
8299,1978-06-03,"R10","North Melbourne",13,7,85,"Essendon",12,10,82,"Arden St",3,1978,"Regular",10,"Home","North Melbourne","Essendon",3
8300,1978-06-03,"R10","Richmond",12,14,86,"Fitzroy",11,14,80,"M.C.G.",6,1978,"Regular",10,"Home","Richmond","Fitzroy",6
8301,1978-06-03,"R10","Hawthorn",12,24,96,"Geelong",8,13,61,"Princes Park",35,1978,"Regular",10,"Home","Hawthorn","Geelong",35
8302,1978-06-05,"R10","Footscray",19,11,125,"Carlton",15,14,104,"Western Oval",21,1978,"Regular",10,"Home","Footscray","Carlton",21
8303,1978-06-05,"R10","St Kilda",14,13,97,"Collingwood",18,23,131,"Waverley Park",-34,1978,"Regular",10,"Away","Collingwood","St Kilda",34
8304,1978-06-05,"R10","Sydney",24,18,162,"Melbourne",14,8,92,"Lake Oval",70,1978,"Regular",10,"Home","Sydney","Melbourne",70
8305,1978-06-17,"R11","Carlton",23,27,165,"St Kilda",8,17,65,"Princes Park",100,1978,"Regular",11,"Home","Carlton","St Kilda",100
8306,1978-06-17,"R11","Collingwood",17,25,127,"Melbourne",10,7,67,"Victoria Park",60,1978,"Regular",11,"Home","Collingwood","Melbourne",60
8307,1978-06-17,"R11","Essendon",16,8,104,"Hawthorn",19,19,133,"Windy Hill",-29,1978,"Regular",11,"Away","Hawthorn","Essendon",29
8308,1978-06-17,"R11","Fitzroy",16,15,111,"Geelong",16,18,114,"Junction Oval",-3,1978,"Regular",11,"Away","Geelong","Fitzroy",3
8309,1978-06-17,"R11","Richmond",23,17,155,"Footscray",14,13,97,"M.C.G.",58,1978,"Regular",11,"Home","Richmond","Footscray",58
8310,1978-06-17,"R11","Sydney",15,7,97,"North Melbourne",17,15,117,"Waverley Park",-20,1978,"Regular",11,"Away","North Melbourne","Sydney",20
8311,1978-06-24,"R12","Carlton",20,17,137,"Richmond",13,16,94,"Princes Park",43,1978,"Regular",12,"Home","Carlton","Richmond",43
8312,1978-06-24,"R12","Collingwood",7,14,56,"Geelong",13,18,96,"Waverley Park",-40,1978,"Regular",12,"Away","Geelong","Collingwood",40
8313,1978-06-24,"R12","Sydney",13,19,97,"Essendon",17,18,120,"Lake Oval",-23,1978,"Regular",12,"Away","Essendon","Sydney",23
8314,1978-06-24,"R12","St Kilda",17,9,111,"Fitzroy",20,14,134,"Moorabbin Oval",-23,1978,"Regular",12,"Away","Fitzroy","St Kilda",23
8315,1978-06-24,"R12","North Melbourne",8,12,60,"Footscray",13,12,90,"Arden St",-30,1978,"Regular",12,"Away","Footscray","North Melbourne",30
8316,1978-06-24,"R12","Melbourne",15,18,108,"Hawthorn",18,20,128,"M.C.G.",-20,1978,"Regular",12,"Away","Hawthorn","Melbourne",20
8317,1978-07-01,"R13","Geelong",8,9,57,"Carlton",9,13,67,"Kardinia Park",-10,1978,"Regular",13,"Away","Carlton","Geelong",10
8318,1978-07-01,"R13","Essendon",12,26,98,"Collingwood",14,21,105,"Windy Hill",-7,1978,"Regular",13,"Away","Collingwood","Essendon",7
8319,1978-07-01,"R13","Fitzroy",19,27,141,"Melbourne",8,13,61,"Waverley Park",80,1978,"Regular",13,"Home","Fitzroy","Melbourne",80
8320,1978-07-01,"R13","Footscray",33,15,213,"St Kilda",16,10,106,"Western Oval",107,1978,"Regular",13,"Home","Footscray","St Kilda",107
8321,1978-07-01,"R13","Hawthorn",21,14,140,"Sydney",18,11,119,"Princes Park",21,1978,"Regular",13,"Home","Hawthorn","Sydney",21
8322,1978-07-01,"R13","Richmond",21,16,142,"North Melbourne",17,15,117,"M.C.G.",25,1978,"Regular",13,"Home","Richmond","North Melbourne",25
8323,1978-07-08,"R14","Essendon",13,24,102,"Carlton",14,11,95,"Windy Hill",7,1978,"Regular",14,"Home","Essendon","Carlton",7
8324,1978-07-08,"R14","Hawthorn",10,14,74,"Collingwood",13,6,84,"Waverley Park",-10,1978,"Regular",14,"Away","Collingwood","Hawthorn",10
8325,1978-07-08,"R14","Sydney",22,11,143,"Fitzroy",13,15,93,"Lake Oval",50,1978,"Regular",14,"Home","Sydney","Fitzroy",50
8326,1978-07-08,"R14","Footscray",20,7,127,"Melbourne",8,11,59,"Western Oval",68,1978,"Regular",14,"Home","Footscray","Melbourne",68
8327,1978-07-08,"R14","Richmond",17,20,122,"Geelong",18,9,117,"M.C.G.",5,1978,"Regular",14,"Home","Richmond","Geelong",5
8328,1978-07-08,"R14","North Melbourne",19,7,121,"St Kilda",18,16,124,"Arden St",-3,1978,"Regular",14,"Away","St Kilda","North Melbourne",3
8329,1978-07-15,"R15","Melbourne",2,14,26,"Carlton",17,13,115,"Waverley Park",-89,1978,"Regular",15,"Away","Carlton","Melbourne",89
8330,1978-07-15,"R15","Collingwood",17,12,114,"Sydney",12,22,94,"Victoria Park",20,1978,"Regular",15,"Home","Collingwood","Sydney",20
8331,1978-07-15,"R15","Fitzroy",15,11,101,"Essendon",11,17,83,"Junction Oval",18,1978,"Regular",15,"Home","Fitzroy","Essendon",18
8332,1978-07-15,"R15","Geelong",12,12,84,"Footscray",10,12,72,"Kardinia Park",12,1978,"Regular",15,"Home","Geelong","Footscray",12
8333,1978-07-15,"R15","Hawthorn",10,14,74,"North Melbourne",7,13,55,"Princes Park",19,1978,"Regular",15,"Home","Hawthorn","North Melbourne",19
8334,1978-07-15,"R15","St Kilda",10,11,71,"Richmond",19,11,125,"Moorabbin Oval",-54,1978,"Regular",15,"Away","Richmond","St Kilda",54
8335,1978-07-22,"R16","Carlton",16,16,112,"Sydney",9,17,71,"Princes Park",41,1978,"Regular",16,"Home","Carlton","Sydney",41
8336,1978-07-22,"R16","Collingwood",7,17,59,"North Melbourne",15,11,101,"Victoria Park",-42,1978,"Regular",16,"Away","North Melbourne","Collingwood",42
8337,1978-07-22,"R16","Essendon",13,8,86,"Footscray",15,17,107,"Waverley Park",-21,1978,"Regular",16,"Away","Footscray","Essendon",21
8338,1978-07-22,"R16","Fitzroy",18,14,122,"Hawthorn",17,19,121,"Junction Oval",1,1978,"Regular",16,"Home","Fitzroy","Hawthorn",1
8339,1978-07-22,"R16","Geelong",16,8,104,"St Kilda",12,20,92,"Kardinia Park",12,1978,"Regular",16,"Home","Geelong","St Kilda",12
8340,1978-07-22,"R16","Melbourne",14,9,93,"Richmond",17,19,121,"M.C.G.",-28,1978,"Regular",16,"Away","Richmond","Melbourne",28
8341,1978-07-29,"R17","Hawthorn",13,17,95,"Carlton",18,11,119,"Princes Park",-24,1978,"Regular",17,"Away","Carlton","Hawthorn",24
8342,1978-07-29,"R17","Collingwood",16,11,107,"Fitzroy",11,11,77,"Waverley Park",30,1978,"Regular",17,"Home","Collingwood","Fitzroy",30
8343,1978-07-29,"R17","Richmond",20,16,136,"Essendon",13,18,96,"M.C.G.",40,1978,"Regular",17,"Home","Richmond","Essendon",40
8344,1978-07-29,"R17","Sydney",15,15,105,"Footscray",13,13,91,"Lake Oval",14,1978,"Regular",17,"Home","Sydney","Footscray",14
8345,1978-07-29,"R17","North Melbourne",18,14,122,"Geelong",10,16,76,"Arden St",46,1978,"Regular",17,"Home","North Melbourne","Geelong",46
8346,1978-07-29,"R17","St Kilda",20,21,141,"Melbourne",13,11,89,"Moorabbin Oval",52,1978,"Regular",17,"Home","St Kilda","Melbourne",52
8347,1978-08-05,"R18","Carlton",14,19,103,"Collingwood",8,14,62,"Princes Park",41,1978,"Regular",18,"Home","Carlton","Collingwood",41
8348,1978-08-05,"R18","Essendon",11,16,82,"St Kilda",18,13,121,"Windy Hill",-39,1978,"Regular",18,"Away","St Kilda","Essendon",39
8349,1978-08-05,"R18","Fitzroy",11,16,82,"North Melbourne",19,10,124,"Junction Oval",-42,1978,"Regular",18,"Away","North Melbourne","Fitzroy",42
8350,1978-08-05,"R18","Footscray",17,10,112,"Hawthorn",17,16,118,"Western Oval",-6,1978,"Regular",18,"Away","Hawthorn","Footscray",6
8351,1978-08-05,"R18","Melbourne",13,17,95,"Geelong",14,17,101,"M.C.G.",-6,1978,"Regular",18,"Away","Geelong","Melbourne",6
8352,1978-08-05,"R18","Sydney",14,9,93,"Richmond",9,16,70,"Waverley Park",23,1978,"Regular",18,"Home","Sydney","Richmond",23
8353,1978-08-12,"R19","Fitzroy",8,10,58,"Carlton",9,15,69,"Waverley Park",-11,1978,"Regular",19,"Away","Carlton","Fitzroy",11
8354,1978-08-12,"R19","Collingwood",11,16,82,"Footscray",10,6,66,"Victoria Park",16,1978,"Regular",19,"Home","Collingwood","Footscray",16
8355,1978-08-12,"R19","Geelong",14,8,92,"Essendon",13,7,85,"Kardinia Park",7,1978,"Regular",19,"Home","Geelong","Essendon",7
8356,1978-08-12,"R19","Hawthorn",18,19,127,"Richmond",10,10,70,"Princes Park",57,1978,"Regular",19,"Home","Hawthorn","Richmond",57
8357,1978-08-12,"R19","North Melbourne",26,18,174,"Melbourne",8,13,61,"Arden St",113,1978,"Regular",19,"Home","North Melbourne","Melbourne",113
8358,1978-08-12,"R19","St Kilda",13,7,85,"Sydney",3,19,37,"Moorabbin Oval",48,1978,"Regular",19,"Home","St Kilda","Sydney",48
8359,1978-08-19,"R20","North Melbourne",9,16,70,"Carlton",19,17,131,"Arden St",-61,1978,"Regular",20,"Away","Carlton","North Melbourne",61
8360,1978-08-19,"R20","Richmond",16,13,109,"Collingwood",19,9,123,"M.C.G.",-14,1978,"Regular",20,"Away","Collingwood","Richmond",14
8361,1978-08-19,"R20","Essendon",19,16,130,"Melbourne",21,10,136,"Windy Hill",-6,1978,"Regular",20,"Away","Melbourne","Essendon",6
8362,1978-08-19,"R20","Footscray",9,17,71,"Fitzroy",21,13,139,"Western Oval",-68,1978,"Regular",20,"Away","Fitzroy","Footscray",68
8363,1978-08-19,"R20","Sydney",24,11,155,"Geelong",26,11,167,"Lake Oval",-12,1978,"Regular",20,"Away","Geelong","Sydney",12
8364,1978-08-19,"R20","Hawthorn",12,11,83,"St Kilda",21,13,139,"Waverley Park",-56,1978,"Regular",20,"Away","St Kilda","Hawthorn",56
8365,1978-08-26,"R21","Carlton",23,7,145,"Footscray",15,12,102,"Princes Park",43,1978,"Regular",21,"Home","Carlton","Footscray",43
8366,1978-08-26,"R21","Collingwood",22,15,147,"St Kilda",15,17,107,"Victoria Park",40,1978,"Regular",21,"Home","Collingwood","St Kilda",40
8367,1978-08-26,"R21","Essendon",7,9,51,"North Melbourne",11,11,77,"Waverley Park",-26,1978,"Regular",21,"Away","North Melbourne","Essendon",26
8368,1978-08-26,"R21","Fitzroy",20,14,134,"Richmond",17,15,117,"Junction Oval",17,1978,"Regular",21,"Home","Fitzroy","Richmond",17
8369,1978-08-26,"R21","Geelong",13,8,86,"Hawthorn",13,10,88,"Kardinia Park",-2,1978,"Regular",21,"Away","Hawthorn","Geelong",2
8370,1978-08-26,"R21","Melbourne",15,16,106,"Sydney",11,19,85,"M.C.G.",21,1978,"Regular",21,"Home","Melbourne","Sydney",21
8371,1978-09-02,"R22","St Kilda",16,10,106,"Carlton",9,12,66,"Moorabbin Oval",40,1978,"Regular",22,"Home","St Kilda","Carlton",40
8372,1978-09-02,"R22","Melbourne",19,11,125,"Collingwood",24,12,156,"M.C.G.",-31,1978,"Regular",22,"Away","Collingwood","Melbourne",31
8373,1978-09-02,"R22","Hawthorn",17,16,118,"Essendon",16,13,109,"Princes Park",9,1978,"Regular",22,"Home","Hawthorn","Essendon",9
8374,1978-09-02,"R22","Geelong",13,22,100,"Fitzroy",5,8,38,"Kardinia Park",62,1978,"Regular",22,"Home","Geelong","Fitzroy",62
8375,1978-09-02,"R22","Footscray",11,15,81,"Richmond",19,20,134,"Waverley Park",-53,1978,"Regular",22,"Away","Richmond","Footscray",53
8376,1978-09-02,"R22","North Melbourne",16,15,111,"Sydney",12,15,87,"Arden St",24,1978,"Regular",22,"Home","North Melbourne","Sydney",24
8377,1978-09-09,"EF","Carlton",15,15,105,"Geelong",9,18,72,"Waverley Park",33,1978,"Finals",23,"Home","Carlton","Geelong",33
8378,1978-09-09,"QF","Hawthorn",23,16,154,"Collingwood",14,14,98,"M.C.G.",56,1978,"Finals",23,"Home","Hawthorn","Collingwood",56
8379,1978-09-16,"SF","Collingwood",15,18,108,"Carlton",13,15,93,"M.C.G.",15,1978,"Finals",24,"Home","Collingwood","Carlton",15
8380,1978-09-16,"SF","North Melbourne",10,13,73,"Hawthorn",12,15,87,"Waverley Park",-14,1978,"Finals",24,"Away","Hawthorn","North Melbourne",14
8381,1978-09-23,"PF","North Melbourne",14,12,96,"Collingwood",12,12,84,"Waverley Park",12,1978,"Finals",25,"Home","North Melbourne","Collingwood",12
8382,1978-09-30,"GF","North Melbourne",15,13,103,"Hawthorn",18,13,121,"M.C.G.",-18,1978,"Finals",26,"Away","Hawthorn","North Melbourne",18
8383,1979-03-31,"R3","Essendon",11,14,80,"Carlton",14,17,101,"Waverley Park",-21,1979,"Regular",3,"Away","Carlton","Essendon",21
8384,1979-04-07,"R1","Carlton",23,13,151,"Geelong",15,11,101,"Princes Park",50,1979,"Regular",1,"Home","Carlton","Geelong",50
8385,1979-04-07,"R1","Collingwood",9,15,69,"Fitzroy",21,23,149,"Victoria Park",-80,1979,"Regular",1,"Away","Fitzroy","Collingwood",80
8386,1979-04-07,"R1","North Melbourne",17,27,129,"Essendon",16,13,109,"Arden St",20,1979,"Regular",1,"Home","North Melbourne","Essendon",20
8387,1979-04-07,"R1","Melbourne",18,17,125,"Footscray",16,17,113,"M.C.G.",12,1979,"Regular",1,"Home","Melbourne","Footscray",12
8388,1979-04-07,"R1","St Kilda",19,14,128,"Hawthorn",14,19,103,"Moorabbin Oval",25,1979,"Regular",1,"Home","St Kilda","Hawthorn",25
8389,1979-04-07,"R1","Sydney",15,21,111,"Richmond",19,11,125,"Lake Oval",-14,1979,"Regular",1,"Away","Richmond","Sydney",14
8390,1979-04-14,"R2","Hawthorn",13,24,102,"Collingwood",19,18,132,"Princes Park",-30,1979,"Regular",2,"Away","Collingwood","Hawthorn",30
8391,1979-04-14,"R2","Fitzroy",12,14,86,"Sydney",21,13,139,"Junction Oval",-53,1979,"Regular",2,"Away","Sydney","Fitzroy",53
8392,1979-04-14,"R2","Footscray",13,16,94,"North Melbourne",20,13,133,"Western Oval",-39,1979,"Regular",2,"Away","North Melbourne","Footscray",39
8393,1979-04-16,"R2","Richmond",13,18,96,"Carlton",23,9,147,"M.C.G.",-51,1979,"Regular",2,"Away","Carlton","Richmond",51
8394,1979-04-16,"R2","Essendon",21,22,148,"St Kilda",9,10,64,"Windy Hill",84,1979,"Regular",2,"Home","Essendon","St Kilda",84
8395,1979-04-16,"R2","Geelong",15,16,106,"Melbourne",9,13,67,"Kardinia Park",39,1979,"Regular",2,"Home","Geelong","Melbourne",39
8396,1979-04-21,"R3","North Melbourne",18,19,127,"Collingwood",14,15,99,"Arden St",28,1979,"Regular",3,"Home","North Melbourne","Collingwood",28
8397,1979-04-21,"R3","Richmond",20,12,132,"Fitzroy",16,16,112,"M.C.G.",20,1979,"Regular",3,"Home","Richmond","Fitzroy",20
8398,1979-04-21,"R3","St Kilda",15,14,104,"Footscray",16,13,109,"Moorabbin Oval",-5,1979,"Regular",3,"Away","Footscray","St Kilda",5
8399,1979-04-21,"R3","Hawthorn",18,15,123,"Geelong",11,17,83,"Princes Park",40,1979,"Regular",3,"Home","Hawthorn","Geelong",40
8400,1979-04-21,"R3","Sydney",18,10,118,"Melbourne",16,15,111,"Lake Oval",7,1979,"Regular",3,"Home","Sydney","Melbourne",7
8401,1979-04-25,"R4","Hawthorn",29,15,189,"Sydney",15,5,95,"Waverley Park",94,1979,"Regular",4,"Home","Hawthorn","Sydney",94
8402,1979-04-25,"R4","Melbourne",16,23,119,"Richmond",15,19,109,"M.C.G.",10,1979,"Regular",4,"Home","Melbourne","Richmond",10
8403,1979-04-28,"R4","Fitzroy",11,16,82,"Carlton",20,19,139,"Junction Oval",-57,1979,"Regular",4,"Away","Carlton","Fitzroy",57
8404,1979-04-28,"R4","Collingwood",31,21,207,"St Kilda",3,11,29,"Victoria Park",178,1979,"Regular",4,"Home","Collingwood","St Kilda",178
8405,1979-04-28,"R4","Footscray",20,8,128,"Essendon",19,14,128,"Western Oval",0,1979,"Regular",4,"Home","Footscray","Essendon",0
8406,1979-04-28,"R4","Geelong",10,13,73,"North Melbourne",19,9,123,"Kardinia Park",-50,1979,"Regular",4,"Away","North Melbourne","Geelong",50
8407,1979-05-05,"R5","Carlton",15,20,110,"Melbourne",13,18,96,"Princes Park",14,1979,"Regular",5,"Home","Carlton","Melbourne",14
8408,1979-05-05,"R5","Footscray",12,17,89,"Collingwood",20,17,137,"Waverley Park",-48,1979,"Regular",5,"Away","Collingwood","Footscray",48
8409,1979-05-05,"R5","Essendon",10,16,76,"Fitzroy",25,22,172,"Windy Hill",-96,1979,"Regular",5,"Away","Fitzroy","Essendon",96
8410,1979-05-05,"R5","St Kilda",17,10,112,"Geelong",22,10,142,"Moorabbin Oval",-30,1979,"Regular",5,"Away","Geelong","St Kilda",30
8411,1979-05-05,"R5","Richmond",11,16,82,"Hawthorn",24,17,161,"M.C.G.",-79,1979,"Regular",5,"Away","Hawthorn","Richmond",79
8412,1979-05-05,"R5","North Melbourne",19,24,138,"Sydney",12,16,88,"Arden St",50,1979,"Regular",5,"Home","North Melbourne","Sydney",50
8413,1979-05-12,"R6","Hawthorn",16,12,108,"Carlton",25,18,168,"Princes Park",-60,1979,"Regular",6,"Away","Carlton","Hawthorn",60
8414,1979-05-12,"R6","Collingwood",14,15,99,"Essendon",19,19,133,"Victoria Park",-34,1979,"Regular",6,"Away","Essendon","Collingwood",34
8415,1979-05-12,"R6","Melbourne",21,14,140,"Fitzroy",24,19,163,"M.C.G.",-23,1979,"Regular",6,"Away","Fitzroy","Melbourne",23
8416,1979-05-12,"R6","Geelong",9,18,72,"Footscray",7,5,47,"Kardinia Park",25,1979,"Regular",6,"Home","Geelong","Footscray",25
8417,1979-05-12,"R6","North Melbourne",14,15,99,"Richmond",13,16,94,"Waverley Park",5,1979,"Regular",6,"Home","North Melbourne","Richmond",5
8418,1979-05-12,"R6","Sydney",26,19,175,"St Kilda",11,20,86,"Lake Oval",89,1979,"Regular",6,"Home","Sydney","St Kilda",89
8419,1979-05-19,"R7","Carlton",15,14,104,"North Melbourne",16,12,108,"Princes Park",-4,1979,"Regular",7,"Away","North Melbourne","Carlton",4
8420,1979-05-19,"R7","Collingwood",13,14,92,"Geelong",6,15,51,"Waverley Park",41,1979,"Regular",7,"Home","Collingwood","Geelong",41
8421,1979-05-19,"R7","Essendon",23,18,156,"Melbourne",9,20,74,"Windy Hill",82,1979,"Regular",7,"Home","Essendon","Melbourne",82
8422,1979-05-19,"R7","Fitzroy",14,18,102,"Hawthorn",11,24,90,"Junction Oval",12,1979,"Regular",7,"Home","Fitzroy","Hawthorn",12
8423,1979-05-19,"R7","Footscray",22,17,149,"Sydney",14,17,101,"Western Oval",48,1979,"Regular",7,"Home","Footscray","Sydney",48
8424,1979-05-19,"R7","St Kilda",16,15,111,"Richmond",14,15,99,"Moorabbin Oval",12,1979,"Regular",7,"Home","St Kilda","Richmond",12
8425,1979-05-26,"R8","St Kilda",9,10,64,"Carlton",15,13,103,"Waverley Park",-39,1979,"Regular",8,"Away","Carlton","St Kilda",39
8426,1979-05-26,"R8","Sydney",6,8,44,"Collingwood",20,11,131,"Lake Oval",-87,1979,"Regular",8,"Away","Collingwood","Sydney",87
8427,1979-05-26,"R8","Geelong",12,11,83,"Essendon",12,12,84,"Kardinia Park",-1,1979,"Regular",8,"Away","Essendon","Geelong",1
8428,1979-05-26,"R8","North Melbourne",13,16,94,"Fitzroy",21,22,148,"Arden St",-54,1979,"Regular",8,"Away","Fitzroy","North Melbourne",54
8429,1979-05-26,"R8","Richmond",22,26,158,"Footscray",12,13,85,"M.C.G.",73,1979,"Regular",8,"Home","Richmond","Footscray",73
8430,1979-05-26,"R8","Hawthorn",17,18,120,"Melbourne",10,17,77,"Princes Park",43,1979,"Regular",8,"Home","Hawthorn","Melbourne",43
8431,1979-06-02,"R9","Footscray",11,12,78,"Carlton",18,19,127,"Western Oval",-49,1979,"Regular",9,"Away","Carlton","Footscray",49
8432,1979-06-02,"R9","Collingwood",19,18,132,"Richmond",10,20,80,"Victoria Park",52,1979,"Regular",9,"Home","Collingwood","Richmond",52
8433,1979-06-02,"R9","Hawthorn",16,12,108,"Essendon",17,14,116,"Princes Park",-8,1979,"Regular",9,"Away","Essendon","Hawthorn",8
8434,1979-06-02,"R9","Fitzroy",18,15,123,"St Kilda",11,12,78,"Junction Oval",45,1979,"Regular",9,"Home","Fitzroy","St Kilda",45
8435,1979-06-02,"R9","Geelong",18,15,123,"Sydney",17,8,110,"Waverley Park",13,1979,"Regular",9,"Home","Geelong","Sydney",13
8436,1979-06-02,"R9","Melbourne",17,9,111,"North Melbourne",23,18,156,"M.C.G.",-45,1979,"Regular",9,"Away","North Melbourne","Melbourne",45
8437,1979-06-09,"R10","Carlton",18,15,123,"Collingwood",16,11,107,"Princes Park",16,1979,"Regular",10,"Home","Carlton","Collingwood",16
8438,1979-06-09,"R10","Essendon",16,19,115,"Sydney",14,15,99,"Windy Hill",16,1979,"Regular",10,"Home","Essendon","Sydney",16
8439,1979-06-09,"R10","Footscray",11,8,74,"Fitzroy",17,17,119,"Waverley Park",-45,1979,"Regular",10,"Away","Fitzroy","Footscray",45
8440,1979-06-09,"R10","Richmond",14,17,101,"Geelong",18,19,127,"M.C.G.",-26,1979,"Regular",10,"Away","Geelong","Richmond",26
8441,1979-06-09,"R10","St Kilda",9,11,65,"Melbourne",12,13,85,"Moorabbin Oval",-20,1979,"Regular",10,"Away","Melbourne","St Kilda",20
8442,1979-06-10,"R10","North Melbourne",16,9,105,"Hawthorn",23,18,156,"S.C.G.",-51,1979,"Regular",10,"Away","Hawthorn","North Melbourne",51
8443,1979-06-16,"R11","Melbourne",11,16,82,"Collingwood",13,18,96,"M.C.G.",-14,1979,"Regular",11,"Away","Collingwood","Melbourne",14
8444,1979-06-16,"R11","Fitzroy",19,18,132,"Geelong",9,11,65,"Junction Oval",67,1979,"Regular",11,"Home","Fitzroy","Geelong",67
8445,1979-06-16,"R11","Hawthorn",15,10,100,"Footscray",15,11,101,"Princes Park",-1,1979,"Regular",11,"Away","Footscray","Hawthorn",1
8446,1979-06-18,"R11","Sydney",18,18,126,"Carlton",20,12,132,"Lake Oval",-6,1979,"Regular",11,"Away","Carlton","Sydney",6
8447,1979-06-18,"R11","Richmond",16,12,108,"Essendon",20,12,132,"Waverley Park",-24,1979,"Regular",11,"Away","Essendon","Richmond",24
8448,1979-06-18,"R11","St Kilda",15,17,107,"North Melbourne",16,14,110,"Moorabbin Oval",-3,1979,"Regular",11,"Away","North Melbourne","St Kilda",3
8449,1979-06-23,"R12","Geelong",15,17,107,"Carlton",14,17,101,"Kardinia Park",6,1979,"Regular",12,"Home","Geelong","Carlton",6
8450,1979-06-23,"R12","Fitzroy",17,20,122,"Collingwood",11,14,80,"Waverley Park",42,1979,"Regular",12,"Home","Fitzroy","Collingwood",42
8451,1979-06-23,"R12","Essendon",15,11,101,"North Melbourne",6,18,54,"Windy Hill",47,1979,"Regular",12,"Home","Essendon","North Melbourne",47
8452,1979-06-23,"R12","Footscray",18,12,120,"Melbourne",11,15,81,"Western Oval",39,1979,"Regular",12,"Home","Footscray","Melbourne",39
8453,1979-06-23,"R12","Hawthorn",19,18,132,"St Kilda",13,15,93,"Princes Park",39,1979,"Regular",12,"Home","Hawthorn","St Kilda",39
8454,1979-06-23,"R12","Richmond",25,16,166,"Sydney",16,14,110,"M.C.G.",56,1979,"Regular",12,"Home","Richmond","Sydney",56
8455,1979-06-30,"R13","Carlton",21,12,138,"Richmond",12,10,82,"Princes Park",56,1979,"Regular",13,"Home","Carlton","Richmond",56
8456,1979-06-30,"R13","Collingwood",25,19,169,"Hawthorn",8,16,64,"Victoria Park",105,1979,"Regular",13,"Home","Collingwood","Hawthorn",105
8457,1979-06-30,"R13","St Kilda",9,12,66,"Essendon",15,15,105,"Moorabbin Oval",-39,1979,"Regular",13,"Away","Essendon","St Kilda",39
8458,1979-06-30,"R13","Sydney",15,20,110,"Fitzroy",20,16,136,"Lake Oval",-26,1979,"Regular",13,"Away","Fitzroy","Sydney",26
8459,1979-06-30,"R13","North Melbourne",8,21,69,"Footscray",12,9,81,"Arden St",-12,1979,"Regular",13,"Away","Footscray","North Melbourne",12
8460,1979-06-30,"R13","Melbourne",9,3,57,"Geelong",16,12,108,"Waverley Park",-51,1979,"Regular",13,"Away","Geelong","Melbourne",51
8461,1979-07-07,"R14","Carlton",17,14,116,"Fitzroy",9,11,65,"Waverley Park",51,1979,"Regular",14,"Home","Carlton","Fitzroy",51
8462,1979-07-07,"R14","St Kilda",6,16,52,"Collingwood",15,11,101,"Moorabbin Oval",-49,1979,"Regular",14,"Away","Collingwood","St Kilda",49
8463,1979-07-07,"R14","Essendon",10,11,71,"Footscray",6,14,50,"Windy Hill",21,1979,"Regular",14,"Home","Essendon","Footscray",21
8464,1979-07-07,"R14","North Melbourne",17,16,118,"Geelong",14,16,100,"Arden St",18,1979,"Regular",14,"Home","North Melbourne","Geelong",18
8465,1979-07-07,"R14","Sydney",13,11,89,"Hawthorn",10,14,74,"Lake Oval",15,1979,"Regular",14,"Home","Sydney","Hawthorn",15
8466,1979-07-07,"R14","Richmond",17,18,120,"Melbourne",10,16,76,"M.C.G.",44,1979,"Regular",14,"Home","Richmond","Melbourne",44
8467,1979-07-14,"R15","Carlton",18,18,126,"Essendon",12,11,83,"Princes Park",43,1979,"Regular",15,"Home","Carlton","Essendon",43
8468,1979-07-14,"R15","Collingwood",10,16,76,"North Melbourne",20,13,133,"Victoria Park",-57,1979,"Regular",15,"Away","North Melbourne","Collingwood",57
8469,1979-07-14,"R15","Footscray",24,16,160,"St Kilda",11,15,81,"Western Oval",79,1979,"Regular",15,"Home","Footscray","St Kilda",79
8470,1979-07-14,"R15","Geelong",11,12,78,"Hawthorn",11,13,79,"Waverley Park",-1,1979,"Regular",15,"Away","Hawthorn","Geelong",1
8471,1979-07-14,"R15","Melbourne",24,23,167,"Sydney",24,10,154,"M.C.G.",13,1979,"Regular",15,"Home","Melbourne","Sydney",13
8472,1979-07-15,"R15","Fitzroy",20,15,135,"Richmond",22,20,152,"S.C.G.",-17,1979,"Regular",15,"Away","Richmond","Fitzroy",17
8473,1979-07-21,"R16","Melbourne",9,7,61,"Carlton",19,26,140,"M.C.G.",-79,1979,"Regular",16,"Away","Carlton","Melbourne",79
8474,1979-07-21,"R16","Collingwood",23,17,155,"Footscray",3,15,33,"Victoria Park",122,1979,"Regular",16,"Home","Collingwood","Footscray",122
8475,1979-07-21,"R16","Fitzroy",16,16,112,"Essendon",15,9,99,"Junction Oval",13,1979,"Regular",16,"Home","Fitzroy","Essendon",13
8476,1979-07-21,"R16","Geelong",20,9,129,"St Kilda",14,20,104,"Kardinia Park",25,1979,"Regular",16,"Home","Geelong","St Kilda",25
8477,1979-07-21,"R16","Hawthorn",14,20,104,"Richmond",18,11,119,"Princes Park",-15,1979,"Regular",16,"Away","Richmond","Hawthorn",15
8478,1979-07-21,"R16","Sydney",8,18,66,"North Melbourne",12,16,88,"Waverley Park",-22,1979,"Regular",16,"Away","North Melbourne","Sydney",22
8479,1979-07-28,"R17","Carlton",15,21,111,"Hawthorn",12,11,83,"Princes Park",28,1979,"Regular",17,"Home","Carlton","Hawthorn",28
8480,1979-07-28,"R17","Essendon",9,17,71,"Collingwood",14,8,92,"Windy Hill",-21,1979,"Regular",17,"Away","Collingwood","Essendon",21
8481,1979-07-28,"R17","Fitzroy",36,22,238,"Melbourne",6,12,48,"Waverley Park",190,1979,"Regular",17,"Home","Fitzroy","Melbourne",190
8482,1979-07-28,"R17","Footscray",12,10,82,"Geelong",18,14,122,"Western Oval",-40,1979,"Regular",17,"Away","Geelong","Footscray",40
8483,1979-07-28,"R17","Richmond",16,15,111,"North Melbourne",19,10,124,"M.C.G.",-13,1979,"Regular",17,"Away","North Melbourne","Richmond",13
8484,1979-07-28,"R17","St Kilda",19,14,128,"Sydney",16,12,108,"Moorabbin Oval",20,1979,"Regular",17,"Home","St Kilda","Sydney",20
8485,1979-08-04,"R18","North Melbourne",18,11,119,"Carlton",21,15,141,"Arden St",-22,1979,"Regular",18,"Away","Carlton","North Melbourne",22
8486,1979-08-04,"R18","Geelong",18,16,124,"Collingwood",9,9,63,"Kardinia Park",61,1979,"Regular",18,"Home","Geelong","Collingwood",61
8487,1979-08-04,"R18","Melbourne",21,8,134,"Essendon",16,9,105,"M.C.G.",29,1979,"Regular",18,"Home","Melbourne","Essendon",29
8488,1979-08-04,"R18","Hawthorn",15,14,104,"Fitzroy",15,25,115,"Princes Park",-11,1979,"Regular",18,"Away","Fitzroy","Hawthorn",11
8489,1979-08-04,"R18","Sydney",31,9,195,"Footscray",15,16,106,"Lake Oval",89,1979,"Regular",18,"Home","Sydney","Footscray",89
8490,1979-08-04,"R18","Richmond",28,22,190,"St Kilda",18,11,119,"Waverley Park",71,1979,"Regular",18,"Home","Richmond","St Kilda",71
8491,1979-08-11,"R19","Carlton",22,17,149,"St Kilda",6,9,45,"Princes Park",104,1979,"Regular",19,"Home","Carlton","St Kilda",104
8492,1979-08-11,"R19","Collingwood",14,11,95,"Sydney",13,9,87,"Victoria Park",8,1979,"Regular",19,"Home","Collingwood","Sydney",8
8493,1979-08-11,"R19","Essendon",14,12,96,"Geelong",8,8,56,"Windy Hill",40,1979,"Regular",19,"Home","Essendon","Geelong",40
8494,1979-08-11,"R19","Fitzroy",7,12,54,"North Melbourne",17,19,121,"Junction Oval",-67,1979,"Regular",19,"Away","North Melbourne","Fitzroy",67
8495,1979-08-11,"R19","Footscray",13,19,97,"Richmond",6,5,41,"Western Oval",56,1979,"Regular",19,"Home","Footscray","Richmond",56
8496,1979-08-11,"R19","Melbourne",8,25,73,"Hawthorn",14,11,95,"Waverley Park",-22,1979,"Regular",19,"Away","Hawthorn","Melbourne",22
8497,1979-08-18,"R20","Carlton",12,18,90,"Footscray",8,6,54,"Waverley Park",36,1979,"Regular",20,"Home","Carlton","Footscray",36
8498,1979-08-18,"R20","Richmond",10,15,75,"Collingwood",13,17,95,"M.C.G.",-20,1979,"Regular",20,"Away","Collingwood","Richmond",20
8499,1979-08-18,"R20","Essendon",9,16,70,"Hawthorn",10,14,74,"Windy Hill",-4,1979,"Regular",20,"Away","Hawthorn","Essendon",4
8500,1979-08-18,"R20","St Kilda",9,6,60,"Fitzroy",10,16,76,"Moorabbin Oval",-16,1979,"Regular",20,"Away","Fitzroy","St Kilda",16
8501,1979-08-18,"R20","Sydney",16,6,102,"Geelong",10,12,72,"Lake Oval",30,1979,"Regular",20,"Home","Sydney","Geelong",30
8502,1979-08-18,"R20","North Melbourne",15,27,117,"Melbourne",6,9,45,"Arden St",72,1979,"Regular",20,"Home","North Melbourne","Melbourne",72
8503,1979-08-25,"R21","Collingwood",18,12,120,"Carlton",14,17,101,"Victoria Park",19,1979,"Regular",21,"Home","Collingwood","Carlton",19
8504,1979-08-25,"R21","Sydney",10,16,76,"Essendon",13,17,95,"Waverley Park",-19,1979,"Regular",21,"Away","Essendon","Sydney",19
8505,1979-08-25,"R21","Fitzroy",22,19,151,"Footscray",14,16,100,"Junction Oval",51,1979,"Regular",21,"Home","Fitzroy","Footscray",51
8506,1979-08-25,"R21","Geelong",17,13,115,"Richmond",12,17,89,"Kardinia Park",26,1979,"Regular",21,"Home","Geelong","Richmond",26
8507,1979-08-25,"R21","Hawthorn",7,18,60,"North Melbourne",24,21,165,"Princes Park",-105,1979,"Regular",21,"Away","North Melbourne","Hawthorn",105
8508,1979-08-25,"R21","Melbourne",24,17,161,"St Kilda",12,24,96,"M.C.G.",65,1979,"Regular",21,"Home","Melbourne","St Kilda",65
8509,1979-09-01,"R22","Carlton",23,16,154,"Sydney",17,19,121,"Princes Park",33,1979,"Regular",22,"Home","Carlton","Sydney",33
8510,1979-09-01,"R22","Collingwood",23,16,154,"Melbourne",15,13,103,"Victoria Park",51,1979,"Regular",22,"Home","Collingwood","Melbourne",51
8511,1979-09-01,"R22","Essendon",8,15,63,"Richmond",18,14,122,"Windy Hill",-59,1979,"Regular",22,"Away","Richmond","Essendon",59
8512,1979-09-01,"R22","Geelong",16,16,112,"Fitzroy",15,17,107,"Kardinia Park",5,1979,"Regular",22,"Home","Geelong","Fitzroy",5
8513,1979-09-01,"R22","Footscray",9,11,65,"Hawthorn",14,19,103,"Western Oval",-38,1979,"Regular",22,"Away","Hawthorn","Footscray",38
8514,1979-09-01,"R22","North Melbourne",21,18,144,"St Kilda",9,11,65,"Waverley Park",79,1979,"Regular",22,"Home","North Melbourne","St Kilda",79
8515,1979-09-08,"QF","North Melbourne",18,13,121,"Collingwood",9,28,82,"M.C.G.",39,1979,"Finals",23,"Home","North Melbourne","Collingwood",39
8516,1979-09-08,"EF","Fitzroy",17,22,124,"Essendon",5,13,43,"Waverley Park",81,1979,"Finals",23,"Home","Fitzroy","Essendon",81
8517,1979-09-15,"SF","Carlton",15,21,111,"North Melbourne",11,7,73,"Waverley Park",38,1979,"Finals",24,"Home","Carlton","North Melbourne",38
8518,1979-09-15,"SF","Collingwood",16,20,116,"Fitzroy",12,22,94,"M.C.G.",22,1979,"Finals",24,"Home","Collingwood","Fitzroy",22
8519,1979-09-22,"PF","North Melbourne",13,17,95,"Collingwood",18,14,122,"Waverley Park",-27,1979,"Finals",25,"Away","Collingwood","North Melbourne",27
8520,1979-09-29,"GF","Carlton",11,16,82,"Collingwood",11,11,77,"M.C.G.",5,1979,"Finals",26,"Home","Carlton","Collingwood",5
8521,1980-03-29,"R1","Collingwood",13,16,94,"Carlton",19,18,132,"Victoria Park",-38,1980,"Regular",1,"Away","Carlton","Collingwood",38
8522,1980-03-29,"R1","Essendon",12,15,87,"North Melbourne",15,10,100,"Windy Hill",-13,1980,"Regular",1,"Away","North Melbourne","Essendon",13
8523,1980-03-29,"R1","Footscray",17,11,113,"Fitzroy",18,17,125,"Western Oval",-12,1980,"Regular",1,"Away","Fitzroy","Footscray",12
8524,1980-03-29,"R1","Geelong",12,13,85,"Sydney",13,10,88,"Kardinia Park",-3,1980,"Regular",1,"Away","Sydney","Geelong",3
8525,1980-03-29,"R1","Hawthorn",15,16,106,"Richmond",16,15,111,"Princes Park",-5,1980,"Regular",1,"Away","Richmond","Hawthorn",5
8526,1980-03-29,"R1","St Kilda",14,16,100,"Melbourne",18,14,122,"Waverley Park",-22,1980,"Regular",1,"Away","Melbourne","St Kilda",22
8527,1980-04-05,"R2","North Melbourne",7,14,56,"Collingwood",7,19,61,"Arden St",-5,1980,"Regular",2,"Away","Collingwood","North Melbourne",5
8528,1980-04-05,"R2","Richmond",17,15,117,"Essendon",17,22,124,"M.C.G.",-7,1980,"Regular",2,"Away","Essendon","Richmond",7
8529,1980-04-05,"R2","St Kilda",11,17,83,"Hawthorn",15,26,116,"Moorabbin Oval",-33,1980,"Regular",2,"Away","Hawthorn","St Kilda",33
8530,1980-04-07,"R2","Carlton",14,25,109,"Geelong",15,14,104,"Princes Park",5,1980,"Regular",2,"Home","Carlton","Geelong",5
8531,1980-04-07,"R2","Fitzroy",17,14,116,"Melbourne",22,8,140,"Waverley Park",-24,1980,"Regular",2,"Away","Melbourne","Fitzroy",24
8532,1980-04-07,"R2","Sydney",14,17,101,"Footscray",10,13,73,"Lake Oval",28,1980,"Regular",2,"Home","Sydney","Footscray",28
8533,1980-04-12,"R3","Footscray",14,10,94,"Carlton",17,17,119,"Western Oval",-25,1980,"Regular",3,"Away","Carlton","Footscray",25
8534,1980-04-12,"R3","Hawthorn",19,16,130,"Collingwood",16,23,119,"Princes Park",11,1980,"Regular",3,"Home","Hawthorn","Collingwood",11
8535,1980-04-12,"R3","Sydney",14,17,101,"Essendon",24,12,156,"Waverley Park",-55,1980,"Regular",3,"Away","Essendon","Sydney",55
8536,1980-04-12,"R3","Fitzroy",14,18,102,"North Melbourne",21,22,148,"Junction Oval",-46,1980,"Regular",3,"Away","North Melbourne","Fitzroy",46
8537,1980-04-12,"R3","Geelong",17,17,119,"Melbourne",14,9,93,"Kardinia Park",26,1980,"Regular",3,"Home","Geelong","Melbourne",26
8538,1980-04-12,"R3","Richmond",18,20,128,"St Kilda",19,14,128,"M.C.G.",0,1980,"Regular",3,"Home","Richmond","St Kilda",0
8539,1980-04-19,"R4","Carlton",22,18,150,"Sydney",13,15,93,"Princes Park",57,1980,"Regular",4,"Home","Carlton","Sydney",57
8540,1980-04-19,"R4","Collingwood",8,9,57,"Richmond",16,13,109,"Victoria Park",-52,1980,"Regular",4,"Away","Richmond","Collingwood",52
8541,1980-04-19,"R4","St Kilda",11,17,83,"Essendon",12,8,80,"Moorabbin Oval",3,1980,"Regular",4,"Home","St Kilda","Essendon",3
8542,1980-04-19,"R4","Fitzroy",12,10,82,"Hawthorn",11,19,85,"Waverley Park",-3,1980,"Regular",4,"Away","Hawthorn","Fitzroy",3
8543,1980-04-19,"R4","Melbourne",18,21,129,"Footscray",18,12,120,"M.C.G.",9,1980,"Regular",4,"Home","Melbourne","Footscray",9
8544,1980-04-19,"R4","North Melbourne",10,9,69,"Geelong",16,10,106,"Arden St",-37,1980,"Regular",4,"Away","Geelong","North Melbourne",37
8545,1980-04-25,"R5","Carlton",14,19,103,"Melbourne",9,20,74,"Waverley Park",29,1980,"Regular",5,"Home","Carlton","Melbourne",29
8546,1980-04-25,"R5","Richmond",29,25,199,"Fitzroy",11,15,81,"M.C.G.",118,1980,"Regular",5,"Home","Richmond","Fitzroy",118
8547,1980-04-25,"R5","Geelong",14,10,94,"Hawthorn",13,11,89,"Kardinia Park",5,1980,"Regular",5,"Home","Geelong","Hawthorn",5
8548,1980-04-26,"R5","Essendon",9,15,69,"Collingwood",10,13,73,"Windy Hill",-4,1980,"Regular",5,"Away","Collingwood","Essendon",4
8549,1980-04-26,"R5","Sydney",17,20,122,"St Kilda",7,15,57,"Lake Oval",65,1980,"Regular",5,"Home","Sydney","St Kilda",65
8550,1980-04-27,"R5","Footscray",8,7,55,"North Melbourne",26,21,177,"S.C.G.",-122,1980,"Regular",5,"Away","North Melbourne","Footscray",122
8551,1980-05-03,"R6","North Melbourne",18,11,119,"Carlton",12,15,87,"Arden St",32,1980,"Regular",6,"Home","North Melbourne","Carlton",32
8552,1980-05-03,"R6","Collingwood",26,12,168,"St Kilda",16,12,108,"Victoria Park",60,1980,"Regular",6,"Home","Collingwood","St Kilda",60
8553,1980-05-03,"R6","Fitzroy",16,12,108,"Essendon",15,23,113,"Junction Oval",-5,1980,"Regular",6,"Away","Essendon","Fitzroy",5
8554,1980-05-03,"R6","Hawthorn",19,16,130,"Footscray",18,5,113,"Princes Park",17,1980,"Regular",6,"Home","Hawthorn","Footscray",17
8555,1980-05-03,"R6","Geelong",10,17,77,"Richmond",12,16,88,"Waverley Park",-11,1980,"Regular",6,"Away","Richmond","Geelong",11
8556,1980-05-03,"R6","Melbourne",15,14,104,"Sydney",19,16,130,"M.C.G.",-26,1980,"Regular",6,"Away","Sydney","Melbourne",26
8557,1980-05-10,"R7","Carlton",14,27,111,"Hawthorn",16,17,113,"Princes Park",-2,1980,"Regular",7,"Away","Hawthorn","Carlton",2
8558,1980-05-10,"R7","Sydney",17,13,115,"Collingwood",13,12,90,"Lake Oval",25,1980,"Regular",7,"Home","Sydney","Collingwood",25
8559,1980-05-10,"R7","Essendon",13,15,93,"Geelong",16,11,107,"Windy Hill",-14,1980,"Regular",7,"Away","Geelong","Essendon",14
8560,1980-05-10,"R7","St Kilda",12,20,92,"Fitzroy",18,23,131,"Moorabbin Oval",-39,1980,"Regular",7,"Away","Fitzroy","St Kilda",39
8561,1980-05-10,"R7","Footscray",10,10,70,"Richmond",27,18,180,"Western Oval",-110,1980,"Regular",7,"Away","Richmond","Footscray",110
8562,1980-05-10,"R7","Melbourne",10,12,72,"North Melbourne",24,15,159,"Waverley Park",-87,1980,"Regular",7,"Away","North Melbourne","Melbourne",87
8563,1980-05-17,"R8","Richmond",19,24,138,"Carlton",12,13,85,"M.C.G.",53,1980,"Regular",8,"Home","Richmond","Carlton",53
8564,1980-05-17,"R8","Fitzroy",17,16,118,"Collingwood",17,16,118,"Junction Oval",0,1980,"Regular",8,"Home","Fitzroy","Collingwood",0
8565,1980-05-17,"R8","Footscray",10,11,71,"Essendon",22,16,148,"Waverley Park",-77,1980,"Regular",8,"Away","Essendon","Footscray",77
8566,1980-05-17,"R8","Geelong",20,15,135,"St Kilda",10,12,72,"Kardinia Park",63,1980,"Regular",8,"Home","Geelong","St Kilda",63
8567,1980-05-17,"R8","Hawthorn",17,16,118,"Melbourne",15,18,108,"Princes Park",10,1980,"Regular",8,"Home","Hawthorn","Melbourne",10
8568,1980-05-17,"R8","North Melbourne",15,19,109,"Sydney",16,10,106,"Arden St",3,1980,"Regular",8,"Home","North Melbourne","Sydney",3
8569,1980-05-24,"R9","Collingwood",18,28,136,"Geelong",15,15,105,"Victoria Park",31,1980,"Regular",9,"Home","Collingwood","Geelong",31
8570,1980-05-24,"R9","Fitzroy",14,16,100,"Sydney",16,25,121,"Junction Oval",-21,1980,"Regular",9,"Away","Sydney","Fitzroy",21
8571,1980-05-24,"R9","St Kilda",19,15,129,"Footscray",15,13,103,"Moorabbin Oval",26,1980,"Regular",9,"Home","St Kilda","Footscray",26
8572,1980-05-24,"R9","North Melbourne",14,9,93,"Hawthorn",13,10,88,"Waverley Park",5,1980,"Regular",9,"Home","North Melbourne","Hawthorn",5
8573,1980-05-24,"R9","Melbourne",15,12,102,"Richmond",29,21,195,"M.C.G.",-93,1980,"Regular",9,"Away","Richmond","Melbourne",93
8574,1980-05-25,"R9","Essendon",13,16,94,"Carlton",20,11,131,"S.C.G.",-37,1980,"Regular",9,"Away","Carlton","Essendon",37
8575,1980-05-31,"R10","Carlton",14,20,104,"St Kilda",9,8,62,"Waverley Park",42,1980,"Regular",10,"Home","Carlton","St Kilda",42
8576,1980-05-31,"R10","Footscray",18,11,119,"Collingwood",24,17,161,"Western Oval",-42,1980,"Regular",10,"Away","Collingwood","Footscray",42
8577,1980-05-31,"R10","Essendon",17,18,120,"Melbourne",11,10,76,"Windy Hill",44,1980,"Regular",10,"Home","Essendon","Melbourne",44
8578,1980-05-31,"R10","Geelong",18,15,123,"Fitzroy",17,6,108,"Kardinia Park",15,1980,"Regular",10,"Home","Geelong","Fitzroy",15
8579,1980-05-31,"R10","Sydney",28,15,183,"Hawthorn",14,15,99,"Lake Oval",84,1980,"Regular",10,"Home","Sydney","Hawthorn",84
8580,1980-05-31,"R10","Richmond",15,15,105,"North Melbourne",13,20,98,"M.C.G.",7,1980,"Regular",10,"Home","Richmond","North Melbourne",7
8581,1980-06-07,"R11","Fitzroy",19,12,126,"Carlton",22,24,156,"Junction Oval",-30,1980,"Regular",11,"Away","Carlton","Fitzroy",30
8582,1980-06-07,"R11","Collingwood",19,15,129,"Melbourne",18,11,119,"Victoria Park",10,1980,"Regular",11,"Home","Collingwood","Melbourne",10
8583,1980-06-07,"R11","Hawthorn",9,17,71,"Essendon",13,11,89,"Princes Park",-18,1980,"Regular",11,"Away","Essendon","Hawthorn",18
8584,1980-06-07,"R11","Footscray",15,13,103,"Geelong",22,12,144,"Western Oval",-41,1980,"Regular",11,"Away","Geelong","Footscray",41
8585,1980-06-07,"R11","St Kilda",12,8,80,"North Melbourne",25,13,163,"Moorabbin Oval",-83,1980,"Regular",11,"Away","North Melbourne","St Kilda",83
8586,1980-06-07,"R11","Richmond",18,13,121,"Sydney",10,8,68,"Waverley Park",53,1980,"Regular",11,"Home","Richmond","Sydney",53
8587,1980-06-14,"R12","North Melbourne",15,11,101,"Essendon",10,12,72,"Arden St",29,1980,"Regular",12,"Home","North Melbourne","Essendon",29
8588,1980-06-14,"R12","Fitzroy",18,15,123,"Footscray",25,17,167,"Junction Oval",-44,1980,"Regular",12,"Away","Footscray","Fitzroy",44
8589,1980-06-14,"R12","Melbourne",19,20,134,"St Kilda",14,8,92,"M.C.G.",42,1980,"Regular",12,"Home","Melbourne","St Kilda",42
8590,1980-06-15,"R12","Sydney",12,12,84,"Geelong",21,21,147,"S.C.G.",-63,1980,"Regular",12,"Away","Geelong","Sydney",63
8591,1980-06-16,"R12","Carlton",13,12,90,"Collingwood",11,19,85,"Princes Park",5,1980,"Regular",12,"Home","Carlton","Collingwood",5
8592,1980-06-16,"R12","Richmond",16,12,108,"Hawthorn",11,22,88,"M.C.G.",20,1980,"Regular",12,"Home","Richmond","Hawthorn",20
8593,1980-06-21,"R13","Geelong",12,11,83,"Carlton",12,6,78,"Kardinia Park",5,1980,"Regular",13,"Home","Geelong","Carlton",5
8594,1980-06-21,"R13","Collingwood",20,19,139,"North Melbourne",13,15,93,"Waverley Park",46,1980,"Regular",13,"Home","Collingwood","North Melbourne",46
8595,1980-06-21,"R13","Essendon",15,17,107,"Richmond",16,21,117,"Windy Hill",-10,1980,"Regular",13,"Away","Richmond","Essendon",10
8596,1980-06-21,"R13","Melbourne",18,21,129,"Fitzroy",18,9,117,"M.C.G.",12,1980,"Regular",13,"Home","Melbourne","Fitzroy",12
8597,1980-06-21,"R13","Footscray",15,14,104,"Sydney",12,15,87,"Western Oval",17,1980,"Regular",13,"Home","Footscray","Sydney",17
8598,1980-06-21,"R13","Hawthorn",21,17,143,"St Kilda",16,13,109,"Princes Park",34,1980,"Regular",13,"Home","Hawthorn","St Kilda",34
8599,1980-06-28,"R14","Sydney",5,9,39,"Carlton",10,18,78,"Lake Oval",-39,1980,"Regular",14,"Away","Carlton","Sydney",39
8600,1980-06-28,"R14","Richmond",9,19,73,"Collingwood",7,22,64,"M.C.G.",9,1980,"Regular",14,"Home","Richmond","Collingwood",9
8601,1980-06-28,"R14","Essendon",6,12,48,"St Kilda",7,11,53,"Waverley Park",-5,1980,"Regular",14,"Away","St Kilda","Essendon",5
8602,1980-06-28,"R14","Hawthorn",21,17,143,"Fitzroy",8,7,55,"Princes Park",88,1980,"Regular",14,"Home","Hawthorn","Fitzroy",88
8603,1980-06-28,"R14","Footscray",10,13,73,"Melbourne",6,7,43,"Western Oval",30,1980,"Regular",14,"Home","Footscray","Melbourne",30
8604,1980-06-28,"R14","Geelong",13,6,84,"North Melbourne",4,3,27,"Kardinia Park",57,1980,"Regular",14,"Home","Geelong","North Melbourne",57
8605,1980-07-12,"R15","Melbourne",15,13,103,"Carlton",18,24,132,"M.C.G.",-29,1980,"Regular",15,"Away","Carlton","Melbourne",29
8606,1980-07-12,"R15","Collingwood",11,22,88,"Essendon",13,6,84,"Victoria Park",4,1980,"Regular",15,"Home","Collingwood","Essendon",4
8607,1980-07-12,"R15","Fitzroy",15,19,109,"Richmond",12,16,88,"Junction Oval",21,1980,"Regular",15,"Home","Fitzroy","Richmond",21
8608,1980-07-12,"R15","North Melbourne",15,19,109,"Footscray",7,8,50,"Arden St",59,1980,"Regular",15,"Home","North Melbourne","Footscray",59
8609,1980-07-12,"R15","Hawthorn",4,13,37,"Geelong",17,15,117,"Waverley Park",-80,1980,"Regular",15,"Away","Geelong","Hawthorn",80
8610,1980-07-12,"R15","St Kilda",5,6,36,"Sydney",6,14,50,"Moorabbin Oval",-14,1980,"Regular",15,"Away","Sydney","St Kilda",14
8611,1980-07-19,"R16","Carlton",24,16,160,"Footscray",15,13,103,"Princes Park",57,1980,"Regular",16,"Home","Carlton","Footscray",57
8612,1980-07-19,"R16","Collingwood",22,17,149,"Hawthorn",19,8,122,"Victoria Park",27,1980,"Regular",16,"Home","Collingwood","Hawthorn",27
8613,1980-07-19,"R16","Essendon",20,9,129,"Sydney",19,19,133,"Windy Hill",-4,1980,"Regular",16,"Away","Sydney","Essendon",4
8614,1980-07-19,"R16","North Melbourne",17,13,115,"Fitzroy",13,8,86,"Waverley Park",29,1980,"Regular",16,"Home","North Melbourne","Fitzroy",29
8615,1980-07-19,"R16","Melbourne",15,15,105,"Geelong",17,12,114,"M.C.G.",-9,1980,"Regular",16,"Away","Geelong","Melbourne",9
8616,1980-07-20,"R16","St Kilda",11,4,70,"Richmond",34,18,222,"S.C.G.",-152,1980,"Regular",16,"Away","Richmond","St Kilda",152
8617,1980-07-26,"R17","Carlton",14,17,101,"North Melbourne",20,13,133,"Princes Park",-32,1980,"Regular",17,"Away","North Melbourne","Carlton",32
8618,1980-07-26,"R17","St Kilda",16,11,107,"Collingwood",32,19,211,"Waverley Park",-104,1980,"Regular",17,"Away","Collingwood","St Kilda",104
8619,1980-07-26,"R17","Essendon",18,14,122,"Fitzroy",17,14,116,"Windy Hill",6,1980,"Regular",17,"Home","Essendon","Fitzroy",6
8620,1980-07-26,"R17","Footscray",25,10,160,"Hawthorn",15,17,107,"Western Oval",53,1980,"Regular",17,"Home","Footscray","Hawthorn",53
8621,1980-07-26,"R17","Richmond",13,15,93,"Geelong",16,14,110,"M.C.G.",-17,1980,"Regular",17,"Away","Geelong","Richmond",17
8622,1980-07-26,"R17","Sydney",17,22,124,"Melbourne",13,12,90,"Lake Oval",34,1980,"Regular",17,"Home","Sydney","Melbourne",34
8623,1980-08-02,"R18","Hawthorn",9,15,69,"Carlton",16,17,113,"Princes Park",-44,1980,"Regular",18,"Away","Carlton","Hawthorn",44
8624,1980-08-02,"R18","Collingwood",11,24,90,"Sydney",8,9,57,"Victoria Park",33,1980,"Regular",18,"Home","Collingwood","Sydney",33
8625,1980-08-02,"R18","Geelong",15,14,104,"Essendon",13,12,90,"Kardinia Park",14,1980,"Regular",18,"Home","Geelong","Essendon",14
8626,1980-08-02,"R18","Fitzroy",15,14,104,"St Kilda",12,8,80,"Junction Oval",24,1980,"Regular",18,"Home","Fitzroy","St Kilda",24
8627,1980-08-02,"R18","Richmond",23,18,156,"Footscray",6,5,41,"Waverley Park",115,1980,"Regular",18,"Home","Richmond","Footscray",115
8628,1980-08-02,"R18","North Melbourne",12,15,87,"Melbourne",7,15,57,"Arden St",30,1980,"Regular",18,"Home","North Melbourne","Melbourne",30
8629,1980-08-09,"R19","Carlton",12,19,91,"Richmond",10,10,70,"Princes Park",21,1980,"Regular",19,"Home","Carlton","Richmond",21
8630,1980-08-09,"R19","Collingwood",19,10,124,"Fitzroy",16,19,115,"Waverley Park",9,1980,"Regular",19,"Home","Collingwood","Fitzroy",9
8631,1980-08-09,"R19","Essendon",18,8,116,"Footscray",11,8,74,"Windy Hill",42,1980,"Regular",19,"Home","Essendon","Footscray",42
8632,1980-08-09,"R19","St Kilda",13,10,88,"Geelong",11,17,83,"Moorabbin Oval",5,1980,"Regular",19,"Home","St Kilda","Geelong",5
8633,1980-08-09,"R19","Melbourne",9,10,64,"Hawthorn",19,27,141,"M.C.G.",-77,1980,"Regular",19,"Away","Hawthorn","Melbourne",77
8634,1980-08-09,"R19","Sydney",12,13,85,"North Melbourne",11,7,73,"Lake Oval",12,1980,"Regular",19,"Home","Sydney","North Melbourne",12
8635,1980-08-16,"R20","Carlton",25,14,164,"Essendon",16,7,103,"Princes Park",61,1980,"Regular",20,"Home","Carlton","Essendon",61
8636,1980-08-16,"R20","Geelong",14,15,99,"Collingwood",12,9,81,"Kardinia Park",18,1980,"Regular",20,"Home","Geelong","Collingwood",18
8637,1980-08-16,"R20","Sydney",20,14,134,"Fitzroy",17,15,117,"Lake Oval",17,1980,"Regular",20,"Home","Sydney","Fitzroy",17
8638,1980-08-16,"R20","Footscray",16,22,118,"St Kilda",11,7,73,"Western Oval",45,1980,"Regular",20,"Home","Footscray","St Kilda",45
8639,1980-08-16,"R20","Hawthorn",11,13,79,"North Melbourne",20,15,135,"Waverley Park",-56,1980,"Regular",20,"Away","North Melbourne","Hawthorn",56
8640,1980-08-16,"R20","Richmond",26,18,174,"Melbourne",16,13,109,"M.C.G.",65,1980,"Regular",20,"Home","Richmond","Melbourne",65
8641,1980-08-23,"R21","St Kilda",13,9,87,"Carlton",20,16,136,"Moorabbin Oval",-49,1980,"Regular",21,"Away","Carlton","St Kilda",49
8642,1980-08-23,"R21","Collingwood",19,16,130,"Footscray",13,14,92,"Victoria Park",38,1980,"Regular",21,"Home","Collingwood","Footscray",38
8643,1980-08-23,"R21","Melbourne",14,17,101,"Essendon",18,14,122,"M.C.G.",-21,1980,"Regular",21,"Away","Essendon","Melbourne",21
8644,1980-08-23,"R21","Fitzroy",16,21,117,"Geelong",20,12,132,"Junction Oval",-15,1980,"Regular",21,"Away","Geelong","Fitzroy",15
8645,1980-08-23,"R21","Hawthorn",16,17,113,"Sydney",12,11,83,"Waverley Park",30,1980,"Regular",21,"Home","Hawthorn","Sydney",30
8646,1980-08-23,"R21","North Melbourne",14,14,98,"Richmond",15,19,109,"Arden St",-11,1980,"Regular",21,"Away","Richmond","North Melbourne",11
8647,1980-08-30,"R22","Carlton",21,20,146,"Fitzroy",20,22,142,"Princes Park",4,1980,"Regular",22,"Home","Carlton","Fitzroy",4
8648,1980-08-30,"R22","Melbourne",9,12,66,"Collingwood",19,10,124,"M.C.G.",-58,1980,"Regular",22,"Away","Collingwood","Melbourne",58
8649,1980-08-30,"R22","Essendon",15,12,102,"Hawthorn",8,14,62,"Windy Hill",40,1980,"Regular",22,"Home","Essendon","Hawthorn",40
8650,1980-08-30,"R22","Geelong",12,18,90,"Footscray",5,10,40,"Waverley Park",50,1980,"Regular",22,"Home","Geelong","Footscray",50
8651,1980-08-30,"R22","North Melbourne",11,17,83,"St Kilda",12,11,83,"Arden St",0,1980,"Regular",22,"Home","North Melbourne","St Kilda",0
8652,1980-08-30,"R22","Sydney",16,11,107,"Richmond",7,11,53,"Lake Oval",54,1980,"Regular",22,"Home","Sydney","Richmond",54
8653,1980-09-06,"QF","Carlton",10,14,74,"Richmond",18,8,116,"Waverley Park",-42,1980,"Finals",23,"Away","Richmond","Carlton",42
8654,1980-09-06,"EF","North Melbourne",14,12,96,"Collingwood",14,20,104,"M.C.G.",-8,1980,"Finals",23,"Away","Collingwood","North Melbourne",8
8655,1980-09-13,"SF","Carlton",15,12,102,"Collingwood",22,20,152,"M.C.G.",-50,1980,"Finals",24,"Away","Collingwood","Carlton",50
8656,1980-09-13,"SF","Geelong",11,5,71,"Richmond",14,11,95,"Waverley Park",-24,1980,"Finals",24,"Away","Richmond","Geelong",24
8657,1980-09-20,"PF","Geelong",13,11,89,"Collingwood",13,15,93,"Waverley Park",-4,1980,"Finals",25,"Away","Collingwood","Geelong",4
8658,1980-09-27,"GF","Richmond",23,21,159,"Collingwood",9,24,78,"M.C.G.",81,1980,"Finals",26,"Home","Richmond","Collingwood",81
8659,1981-03-28,"R1","Carlton",22,12,144,"Richmond",12,10,82,"Waverley Park",62,1981,"Regular",1,"Home","Carlton","Richmond",62
8660,1981-03-28,"R1","Fitzroy",20,13,133,"Collingwood",22,27,159,"Junction Oval",-26,1981,"Regular",1,"Away","Collingwood","Fitzroy",26
8661,1981-03-28,"R1","Geelong",10,17,77,"Essendon",10,11,71,"Kardinia Park",6,1981,"Regular",1,"Home","Geelong","Essendon",6
8662,1981-03-28,"R1","Footscray",16,12,108,"St Kilda",23,19,157,"Western Oval",-49,1981,"Regular",1,"Away","St Kilda","Footscray",49
8663,1981-03-28,"R1","Melbourne",16,16,112,"Hawthorn",23,15,153,"M.C.G.",-41,1981,"Regular",1,"Away","Hawthorn","Melbourne",41
8664,1981-03-28,"R1","North Melbourne",21,19,145,"Sydney",12,25,97,"Arden St",48,1981,"Regular",1,"Home","North Melbourne","Sydney",48
8665,1981-04-04,"R2","Hawthorn",16,11,107,"Carlton",17,21,123,"Princes Park",-16,1981,"Regular",2,"Away","Carlton","Hawthorn",16
8666,1981-04-04,"R2","Collingwood",26,22,178,"Footscray",13,6,84,"Victoria Park",94,1981,"Regular",2,"Home","Collingwood","Footscray",94
8667,1981-04-04,"R2","Essendon",16,15,111,"North Melbourne",15,9,99,"Windy Hill",12,1981,"Regular",2,"Home","Essendon","North Melbourne",12
8668,1981-04-04,"R2","Fitzroy",23,17,155,"Melbourne",16,14,110,"Waverley Park",45,1981,"Regular",2,"Home","Fitzroy","Melbourne",45
8669,1981-04-04,"R2","St Kilda",14,23,107,"Geelong",16,13,109,"Moorabbin Oval",-2,1981,"Regular",2,"Away","Geelong","St Kilda",2
8670,1981-04-04,"R2","Sydney",16,14,110,"Richmond",22,13,145,"Lake Oval",-35,1981,"Regular",2,"Away","Richmond","Sydney",35
8671,1981-04-11,"R3","Carlton",14,24,108,"Fitzroy",12,20,92,"Princes Park",16,1981,"Regular",3,"Home","Carlton","Fitzroy",16
8672,1981-04-11,"R3","St Kilda",19,21,135,"Collingwood",23,19,157,"Moorabbin Oval",-22,1981,"Regular",3,"Away","Collingwood","St Kilda",22
8673,1981-04-11,"R3","Richmond",17,16,118,"Essendon",16,18,114,"M.C.G.",4,1981,"Regular",3,"Home","Richmond","Essendon",4
8674,1981-04-11,"R3","Footscray",18,11,119,"Melbourne",18,12,120,"Western Oval",-1,1981,"Regular",3,"Away","Melbourne","Footscray",1
8675,1981-04-11,"R3","North Melbourne",15,26,116,"Geelong",14,5,89,"Arden St",27,1981,"Regular",3,"Home","North Melbourne","Geelong",27
8676,1981-04-11,"R3","Sydney",21,13,139,"Hawthorn",18,9,117,"Waverley Park",22,1981,"Regular",3,"Home","Sydney","Hawthorn",22
8677,1981-04-18,"R4","Fitzroy",25,19,169,"Sydney",14,16,100,"Junction Oval",69,1981,"Regular",4,"Home","Fitzroy","Sydney",69
8678,1981-04-18,"R4","Melbourne",10,16,76,"St Kilda",16,32,128,"M.C.G.",-52,1981,"Regular",4,"Away","St Kilda","Melbourne",52
8679,1981-04-18,"R4","North Melbourne",13,17,95,"Richmond",17,22,124,"Waverley Park",-29,1981,"Regular",4,"Away","Richmond","North Melbourne",29
8680,1981-04-20,"R4","Footscray",11,10,76,"Carlton",15,14,104,"Waverley Park",-28,1981,"Regular",4,"Away","Carlton","Footscray",28
8681,1981-04-20,"R4","Geelong",9,14,68,"Collingwood",11,10,76,"Kardinia Park",-8,1981,"Regular",4,"Away","Collingwood","Geelong",8
8682,1981-04-20,"R4","Essendon",11,13,79,"Hawthorn",13,16,94,"Windy Hill",-15,1981,"Regular",4,"Away","Hawthorn","Essendon",15
8683,1981-04-25,"R5","St Kilda",10,13,73,"Carlton",19,23,137,"Moorabbin Oval",-64,1981,"Regular",5,"Away","Carlton","St Kilda",64
8684,1981-04-25,"R5","Collingwood",21,20,146,"Melbourne",13,5,83,"Victoria Park",63,1981,"Regular",5,"Home","Collingwood","Melbourne",63
8685,1981-04-25,"R5","Essendon",15,14,104,"Fitzroy",19,11,125,"Waverley Park",-21,1981,"Regular",5,"Away","Fitzroy","Essendon",21
8686,1981-04-25,"R5","Sydney",18,22,130,"Footscray",9,14,68,"Lake Oval",62,1981,"Regular",5,"Home","Sydney","Footscray",62
8687,1981-04-25,"R5","Richmond",15,22,112,"Geelong",11,18,84,"M.C.G.",28,1981,"Regular",5,"Home","Richmond","Geelong",28
8688,1981-04-25,"R5","Hawthorn",17,16,118,"North Melbourne",11,17,83,"Princes Park",35,1981,"Regular",5,"Home","Hawthorn","North Melbourne",35
8689,1981-05-02,"R6","Carlton",12,15,87,"Collingwood",22,12,144,"Princes Park",-57,1981,"Regular",6,"Away","Collingwood","Carlton",57
8690,1981-05-02,"R6","Footscray",13,13,91,"Essendon",12,11,83,"Western Oval",8,1981,"Regular",6,"Home","Footscray","Essendon",8
8691,1981-05-02,"R6","North Melbourne",27,17,179,"Fitzroy",19,12,126,"Arden St",53,1981,"Regular",6,"Home","North Melbourne","Fitzroy",53
8692,1981-05-02,"R6","Richmond",10,19,79,"Hawthorn",23,16,154,"M.C.G.",-75,1981,"Regular",6,"Away","Hawthorn","Richmond",75
8693,1981-05-02,"R6","St Kilda",13,15,93,"Sydney",15,13,103,"Waverley Park",-10,1981,"Regular",6,"Away","Sydney","St Kilda",10
8694,1981-05-03,"R6","Geelong",22,21,153,"Melbourne",16,8,104,"S.C.G.",49,1981,"Regular",6,"Home","Geelong","Melbourne",49
8695,1981-05-09,"R7","Melbourne",8,8,56,"Carlton",12,24,96,"M.C.G.",-40,1981,"Regular",7,"Away","Carlton","Melbourne",40
8696,1981-05-09,"R7","Collingwood",18,15,123,"Sydney",7,16,58,"Victoria Park",65,1981,"Regular",7,"Home","Collingwood","Sydney",65
8697,1981-05-09,"R7","Essendon",14,17,101,"St Kilda",11,10,76,"Windy Hill",25,1981,"Regular",7,"Home","Essendon","St Kilda",25
8698,1981-05-09,"R7","Fitzroy",13,14,92,"Richmond",12,16,88,"Junction Oval",4,1981,"Regular",7,"Home","Fitzroy","Richmond",4
8699,1981-05-09,"R7","North Melbourne",17,16,118,"Footscray",7,12,54,"Waverley Park",64,1981,"Regular",7,"Home","North Melbourne","Footscray",64
8700,1981-05-09,"R7","Hawthorn",8,8,56,"Geelong",7,17,59,"Princes Park",-3,1981,"Regular",7,"Away","Geelong","Hawthorn",3
8701,1981-05-16,"R8","Geelong",12,8,80,"Carlton",12,13,85,"Kardinia Park",-5,1981,"Regular",8,"Away","Carlton","Geelong",5
8702,1981-05-16,"R8","Collingwood",14,3,87,"Essendon",21,18,144,"Waverley Park",-57,1981,"Regular",8,"Away","Essendon","Collingwood",57
8703,1981-05-16,"R8","Hawthorn",21,18,144,"Fitzroy",16,19,115,"Princes Park",29,1981,"Regular",8,"Home","Hawthorn","Fitzroy",29
8704,1981-05-16,"R8","Richmond",25,17,167,"Footscray",17,15,117,"M.C.G.",50,1981,"Regular",8,"Home","Richmond","Footscray",50
8705,1981-05-16,"R8","Sydney",17,25,127,"Melbourne",12,11,83,"Lake Oval",44,1981,"Regular",8,"Home","Sydney","Melbourne",44
8706,1981-05-16,"R8","St Kilda",8,16,64,"North Melbourne",25,18,168,"Moorabbin Oval",-104,1981,"Regular",8,"Away","North Melbourne","St Kilda",104
8707,1981-05-23,"R9","Carlton",25,22,172,"Sydney",11,7,73,"Princes Park",99,1981,"Regular",9,"Home","Carlton","Sydney",99
8708,1981-05-23,"R9","North Melbourne",12,26,98,"Collingwood",16,15,111,"Arden St",-13,1981,"Regular",9,"Away","Collingwood","North Melbourne",13
8709,1981-05-23,"R9","Melbourne",10,10,70,"Essendon",14,20,104,"M.C.G.",-34,1981,"Regular",9,"Away","Essendon","Melbourne",34
8710,1981-05-23,"R9","Fitzroy",13,15,93,"Geelong",16,18,114,"Junction Oval",-21,1981,"Regular",9,"Away","Geelong","Fitzroy",21
8711,1981-05-23,"R9","Footscray",10,14,74,"Hawthorn",11,18,84,"Western Oval",-10,1981,"Regular",9,"Away","Hawthorn","Footscray",10
8712,1981-05-23,"R9","Richmond",20,16,136,"St Kilda",15,15,105,"Waverley Park",31,1981,"Regular",9,"Home","Richmond","St Kilda",31
8713,1981-05-30,"R10","Essendon",11,13,79,"Carlton",6,8,44,"Windy Hill",35,1981,"Regular",10,"Home","Essendon","Carlton",35
8714,1981-05-30,"R10","Collingwood",17,10,112,"Richmond",8,9,57,"Victoria Park",55,1981,"Regular",10,"Home","Collingwood","Richmond",55
8715,1981-05-30,"R10","Fitzroy",22,15,147,"Footscray",10,10,70,"Junction Oval",77,1981,"Regular",10,"Home","Fitzroy","Footscray",77
8716,1981-05-30,"R10","Geelong",14,8,92,"Sydney",10,10,70,"Kardinia Park",22,1981,"Regular",10,"Home","Geelong","Sydney",22
8717,1981-05-30,"R10","Hawthorn",13,17,95,"St Kilda",11,14,80,"Princes Park",15,1981,"Regular",10,"Home","Hawthorn","St Kilda",15
8718,1981-05-30,"R10","Melbourne",6,7,43,"North Melbourne",25,22,172,"Waverley Park",-129,1981,"Regular",10,"Away","North Melbourne","Melbourne",129
8719,1981-06-06,"R11","Carlton",17,13,115,"North Melbourne",11,18,84,"Princes Park",31,1981,"Regular",11,"Home","Carlton","North Melbourne",31
8720,1981-06-06,"R11","St Kilda",14,15,99,"Fitzroy",7,17,59,"Moorabbin Oval",40,1981,"Regular",11,"Home","St Kilda","Fitzroy",40
8721,1981-06-06,"R11","Richmond",20,16,136,"Melbourne",14,10,94,"M.C.G.",42,1981,"Regular",11,"Home","Richmond","Melbourne",42
8722,1981-06-08,"R11","Hawthorn",18,19,127,"Collingwood",12,9,81,"Waverley Park",46,1981,"Regular",11,"Home","Hawthorn","Collingwood",46
8723,1981-06-08,"R11","Sydney",12,8,80,"Essendon",15,18,108,"Lake Oval",-28,1981,"Regular",11,"Away","Essendon","Sydney",28
8724,1981-06-08,"R11","Footscray",12,10,82,"Geelong",17,15,117,"Western Oval",-35,1981,"Regular",11,"Away","Geelong","Footscray",35
8725,1981-06-13,"R12","Carlton",21,13,139,"Hawthorn",14,16,100,"Princes Park",39,1981,"Regular",12,"Home","Carlton","Hawthorn",39
8726,1981-06-13,"R12","Footscray",13,15,93,"Collingwood",14,14,98,"Western Oval",-5,1981,"Regular",12,"Away","Collingwood","Footscray",5
8727,1981-06-13,"R12","North Melbourne",13,12,90,"Essendon",18,29,137,"Arden St",-47,1981,"Regular",12,"Away","Essendon","North Melbourne",47
8728,1981-06-13,"R12","Melbourne",13,12,90,"Fitzroy",17,32,134,"M.C.G.",-44,1981,"Regular",12,"Away","Fitzroy","Melbourne",44
8729,1981-06-13,"R12","Geelong",19,21,135,"St Kilda",4,11,35,"Kardinia Park",100,1981,"Regular",12,"Home","Geelong","St Kilda",100
8730,1981-06-13,"R12","Richmond",19,12,126,"Sydney",16,15,111,"Waverley Park",15,1981,"Regular",12,"Home","Richmond","Sydney",15
8731,1981-06-20,"R13","Fitzroy",20,11,131,"Carlton",15,16,106,"Junction Oval",25,1981,"Regular",13,"Home","Fitzroy","Carlton",25
8732,1981-06-20,"R13","Collingwood",19,14,128,"St Kilda",10,11,71,"Victoria Park",57,1981,"Regular",13,"Home","Collingwood","St Kilda",57
8733,1981-06-20,"R13","Essendon",12,22,94,"Richmond",13,12,90,"Windy Hill",4,1981,"Regular",13,"Home","Essendon","Richmond",4
8734,1981-06-20,"R13","Melbourne",14,10,94,"Footscray",19,11,125,"Waverley Park",-31,1981,"Regular",13,"Away","Footscray","Melbourne",31
8735,1981-06-20,"R13","Geelong",26,14,170,"North Melbourne",8,8,56,"Kardinia Park",114,1981,"Regular",13,"Home","Geelong","North Melbourne",114
8736,1981-06-20,"R13","Hawthorn",20,18,138,"Sydney",15,16,106,"Princes Park",32,1981,"Regular",13,"Home","Hawthorn","Sydney",32
8737,1981-06-27,"R14","Carlton",15,25,115,"Footscray",5,4,34,"Princes Park",81,1981,"Regular",14,"Home","Carlton","Footscray",81
8738,1981-06-27,"R14","Collingwood",13,8,86,"Geelong",9,14,68,"Waverley Park",18,1981,"Regular",14,"Home","Collingwood","Geelong",18
8739,1981-06-27,"R14","Sydney",9,16,70,"Fitzroy",14,9,93,"Lake Oval",-23,1981,"Regular",14,"Away","Fitzroy","Sydney",23
8740,1981-06-27,"R14","St Kilda",18,19,127,"Melbourne",8,7,55,"Moorabbin Oval",72,1981,"Regular",14,"Home","St Kilda","Melbourne",72
8741,1981-06-27,"R14","Richmond",21,23,149,"North Melbourne",15,16,106,"M.C.G.",43,1981,"Regular",14,"Home","Richmond","North Melbourne",43
8742,1981-06-28,"R14","Hawthorn",20,13,133,"Essendon",22,19,151,"Gabba",-18,1981,"Regular",14,"Away","Essendon","Hawthorn",18
8743,1981-07-04,"R15","Carlton",6,14,50,"St Kilda",5,5,35,"Waverley Park",15,1981,"Regular",15,"Home","Carlton","St Kilda",15
8744,1981-07-04,"R15","Fitzroy",8,13,61,"Essendon",11,14,80,"Junction Oval",-19,1981,"Regular",15,"Away","Essendon","Fitzroy",19
8745,1981-07-04,"R15","North Melbourne",7,13,55,"Hawthorn",16,19,115,"Arden St",-60,1981,"Regular",15,"Away","Hawthorn","North Melbourne",60
8746,1981-07-11,"R15","Melbourne",10,6,66,"Collingwood",12,16,88,"M.C.G.",-22,1981,"Regular",15,"Away","Collingwood","Melbourne",22
8747,1981-07-11,"R15","Footscray",7,9,51,"Sydney",17,12,114,"Western Oval",-63,1981,"Regular",15,"Away","Sydney","Footscray",63
8748,1981-07-11,"R15","Geelong",12,10,82,"Richmond",8,4,52,"Kardinia Park",30,1981,"Regular",15,"Home","Geelong","Richmond",30
8749,1981-07-18,"R16","Collingwood",11,11,77,"Carlton",10,16,76,"Victoria Park",1,1981,"Regular",16,"Home","Collingwood","Carlton",1
8750,1981-07-18,"R16","Essendon",22,21,153,"Footscray",8,12,60,"Windy Hill",93,1981,"Regular",16,"Home","Essendon","Footscray",93
8751,1981-07-18,"R16","Fitzroy",18,13,121,"North Melbourne",12,15,87,"Waverley Park",34,1981,"Regular",16,"Home","Fitzroy","North Melbourne",34
8752,1981-07-18,"R16","Melbourne",12,7,79,"Geelong",22,35,167,"M.C.G.",-88,1981,"Regular",16,"Away","Geelong","Melbourne",88
8753,1981-07-18,"R16","Hawthorn",12,14,86,"Richmond",20,11,131,"Princes Park",-45,1981,"Regular",16,"Away","Richmond","Hawthorn",45
8754,1981-07-18,"R16","Sydney",22,19,151,"St Kilda",16,4,100,"Lake Oval",51,1981,"Regular",16,"Home","Sydney","St Kilda",51
8755,1981-07-25,"R17","Carlton",23,15,153,"Melbourne",15,10,100,"Princes Park",53,1981,"Regular",17,"Home","Carlton","Melbourne",53
8756,1981-07-25,"R17","St Kilda",12,4,76,"Essendon",12,21,93,"Moorabbin Oval",-17,1981,"Regular",17,"Away","Essendon","St Kilda",17
8757,1981-07-25,"R17","Richmond",16,19,115,"Fitzroy",17,14,116,"M.C.G.",-1,1981,"Regular",17,"Away","Fitzroy","Richmond",1
8758,1981-07-25,"R17","Footscray",18,8,116,"North Melbourne",19,11,125,"Western Oval",-9,1981,"Regular",17,"Away","North Melbourne","Footscray",9
8759,1981-07-25,"R17","Geelong",10,11,71,"Hawthorn",8,9,57,"Kardinia Park",14,1981,"Regular",17,"Home","Geelong","Hawthorn",14
8760,1981-07-26,"R17","Sydney",18,13,121,"Collingwood",15,13,103,"S.C.G.",18,1981,"Regular",17,"Home","Sydney","Collingwood",18
8761,1981-08-01,"R18","Carlton",17,13,115,"Geelong",12,10,82,"Princes Park",33,1981,"Regular",18,"Home","Carlton","Geelong",33
8762,1981-08-01,"R18","Fitzroy",10,13,73,"Hawthorn",7,19,61,"Junction Oval",12,1981,"Regular",18,"Home","Fitzroy","Hawthorn",12
8763,1981-08-01,"R18","Footscray",9,15,69,"Richmond",15,13,103,"Waverley Park",-34,1981,"Regular",18,"Away","Richmond","Footscray",34
8764,1981-08-01,"R18","Melbourne",12,14,86,"Sydney",17,13,115,"M.C.G.",-29,1981,"Regular",18,"Away","Sydney","Melbourne",29
8765,1981-08-01,"R18","North Melbourne",16,21,117,"St Kilda",12,13,85,"Arden St",32,1981,"Regular",18,"Home","North Melbourne","St Kilda",32
8766,1981-08-02,"R18","Essendon",12,16,88,"Collingwood",9,15,69,"M.C.G.",19,1981,"Regular",18,"Home","Essendon","Collingwood",19
8767,1981-08-08,"R19","Collingwood",14,19,103,"North Melbourne",11,13,79,"Victoria Park",24,1981,"Regular",19,"Home","Collingwood","North Melbourne",24
8768,1981-08-08,"R19","Essendon",14,20,104,"Melbourne",9,6,60,"Windy Hill",44,1981,"Regular",19,"Home","Essendon","Melbourne",44
8769,1981-08-08,"R19","Geelong",11,19,85,"Fitzroy",9,16,70,"Waverley Park",15,1981,"Regular",19,"Home","Geelong","Fitzroy",15
8770,1981-08-08,"R19","Hawthorn",15,21,111,"Footscray",13,12,90,"Princes Park",21,1981,"Regular",19,"Home","Hawthorn","Footscray",21
8771,1981-08-08,"R19","St Kilda",9,11,65,"Richmond",10,11,71,"Moorabbin Oval",-6,1981,"Regular",19,"Away","Richmond","St Kilda",6
8772,1981-08-09,"R19","Sydney",8,14,62,"Carlton",13,7,85,"M.C.G.",-23,1981,"Regular",19,"Away","Carlton","Sydney",23
8773,1981-08-15,"R20","Carlton",15,8,98,"Essendon",14,15,99,"Princes Park",-1,1981,"Regular",20,"Away","Essendon","Carlton",1
8774,1981-08-15,"R20","Richmond",11,20,86,"Collingwood",14,7,91,"M.C.G.",-5,1981,"Regular",20,"Away","Collingwood","Richmond",5
8775,1981-08-15,"R20","Footscray",12,14,86,"Fitzroy",22,15,147,"Western Oval",-61,1981,"Regular",20,"Away","Fitzroy","Footscray",61
8776,1981-08-15,"R20","Sydney",12,14,86,"Geelong",21,13,139,"Lake Oval",-53,1981,"Regular",20,"Away","Geelong","Sydney",53
8777,1981-08-15,"R20","St Kilda",9,14,68,"Hawthorn",10,17,77,"Waverley Park",-9,1981,"Regular",20,"Away","Hawthorn","St Kilda",9
8778,1981-08-15,"R20","North Melbourne",21,19,145,"Melbourne",13,9,87,"Arden St",58,1981,"Regular",20,"Home","North Melbourne","Melbourne",58
8779,1981-08-22,"R21","North Melbourne",8,14,62,"Carlton",12,12,84,"Waverley Park",-22,1981,"Regular",21,"Away","Carlton","North Melbourne",22
8780,1981-08-22,"R21","Collingwood",22,17,149,"Hawthorn",11,10,76,"Victoria Park",73,1981,"Regular",21,"Home","Collingwood","Hawthorn",73
8781,1981-08-22,"R21","Essendon",26,23,179,"Sydney",10,8,68,"Windy Hill",111,1981,"Regular",21,"Home","Essendon","Sydney",111
8782,1981-08-22,"R21","Fitzroy",14,18,102,"St Kilda",9,10,64,"Junction Oval",38,1981,"Regular",21,"Home","Fitzroy","St Kilda",38
8783,1981-08-22,"R21","Geelong",18,20,128,"Footscray",8,11,59,"Kardinia Park",69,1981,"Regular",21,"Home","Geelong","Footscray",69
8784,1981-08-22,"R21","Melbourne",15,9,99,"Richmond",17,14,116,"M.C.G.",-17,1981,"Regular",21,"Away","Richmond","Melbourne",17
8785,1981-08-29,"R22","Richmond",5,10,40,"Carlton",9,13,67,"M.C.G.",-27,1981,"Regular",22,"Away","Carlton","Richmond",27
8786,1981-08-29,"R22","Collingwood",4,9,33,"Fitzroy",8,11,59,"Victoria Park",-26,1981,"Regular",22,"Away","Fitzroy","Collingwood",26
8787,1981-08-29,"R22","Essendon",6,11,47,"Geelong",7,13,55,"Waverley Park",-8,1981,"Regular",22,"Away","Geelong","Essendon",8
8788,1981-08-29,"R22","St Kilda",12,15,87,"Footscray",5,8,38,"Moorabbin Oval",49,1981,"Regular",22,"Home","St Kilda","Footscray",49
8789,1981-08-29,"R22","Hawthorn",15,20,110,"Melbourne",8,9,57,"Princes Park",53,1981,"Regular",22,"Home","Hawthorn","Melbourne",53
8790,1981-08-29,"R22","Sydney",10,14,74,"North Melbourne",15,17,107,"Lake Oval",-33,1981,"Regular",22,"Away","North Melbourne","Sydney",33
8791,1981-09-05,"QF","Collingwood",13,20,98,"Geelong",16,16,112,"M.C.G.",-14,1981,"Finals",23,"Away","Geelong","Collingwood",14
8792,1981-09-05,"EF","Essendon",13,16,94,"Fitzroy",16,13,109,"Waverley Park",-15,1981,"Finals",23,"Away","Fitzroy","Essendon",15
8793,1981-09-12,"SF","Carlton",16,17,113,"Geelong",11,7,73,"Waverley Park",40,1981,"Finals",24,"Home","Carlton","Geelong",40
8794,1981-09-12,"SF","Collingwood",19,19,133,"Fitzroy",19,18,132,"M.C.G.",1,1981,"Finals",24,"Home","Collingwood","Fitzroy",1
8795,1981-09-19,"PF","Collingwood",12,10,82,"Geelong",11,9,75,"Waverley Park",7,1981,"Finals",25,"Home","Collingwood","Geelong",7
8796,1981-09-26,"GF","Carlton",12,20,92,"Collingwood",10,12,72,"M.C.G.",20,1981,"Finals",26,"Home","Carlton","Collingwood",20
8797,1982-03-20,"R2","Fitzroy",13,11,89,"Richmond",20,10,130,"Waverley Park",-41,1982,"Regular",2,"Away","Richmond","Fitzroy",41
8798,1982-03-27,"R1","Carlton",16,17,113,"Fitzroy",17,11,113,"Princes Park",0,1982,"Regular",1,"Home","Carlton","Fitzroy",0
8799,1982-03-27,"R1","Collingwood",7,16,58,"Geelong",21,20,146,"Waverley Park",-88,1982,"Regular",1,"Away","Geelong","Collingwood",88
8800,1982-03-27,"R1","Essendon",29,16,190,"Footscray",11,15,81,"Windy Hill",109,1982,"Regular",1,"Home","Essendon","Footscray",109
8801,1982-03-27,"R1","St Kilda",12,16,88,"Hawthorn",17,17,119,"Moorabbin Oval",-31,1982,"Regular",1,"Away","Hawthorn","St Kilda",31
8802,1982-03-27,"R1","Richmond",18,14,122,"North Melbourne",15,14,104,"M.C.G.",18,1982,"Regular",1,"Home","Richmond","North Melbourne",18
8803,1982-03-28,"R1","Sydney",20,17,137,"Melbourne",16,12,108,"S.C.G.",29,1982,"Regular",1,"Home","Sydney","Melbourne",29
8804,1982-04-03,"R2","Carlton",8,17,65,"Essendon",13,13,91,"Waverley Park",-26,1982,"Regular",2,"Away","Essendon","Carlton",26
8805,1982-04-03,"R2","Footscray",14,8,92,"Collingwood",15,14,104,"Western Oval",-12,1982,"Regular",2,"Away","Collingwood","Footscray",12
8806,1982-04-03,"R2","Hawthorn",13,19,97,"Geelong",11,12,78,"Princes Park",19,1982,"Regular",2,"Home","Hawthorn","Geelong",19
8807,1982-04-03,"R2","Melbourne",20,26,146,"St Kilda",16,10,106,"M.C.G.",40,1982,"Regular",2,"Home","Melbourne","St Kilda",40
8808,1982-04-03,"R2","North Melbourne",24,13,157,"Sydney",16,21,117,"Arden St",40,1982,"Regular",2,"Home","North Melbourne","Sydney",40
8809,1982-04-10,"R3","Collingwood",13,16,94,"Carlton",20,8,128,"Victoria Park",-34,1982,"Regular",3,"Away","Carlton","Collingwood",34
8810,1982-04-10,"R3","Fitzroy",14,16,100,"North Melbourne",25,14,164,"Junction Oval",-64,1982,"Regular",3,"Away","North Melbourne","Fitzroy",64
8811,1982-04-10,"R3","St Kilda",17,14,116,"Sydney",20,22,142,"Moorabbin Oval",-26,1982,"Regular",3,"Away","Sydney","St Kilda",26
8812,1982-04-12,"R3","Richmond",25,22,172,"Essendon",16,14,110,"M.C.G.",62,1982,"Regular",3,"Home","Richmond","Essendon",62
8813,1982-04-12,"R3","Hawthorn",28,26,194,"Footscray",7,9,51,"Waverley Park",143,1982,"Regular",3,"Home","Hawthorn","Footscray",143
8814,1982-04-12,"R3","Geelong",21,12,138,"Melbourne",5,16,46,"Kardinia Park",92,1982,"Regular",3,"Home","Geelong","Melbourne",92
8815,1982-04-17,"R4","Carlton",21,22,148,"Hawthorn",12,15,87,"Princes Park",61,1982,"Regular",4,"Home","Carlton","Hawthorn",61
8816,1982-04-17,"R4","Richmond",15,17,107,"Collingwood",10,15,75,"Waverley Park",32,1982,"Regular",4,"Home","Richmond","Collingwood",32
8817,1982-04-17,"R4","Essendon",12,19,91,"North Melbourne",14,24,108,"Windy Hill",-17,1982,"Regular",4,"Away","North Melbourne","Essendon",17
8818,1982-04-17,"R4","Melbourne",19,12,126,"Footscray",19,19,133,"M.C.G.",-7,1982,"Regular",4,"Away","Footscray","Melbourne",7
8819,1982-04-17,"R4","St Kilda",16,9,105,"Geelong",13,14,92,"Moorabbin Oval",13,1982,"Regular",4,"Home","St Kilda","Geelong",13
8820,1982-04-18,"R4","Sydney",24,18,162,"Fitzroy",14,22,106,"S.C.G.",56,1982,"Regular",4,"Home","Sydney","Fitzroy",56
8821,1982-04-24,"R5","Melbourne",9,12,66,"Carlton",9,22,76,"Waverley Park",-10,1982,"Regular",5,"Away","Carlton","Melbourne",10
8822,1982-04-24,"R5","North Melbourne",19,22,136,"Collingwood",18,11,119,"Arden St",17,1982,"Regular",5,"Home","North Melbourne","Collingwood",17
8823,1982-04-24,"R5","Fitzroy",18,19,127,"Essendon",15,12,102,"Junction Oval",25,1982,"Regular",5,"Home","Fitzroy","Essendon",25
8824,1982-04-24,"R5","Footscray",15,20,110,"St Kilda",20,9,129,"Western Oval",-19,1982,"Regular",5,"Away","St Kilda","Footscray",19
8825,1982-04-24,"R5","Geelong",12,12,84,"Sydney",11,16,82,"Kardinia Park",2,1982,"Regular",5,"Home","Geelong","Sydney",2
8826,1982-04-24,"R5","Hawthorn",13,22,100,"Richmond",10,22,82,"Princes Park",18,1982,"Regular",5,"Home","Hawthorn","Richmond",18
8827,1982-05-01,"R6","St Kilda",11,14,80,"Carlton",16,22,118,"Moorabbin Oval",-38,1982,"Regular",6,"Away","Carlton","St Kilda",38
8828,1982-05-01,"R6","Collingwood",13,10,88,"Fitzroy",12,19,91,"Victoria Park",-3,1982,"Regular",6,"Away","Fitzroy","Collingwood",3
8829,1982-05-01,"R6","Geelong",17,20,122,"Footscray",7,22,64,"Kardinia Park",58,1982,"Regular",6,"Home","Geelong","Footscray",58
8830,1982-05-01,"R6","North Melbourne",15,11,101,"Hawthorn",19,21,135,"Waverley Park",-34,1982,"Regular",6,"Away","Hawthorn","North Melbourne",34
8831,1982-05-01,"R6","Richmond",18,8,116,"Melbourne",15,16,106,"M.C.G.",10,1982,"Regular",6,"Home","Richmond","Melbourne",10
8832,1982-05-02,"R6","Sydney",15,21,111,"Essendon",18,9,117,"S.C.G.",-6,1982,"Regular",6,"Away","Essendon","Sydney",6
8833,1982-05-08,"R7","Carlton",15,20,110,"Geelong",7,7,49,"Princes Park",61,1982,"Regular",7,"Home","Carlton","Geelong",61
8834,1982-05-08,"R7","Essendon",17,20,122,"Collingwood",9,13,67,"Windy Hill",55,1982,"Regular",7,"Home","Essendon","Collingwood",55
8835,1982-05-08,"R7","Fitzroy",19,15,129,"Hawthorn",17,15,117,"Junction Oval",12,1982,"Regular",7,"Home","Fitzroy","Hawthorn",12
8836,1982-05-08,"R7","Footscray",15,20,110,"Sydney",20,11,131,"Western Oval",-21,1982,"Regular",7,"Away","Sydney","Footscray",21
8837,1982-05-08,"R7","Melbourne",22,11,143,"North Melbourne",28,12,180,"M.C.G.",-37,1982,"Regular",7,"Away","North Melbourne","Melbourne",37
8838,1982-05-08,"R7","St Kilda",17,12,114,"Richmond",21,14,140,"Waverley Park",-26,1982,"Regular",7,"Away","Richmond","St Kilda",26
8839,1982-05-15,"R8","Footscray",11,11,77,"Carlton",14,22,106,"Western Oval",-29,1982,"Regular",8,"Away","Carlton","Footscray",29
8840,1982-05-15,"R8","Hawthorn",15,15,105,"Essendon",16,15,111,"Princes Park",-6,1982,"Regular",8,"Away","Essendon","Hawthorn",6
8841,1982-05-15,"R8","Fitzroy",13,21,99,"Melbourne",25,14,164,"Waverley Park",-65,1982,"Regular",8,"Away","Melbourne","Fitzroy",65
8842,1982-05-15,"R8","Geelong",12,15,87,"Richmond",11,23,89,"Kardinia Park",-2,1982,"Regular",8,"Away","Richmond","Geelong",2
8843,1982-05-15,"R8","North Melbourne",23,18,156,"St Kilda",6,16,52,"Arden St",104,1982,"Regular",8,"Home","North Melbourne","St Kilda",104
8844,1982-05-16,"R8","Sydney",15,25,115,"Collingwood",13,19,97,"S.C.G.",18,1982,"Regular",8,"Home","Sydney","Collingwood",18
8845,1982-05-22,"R9","Carlton",27,23,185,"Sydney",12,11,83,"Princes Park",102,1982,"Regular",9,"Home","Carlton","Sydney",102
8846,1982-05-22,"R9","Collingwood",13,14,92,"Hawthorn",17,12,114,"Victoria Park",-22,1982,"Regular",9,"Away","Hawthorn","Collingwood",22
8847,1982-05-22,"R9","Essendon",19,19,133,"Melbourne",12,13,85,"Windy Hill",48,1982,"Regular",9,"Home","Essendon","Melbourne",48
8848,1982-05-22,"R9","St Kilda",16,19,115,"Fitzroy",25,12,162,"Moorabbin Oval",-47,1982,"Regular",9,"Away","Fitzroy","St Kilda",47
8849,1982-05-22,"R9","Richmond",21,13,139,"Footscray",14,14,98,"M.C.G.",41,1982,"Regular",9,"Home","Richmond","Footscray",41
8850,1982-05-22,"R9","Geelong",15,19,109,"North Melbourne",9,9,63,"Waverley Park",46,1982,"Regular",9,"Home","Geelong","North Melbourne",46
8851,1982-05-29,"R10","Carlton",18,16,124,"Richmond",16,11,107,"Princes Park",17,1982,"Regular",10,"Home","Carlton","Richmond",17
8852,1982-05-29,"R10","Melbourne",16,24,120,"Collingwood",17,11,113,"M.C.G.",7,1982,"Regular",10,"Home","Melbourne","Collingwood",7
8853,1982-05-29,"R10","Essendon",22,17,149,"St Kilda",18,11,119,"Waverley Park",30,1982,"Regular",10,"Home","Essendon","St Kilda",30
8854,1982-05-29,"R10","Fitzroy",25,11,161,"Geelong",19,18,132,"Junction Oval",29,1982,"Regular",10,"Home","Fitzroy","Geelong",29
8855,1982-05-29,"R10","Footscray",15,10,100,"North Melbourne",23,20,158,"Western Oval",-58,1982,"Regular",10,"Away","North Melbourne","Footscray",58
8856,1982-05-30,"R10","Sydney",15,13,103,"Hawthorn",24,13,157,"S.C.G.",-54,1982,"Regular",10,"Away","Hawthorn","Sydney",54
8857,1982-06-05,"R11","North Melbourne",13,18,96,"Carlton",15,15,105,"Arden St",-9,1982,"Regular",11,"Away","Carlton","North Melbourne",9
8858,1982-06-05,"R11","Collingwood",26,16,172,"St Kilda",21,10,136,"Victoria Park",36,1982,"Regular",11,"Home","Collingwood","St Kilda",36
8859,1982-06-05,"R11","Geelong",10,11,71,"Essendon",17,9,111,"Kardinia Park",-40,1982,"Regular",11,"Away","Essendon","Geelong",40
8860,1982-06-05,"R11","Footscray",16,12,108,"Fitzroy",23,22,160,"Waverley Park",-52,1982,"Regular",11,"Away","Fitzroy","Footscray",52
8861,1982-06-05,"R11","Hawthorn",26,22,178,"Melbourne",14,15,99,"Princes Park",79,1982,"Regular",11,"Home","Hawthorn","Melbourne",79
8862,1982-06-05,"R11","Richmond",20,14,134,"Sydney",18,25,133,"M.C.G.",1,1982,"Regular",11,"Home","Richmond","Sydney",1
8863,1982-06-12,"R12","Richmond",23,18,156,"Fitzroy",17,16,118,"M.C.G.",38,1982,"Regular",12,"Home","Richmond","Fitzroy",38
8864,1982-06-12,"R12","St Kilda",14,11,95,"Melbourne",19,24,138,"Moorabbin Oval",-43,1982,"Regular",12,"Away","Melbourne","St Kilda",43
8865,1982-06-13,"R12","Sydney",15,15,105,"North Melbourne",16,15,111,"S.C.G.",-6,1982,"Regular",12,"Away","North Melbourne","Sydney",6
8866,1982-06-14,"R12","Essendon",19,12,126,"Carlton",8,18,66,"Windy Hill",60,1982,"Regular",12,"Home","Essendon","Carlton",60
8867,1982-06-14,"R12","Collingwood",24,19,163,"Footscray",14,13,97,"Victoria Park",66,1982,"Regular",12,"Home","Collingwood","Footscray",66
8868,1982-06-14,"R12","Geelong",6,17,53,"Hawthorn",17,10,112,"Waverley Park",-59,1982,"Regular",12,"Away","Hawthorn","Geelong",59
8869,1982-06-19,"R13","Carlton",12,26,98,"Collingwood",9,17,71,"Princes Park",27,1982,"Regular",13,"Home","Carlton","Collingwood",27
8870,1982-06-19,"R13","Essendon",10,5,65,"Richmond",12,10,82,"Waverley Park",-17,1982,"Regular",13,"Away","Richmond","Essendon",17
8871,1982-06-19,"R13","North Melbourne",13,10,88,"Fitzroy",11,21,87,"Arden St",1,1982,"Regular",13,"Home","North Melbourne","Fitzroy",1
8872,1982-06-19,"R13","Footscray",16,11,107,"Hawthorn",12,20,92,"Western Oval",15,1982,"Regular",13,"Home","Footscray","Hawthorn",15
8873,1982-06-19,"R13","Melbourne",21,8,134,"Geelong",10,10,70,"M.C.G.",64,1982,"Regular",13,"Home","Melbourne","Geelong",64
8874,1982-06-20,"R13","Sydney",30,19,199,"St Kilda",15,13,103,"S.C.G.",96,1982,"Regular",13,"Home","Sydney","St Kilda",96
8875,1982-06-26,"R14","Hawthorn",17,14,116,"Carlton",12,10,82,"Princes Park",34,1982,"Regular",14,"Home","Hawthorn","Carlton",34
8876,1982-06-26,"R14","Collingwood",10,12,72,"Richmond",13,16,94,"Victoria Park",-22,1982,"Regular",14,"Away","Richmond","Collingwood",22
8877,1982-06-26,"R14","North Melbourne",14,13,97,"Essendon",15,15,105,"M.C.G.",-8,1982,"Regular",14,"Away","Essendon","North Melbourne",8
8878,1982-06-26,"R14","Fitzroy",16,16,112,"Sydney",20,13,133,"Junction Oval",-21,1982,"Regular",14,"Away","Sydney","Fitzroy",21
8879,1982-06-26,"R14","Footscray",14,8,92,"Melbourne",13,16,94,"Waverley Park",-2,1982,"Regular",14,"Away","Melbourne","Footscray",2
8880,1982-06-26,"R14","Geelong",17,8,110,"St Kilda",10,3,63,"Kardinia Park",47,1982,"Regular",14,"Home","Geelong","St Kilda",47
8881,1982-07-03,"R15","Carlton",18,20,128,"Melbourne",16,15,111,"Princes Park",17,1982,"Regular",15,"Home","Carlton","Melbourne",17
8882,1982-07-03,"R15","Collingwood",13,11,89,"North Melbourne",16,13,109,"Waverley Park",-20,1982,"Regular",15,"Away","North Melbourne","Collingwood",20
8883,1982-07-03,"R15","Essendon",21,13,139,"Fitzroy",7,12,54,"Windy Hill",85,1982,"Regular",15,"Home","Essendon","Fitzroy",85
8884,1982-07-03,"R15","St Kilda",20,11,131,"Footscray",18,12,120,"Moorabbin Oval",11,1982,"Regular",15,"Home","St Kilda","Footscray",11
8885,1982-07-03,"R15","Richmond",17,14,116,"Hawthorn",22,14,146,"M.C.G.",-30,1982,"Regular",15,"Away","Hawthorn","Richmond",30
8886,1982-07-04,"R15","Sydney",18,18,126,"Geelong",12,15,87,"S.C.G.",39,1982,"Regular",15,"Home","Sydney","Geelong",39
8887,1982-07-10,"R16","Carlton",21,13,139,"St Kilda",9,9,63,"Waverley Park",76,1982,"Regular",16,"Home","Carlton","St Kilda",76
8888,1982-07-10,"R16","Footscray",25,7,157,"Geelong",17,13,115,"Western Oval",42,1982,"Regular",16,"Home","Footscray","Geelong",42
8889,1982-07-10,"R16","Hawthorn",32,14,206,"North Melbourne",15,22,112,"Princes Park",94,1982,"Regular",16,"Home","Hawthorn","North Melbourne",94
8890,1982-07-17,"R16","Fitzroy",10,24,84,"Collingwood",9,10,64,"Waverley Park",20,1982,"Regular",16,"Home","Fitzroy","Collingwood",20
8891,1982-07-17,"R16","Essendon",12,10,82,"Sydney",17,13,115,"Windy Hill",-33,1982,"Regular",16,"Away","Sydney","Essendon",33
8892,1982-07-17,"R16","Melbourne",9,18,72,"Richmond",23,9,147,"M.C.G.",-75,1982,"Regular",16,"Away","Richmond","Melbourne",75
8893,1982-07-24,"R17","Geelong",16,19,115,"Carlton",11,9,75,"Kardinia Park",40,1982,"Regular",17,"Home","Geelong","Carlton",40
8894,1982-07-24,"R17","Collingwood",15,18,108,"Essendon",17,17,119,"Victoria Park",-11,1982,"Regular",17,"Away","Essendon","Collingwood",11
8895,1982-07-24,"R17","Hawthorn",18,15,123,"Fitzroy",27,8,170,"Waverley Park",-47,1982,"Regular",17,"Away","Fitzroy","Hawthorn",47
8896,1982-07-24,"R17","North Melbourne",22,14,146,"Melbourne",16,17,113,"Arden St",33,1982,"Regular",17,"Home","North Melbourne","Melbourne",33
8897,1982-07-24,"R17","Richmond",28,17,185,"St Kilda",14,18,102,"M.C.G.",83,1982,"Regular",17,"Home","Richmond","St Kilda",83
8898,1982-07-25,"R17","Sydney",14,27,111,"Footscray",15,8,98,"S.C.G.",13,1982,"Regular",17,"Home","Sydney","Footscray",13
8899,1982-07-31,"R18","Carlton",30,21,201,"Footscray",10,12,72,"Princes Park",129,1982,"Regular",18,"Home","Carlton","Footscray",129
8900,1982-07-31,"R18","Collingwood",12,13,85,"Sydney",13,12,90,"Victoria Park",-5,1982,"Regular",18,"Away","Sydney","Collingwood",5
8901,1982-07-31,"R18","Essendon",12,10,82,"Hawthorn",15,10,100,"Windy Hill",-18,1982,"Regular",18,"Away","Hawthorn","Essendon",18
8902,1982-07-31,"R18","Melbourne",13,15,93,"Fitzroy",24,19,163,"M.C.G.",-70,1982,"Regular",18,"Away","Fitzroy","Melbourne",70
8903,1982-07-31,"R18","Richmond",24,19,163,"Geelong",11,13,79,"Waverley Park",84,1982,"Regular",18,"Home","Richmond","Geelong",84
8904,1982-07-31,"R18","St Kilda",14,12,96,"North Melbourne",22,18,150,"Moorabbin Oval",-54,1982,"Regular",18,"Away","North Melbourne","St Kilda",54
8905,1982-08-07,"R19","Hawthorn",20,20,140,"Collingwood",16,22,118,"Princes Park",22,1982,"Regular",19,"Home","Hawthorn","Collingwood",22
8906,1982-08-07,"R19","Melbourne",14,17,101,"Essendon",20,17,137,"Waverley Park",-36,1982,"Regular",19,"Away","Essendon","Melbourne",36
8907,1982-08-07,"R19","Fitzroy",21,16,142,"St Kilda",11,12,78,"Junction Oval",64,1982,"Regular",19,"Home","Fitzroy","St Kilda",64
8908,1982-08-07,"R19","Footscray",7,8,50,"Richmond",16,16,112,"Western Oval",-62,1982,"Regular",19,"Away","Richmond","Footscray",62
8909,1982-08-07,"R19","North Melbourne",22,18,150,"Geelong",11,16,82,"Arden St",68,1982,"Regular",19,"Home","North Melbourne","Geelong",68
8910,1982-08-08,"R19","Sydney",15,16,106,"Carlton",9,18,72,"S.C.G.",34,1982,"Regular",19,"Home","Sydney","Carlton",34
8911,1982-08-14,"R20","Richmond",9,10,64,"Carlton",13,14,92,"M.C.G.",-28,1982,"Regular",20,"Away","Carlton","Richmond",28
8912,1982-08-14,"R20","Collingwood",17,12,114,"Melbourne",25,18,168,"Victoria Park",-54,1982,"Regular",20,"Away","Melbourne","Collingwood",54
8913,1982-08-14,"R20","St Kilda",10,16,76,"Essendon",13,12,90,"Moorabbin Oval",-14,1982,"Regular",20,"Away","Essendon","St Kilda",14
8914,1982-08-14,"R20","Geelong",5,18,48,"Fitzroy",15,15,105,"Kardinia Park",-57,1982,"Regular",20,"Away","Fitzroy","Geelong",57
8915,1982-08-14,"R20","North Melbourne",17,16,118,"Footscray",16,8,104,"Waverley Park",14,1982,"Regular",20,"Home","North Melbourne","Footscray",14
8916,1982-08-14,"R20","Hawthorn",18,18,126,"Sydney",8,14,62,"Princes Park",64,1982,"Regular",20,"Home","Hawthorn","Sydney",64
8917,1982-08-21,"R21","Carlton",26,24,180,"North Melbourne",17,8,110,"Princes Park",70,1982,"Regular",21,"Home","Carlton","North Melbourne",70
8918,1982-08-21,"R21","St Kilda",22,16,148,"Collingwood",16,16,112,"Waverley Park",36,1982,"Regular",21,"Home","St Kilda","Collingwood",36
8919,1982-08-21,"R21","Essendon",14,12,96,"Geelong",12,13,85,"Windy Hill",11,1982,"Regular",21,"Home","Essendon","Geelong",11
8920,1982-08-21,"R21","Fitzroy",19,17,131,"Footscray",12,11,83,"Junction Oval",48,1982,"Regular",21,"Home","Fitzroy","Footscray",48
8921,1982-08-21,"R21","Melbourne",14,8,92,"Hawthorn",14,19,103,"M.C.G.",-11,1982,"Regular",21,"Away","Hawthorn","Melbourne",11
8922,1982-08-22,"R21","Sydney",16,14,110,"Richmond",19,13,127,"S.C.G.",-17,1982,"Regular",21,"Away","Richmond","Sydney",17
8923,1982-08-28,"R22","Fitzroy",17,9,111,"Carlton",23,12,150,"Waverley Park",-39,1982,"Regular",22,"Away","Carlton","Fitzroy",39
8924,1982-08-28,"R22","Geelong",18,13,121,"Collingwood",18,18,126,"Kardinia Park",-5,1982,"Regular",22,"Away","Collingwood","Geelong",5
8925,1982-08-28,"R22","Footscray",9,8,62,"Essendon",32,16,208,"Western Oval",-146,1982,"Regular",22,"Away","Essendon","Footscray",146
8926,1982-08-28,"R22","Hawthorn",23,23,161,"St Kilda",11,7,73,"Princes Park",88,1982,"Regular",22,"Home","Hawthorn","St Kilda",88
8927,1982-08-28,"R22","Melbourne",25,13,163,"Sydney",22,16,148,"M.C.G.",15,1982,"Regular",22,"Home","Melbourne","Sydney",15
8928,1982-08-28,"R22","North Melbourne",11,13,79,"Richmond",15,8,98,"Arden St",-19,1982,"Regular",22,"Away","Richmond","North Melbourne",19
8929,1982-09-04,"QF","Hawthorn",16,9,105,"Carlton",25,13,163,"M.C.G.",-58,1982,"Finals",23,"Away","Carlton","Hawthorn",58
8930,1982-09-04,"EF","Essendon",16,19,115,"North Melbourne",19,14,128,"Waverley Park",-13,1982,"Finals",23,"Away","North Melbourne","Essendon",13
8931,1982-09-11,"SF","Richmond",16,17,113,"Carlton",13,12,90,"Waverley Park",23,1982,"Finals",24,"Home","Richmond","Carlton",23
8932,1982-09-11,"SF","Hawthorn",24,22,166,"North Melbourne",18,6,114,"M.C.G.",52,1982,"Finals",24,"Home","Hawthorn","North Melbourne",52
8933,1982-09-18,"PF","Hawthorn",8,15,63,"Carlton",13,16,94,"Waverley Park",-31,1982,"Finals",25,"Away","Carlton","Hawthorn",31
8934,1982-09-25,"GF","Richmond",12,13,85,"Carlton",14,19,103,"M.C.G.",-18,1982,"Finals",26,"Away","Carlton","Richmond",18
8935,1983-03-26,"R1","Carlton",20,16,136,"Richmond",11,10,76,"Princes Park",60,1983,"Regular",1,"Home","Carlton","Richmond",60
8936,1983-03-26,"R1","Melbourne",19,11,125,"Collingwood",20,15,135,"M.C.G.",-10,1983,"Regular",1,"Away","Collingwood","Melbourne",10
8937,1983-03-26,"R1","Fitzroy",16,16,112,"Hawthorn",20,11,131,"Junction Oval",-19,1983,"Regular",1,"Away","Hawthorn","Fitzroy",19
8938,1983-03-26,"R1","Geelong",15,16,106,"Footscray",11,9,75,"Waverley Park",31,1983,"Regular",1,"Home","Geelong","Footscray",31
8939,1983-03-26,"R1","North Melbourne",14,16,100,"St Kilda",12,15,87,"Arden St",13,1983,"Regular",1,"Home","North Melbourne","St Kilda",13
8940,1983-03-27,"R1","Sydney",17,9,111,"Essendon",15,20,110,"S.C.G.",1,1983,"Regular",1,"Home","Sydney","Essendon",1
8941,1983-04-02,"R2","Footscray",14,15,99,"Carlton",12,10,82,"Western Oval",17,1983,"Regular",2,"Home","Footscray","Carlton",17
8942,1983-04-02,"R2","Collingwood",14,12,96,"Geelong",15,11,101,"Victoria Park",-5,1983,"Regular",2,"Away","Geelong","Collingwood",5
8943,1983-04-02,"R2","Richmond",15,10,100,"Melbourne",18,11,119,"M.C.G.",-19,1983,"Regular",2,"Away","Melbourne","Richmond",19
8944,1983-04-04,"R2","Essendon",20,11,131,"St Kilda",10,10,70,"Windy Hill",61,1983,"Regular",2,"Home","Essendon","St Kilda",61
8945,1983-04-04,"R2","North Melbourne",6,7,43,"Fitzroy",12,16,88,"Waverley Park",-45,1983,"Regular",2,"Away","Fitzroy","North Melbourne",45
8946,1983-04-04,"R2","Hawthorn",9,16,70,"Sydney",5,15,45,"Princes Park",25,1983,"Regular",2,"Home","Hawthorn","Sydney",25
8947,1983-04-09,"R3","Carlton",13,19,97,"Collingwood",11,21,87,"Waverley Park",10,1983,"Regular",3,"Home","Carlton","Collingwood",10
8948,1983-04-09,"R3","Fitzroy",14,13,97,"Essendon",7,14,56,"Junction Oval",41,1983,"Regular",3,"Home","Fitzroy","Essendon",41
8949,1983-04-09,"R3","Footscray",16,15,111,"Melbourne",11,13,79,"Western Oval",32,1983,"Regular",3,"Home","Footscray","Melbourne",32
8950,1983-04-09,"R3","Geelong",13,16,94,"Richmond",6,10,46,"Kardinia Park",48,1983,"Regular",3,"Home","Geelong","Richmond",48
8951,1983-04-09,"R3","St Kilda",6,6,42,"Hawthorn",26,15,171,"Moorabbin Oval",-129,1983,"Regular",3,"Away","Hawthorn","St Kilda",129
8952,1983-04-10,"R3","Sydney",5,15,45,"North Melbourne",27,23,185,"S.C.G.",-140,1983,"Regular",3,"Away","North Melbourne","Sydney",140
8953,1983-04-16,"R4","Melbourne",13,12,90,"Carlton",14,15,99,"M.C.G.",-9,1983,"Regular",4,"Away","Carlton","Melbourne",9
8954,1983-04-16,"R4","Essendon",20,21,141,"Collingwood",17,15,117,"Windy Hill",24,1983,"Regular",4,"Home","Essendon","Collingwood",24
8955,1983-04-16,"R4","Fitzroy",17,23,125,"Sydney",6,16,52,"Junction Oval",73,1983,"Regular",4,"Home","Fitzroy","Sydney",73
8956,1983-04-16,"R4","Hawthorn",12,25,97,"Footscray",17,16,118,"Princes Park",-21,1983,"Regular",4,"Away","Footscray","Hawthorn",21
8957,1983-04-16,"R4","St Kilda",11,13,79,"Geelong",13,12,90,"Waverley Park",-11,1983,"Regular",4,"Away","Geelong","St Kilda",11
8958,1983-04-16,"R4","North Melbourne",18,19,127,"Richmond",14,19,103,"Arden St",24,1983,"Regular",4,"Home","North Melbourne","Richmond",24
8959,1983-04-23,"R5","Carlton",9,11,65,"Fitzroy",18,17,125,"Princes Park",-60,1983,"Regular",5,"Away","Fitzroy","Carlton",60
8960,1983-04-23,"R5","Collingwood",9,19,73,"Hawthorn",14,11,95,"Victoria Park",-22,1983,"Regular",5,"Away","Hawthorn","Collingwood",22
8961,1983-04-24,"R5","Sydney",24,16,160,"St Kilda",21,11,137,"S.C.G.",23,1983,"Regular",5,"Home","Sydney","St Kilda",23
8962,1983-04-25,"R5","Essendon",20,8,128,"North Melbourne",17,21,123,"Waverley Park",5,1983,"Regular",5,"Home","Essendon","North Melbourne",5
8963,1983-04-25,"R5","Richmond",17,12,114,"Footscray",18,8,116,"M.C.G.",-2,1983,"Regular",5,"Away","Footscray","Richmond",2
8964,1983-04-25,"R5","Geelong",16,14,110,"Melbourne",18,13,121,"Kardinia Park",-11,1983,"Regular",5,"Away","Melbourne","Geelong",11
8965,1983-04-30,"R6","Carlton",12,13,85,"Geelong",14,11,95,"Princes Park",-10,1983,"Regular",6,"Away","Geelong","Carlton",10
8966,1983-04-30,"R6","Collingwood",19,16,130,"North Melbourne",15,18,108,"Victoria Park",22,1983,"Regular",6,"Home","Collingwood","North Melbourne",22
8967,1983-04-30,"R6","Essendon",27,19,181,"Footscray",7,7,49,"Windy Hill",132,1983,"Regular",6,"Home","Essendon","Footscray",132
8968,1983-04-30,"R6","St Kilda",15,12,102,"Fitzroy",22,11,143,"Moorabbin Oval",-41,1983,"Regular",6,"Away","Fitzroy","St Kilda",41
8969,1983-04-30,"R6","Hawthorn",12,16,88,"Richmond",15,16,106,"Waverley Park",-18,1983,"Regular",6,"Away","Richmond","Hawthorn",18
8970,1983-04-30,"R6","Melbourne",18,18,126,"Sydney",12,21,93,"M.C.G.",33,1983,"Regular",6,"Home","Melbourne","Sydney",33
8971,1983-05-07,"R7","Footscray",11,16,82,"Collingwood",14,4,88,"Western Oval",-6,1983,"Regular",7,"Away","Collingwood","Footscray",6
8972,1983-05-07,"R7","Richmond",16,16,112,"Essendon",21,11,137,"M.C.G.",-25,1983,"Regular",7,"Away","Essendon","Richmond",25
8973,1983-05-07,"R7","Fitzroy",11,10,76,"Geelong",9,13,67,"Junction Oval",9,1983,"Regular",7,"Home","Fitzroy","Geelong",9
8974,1983-05-07,"R7","Hawthorn",13,13,91,"North Melbourne",21,16,142,"Princes Park",-51,1983,"Regular",7,"Away","North Melbourne","Hawthorn",51
8975,1983-05-07,"R7","Melbourne",16,12,108,"St Kilda",11,9,75,"Waverley Park",33,1983,"Regular",7,"Home","Melbourne","St Kilda",33
8976,1983-05-08,"R7","Sydney",18,10,118,"Carlton",22,17,149,"S.C.G.",-31,1983,"Regular",7,"Away","Carlton","Sydney",31
8977,1983-05-14,"R8","St Kilda",12,17,89,"Carlton",22,13,145,"Moorabbin Oval",-56,1983,"Regular",8,"Away","Carlton","St Kilda",56
8978,1983-05-14,"R8","Collingwood",16,11,107,"Richmond",8,11,59,"Waverley Park",48,1983,"Regular",8,"Home","Collingwood","Richmond",48
8979,1983-05-14,"R8","Hawthorn",20,17,137,"Essendon",14,11,95,"Princes Park",42,1983,"Regular",8,"Home","Hawthorn","Essendon",42
8980,1983-05-14,"R8","Melbourne",12,15,87,"Fitzroy",18,18,126,"M.C.G.",-39,1983,"Regular",8,"Away","Fitzroy","Melbourne",39
8981,1983-05-14,"R8","North Melbourne",29,15,189,"Footscray",11,8,74,"Arden St",115,1983,"Regular",8,"Home","North Melbourne","Footscray",115
8982,1983-05-14,"R8","Geelong",11,18,84,"Sydney",16,14,110,"Kardinia Park",-26,1983,"Regular",8,"Away","Sydney","Geelong",26
8983,1983-05-21,"R9","Carlton",15,14,104,"Hawthorn",14,12,96,"Princes Park",8,1983,"Regular",9,"Home","Carlton","Hawthorn",8
8984,1983-05-21,"R9","Essendon",22,17,149,"Melbourne",17,13,115,"Windy Hill",34,1983,"Regular",9,"Home","Essendon","Melbourne",34
8985,1983-05-21,"R9","Fitzroy",13,21,99,"Footscray",22,13,145,"Waverley Park",-46,1983,"Regular",9,"Away","Footscray","Fitzroy",46
8986,1983-05-21,"R9","Geelong",12,12,84,"North Melbourne",18,16,124,"Kardinia Park",-40,1983,"Regular",9,"Away","North Melbourne","Geelong",40
8987,1983-05-21,"R9","St Kilda",16,12,108,"Richmond",13,15,93,"Moorabbin Oval",15,1983,"Regular",9,"Home","St Kilda","Richmond",15
8988,1983-05-22,"R9","Sydney",18,13,121,"Collingwood",14,16,100,"S.C.G.",21,1983,"Regular",9,"Home","Sydney","Collingwood",21
8989,1983-05-28,"R10","North Melbourne",29,19,193,"Carlton",11,16,82,"Arden St",111,1983,"Regular",10,"Home","North Melbourne","Carlton",111
8990,1983-05-28,"R10","Collingwood",10,17,77,"Fitzroy",13,15,93,"Victoria Park",-16,1983,"Regular",10,"Away","Fitzroy","Collingwood",16
8991,1983-05-28,"R10","Essendon",15,19,109,"Geelong",15,7,97,"Windy Hill",12,1983,"Regular",10,"Home","Essendon","Geelong",12
8992,1983-05-28,"R10","Footscray",17,26,128,"St Kilda",11,16,82,"Western Oval",46,1983,"Regular",10,"Home","Footscray","St Kilda",46
8993,1983-05-28,"R10","Melbourne",16,13,109,"Hawthorn",27,9,171,"Waverley Park",-62,1983,"Regular",10,"Away","Hawthorn","Melbourne",62
8994,1983-05-28,"R10","Richmond",16,10,106,"Sydney",14,10,94,"M.C.G.",12,1983,"Regular",10,"Home","Richmond","Sydney",12
8995,1983-06-04,"R11","Carlton",15,11,101,"Essendon",19,12,126,"Waverley Park",-25,1983,"Regular",11,"Away","Essendon","Carlton",25
8996,1983-06-04,"R11","St Kilda",21,18,144,"Collingwood",24,16,160,"Moorabbin Oval",-16,1983,"Regular",11,"Away","Collingwood","St Kilda",16
8997,1983-06-04,"R11","Fitzroy",20,16,136,"Richmond",16,18,114,"Junction Oval",22,1983,"Regular",11,"Home","Fitzroy","Richmond",22
8998,1983-06-04,"R11","Hawthorn",12,16,88,"Geelong",14,11,95,"Princes Park",-7,1983,"Regular",11,"Away","Geelong","Hawthorn",7
8999,1983-06-04,"R11","Melbourne",18,17,125,"North Melbourne",20,19,139,"M.C.G.",-14,1983,"Regular",11,"Away","North Melbourne","Melbourne",14
9000,1983-06-05,"R11","Sydney",17,19,121,"Footscray",15,12,102,"S.C.G.",19,1983,"Regular",11,"Home","Sydney","Footscray",19
9001,1983-06-11,"R12","Essendon",23,18,156,"Sydney",13,5,83,"Windy Hill",73,1983,"Regular",12,"Home","Essendon","Sydney",73
9002,1983-06-11,"R12","Hawthorn",25,17,167,"Fitzroy",21,8,134,"Princes Park",33,1983,"Regular",12,"Home","Hawthorn","Fitzroy",33
9003,1983-06-11,"R12","St Kilda",15,14,104,"North Melbourne",20,15,135,"Moorabbin Oval",-31,1983,"Regular",12,"Away","North Melbourne","St Kilda",31
9004,1983-06-13,"R12","Richmond",21,15,141,"Carlton",13,13,91,"M.C.G.",50,1983,"Regular",12,"Home","Richmond","Carlton",50
9005,1983-06-13,"R12","Collingwood",12,15,87,"Melbourne",10,8,68,"Waverley Park",19,1983,"Regular",12,"Home","Collingwood","Melbourne",19
9006,1983-06-13,"R12","Footscray",15,12,102,"Geelong",14,7,91,"Western Oval",11,1983,"Regular",12,"Home","Footscray","Geelong",11
9007,1983-06-18,"R13","Carlton",26,15,171,"Footscray",12,10,82,"Princes Park",89,1983,"Regular",13,"Home","Carlton","Footscray",89
9008,1983-06-18,"R13","Geelong",15,11,101,"Collingwood",13,7,85,"Kardinia Park",16,1983,"Regular",13,"Home","Geelong","Collingwood",16
9009,1983-06-18,"R13","St Kilda",13,13,91,"Essendon",21,12,138,"Waverley Park",-47,1983,"Regular",13,"Away","Essendon","St Kilda",47
9010,1983-06-18,"R13","Fitzroy",34,16,220,"North Melbourne",10,10,70,"Junction Oval",150,1983,"Regular",13,"Home","Fitzroy","North Melbourne",150
9011,1983-06-18,"R13","Melbourne",18,15,123,"Richmond",15,19,109,"M.C.G.",14,1983,"Regular",13,"Home","Melbourne","Richmond",14
9012,1983-06-19,"R13","Sydney",11,12,78,"Hawthorn",15,20,110,"S.C.G.",-32,1983,"Regular",13,"Away","Hawthorn","Sydney",32
9013,1983-06-25,"R14","Collingwood",15,10,100,"Carlton",6,9,45,"Victoria Park",55,1983,"Regular",14,"Home","Collingwood","Carlton",55
9014,1983-06-25,"R14","Essendon",8,10,58,"Fitzroy",9,11,65,"Windy Hill",-7,1983,"Regular",14,"Away","Fitzroy","Essendon",7
9015,1983-06-25,"R14","Melbourne",14,15,99,"Footscray",12,13,85,"M.C.G.",14,1983,"Regular",14,"Home","Melbourne","Footscray",14
9016,1983-06-25,"R14","Richmond",11,4,70,"Geelong",10,9,69,"Waverley Park",1,1983,"Regular",14,"Home","Richmond","Geelong",1
9017,1983-06-25,"R14","Hawthorn",21,17,143,"St Kilda",9,20,74,"Princes Park",69,1983,"Regular",14,"Home","Hawthorn","St Kilda",69
9018,1983-06-25,"R14","North Melbourne",11,16,82,"Sydney",7,8,50,"Arden St",32,1983,"Regular",14,"Home","North Melbourne","Sydney",32
9019,1983-07-02,"R15","Carlton",9,13,67,"Melbourne",15,16,106,"Princes Park",-39,1983,"Regular",15,"Away","Melbourne","Carlton",39
9020,1983-07-02,"R15","Collingwood",16,8,104,"Essendon",13,9,87,"Victoria Park",17,1983,"Regular",15,"Home","Collingwood","Essendon",17
9021,1983-07-02,"R15","Footscray",9,6,60,"Hawthorn",13,11,89,"Waverley Park",-29,1983,"Regular",15,"Away","Hawthorn","Footscray",29
9022,1983-07-02,"R15","Geelong",9,14,68,"St Kilda",18,12,120,"Kardinia Park",-52,1983,"Regular",15,"Away","St Kilda","Geelong",52
9023,1983-07-02,"R15","Richmond",16,18,114,"North Melbourne",21,12,138,"M.C.G.",-24,1983,"Regular",15,"Away","North Melbourne","Richmond",24
9024,1983-07-03,"R15","Sydney",23,9,147,"Fitzroy",17,15,117,"S.C.G.",30,1983,"Regular",15,"Home","Sydney","Fitzroy",30
9025,1983-07-09,"R16","Fitzroy",13,11,89,"Carlton",18,16,124,"Waverley Park",-35,1983,"Regular",16,"Away","Carlton","Fitzroy",35
9026,1983-07-09,"R16","North Melbourne",19,14,128,"Essendon",16,11,107,"Arden St",21,1983,"Regular",16,"Home","North Melbourne","Essendon",21
9027,1983-07-09,"R16","Footscray",12,12,84,"Richmond",15,14,104,"Western Oval",-20,1983,"Regular",16,"Away","Richmond","Footscray",20
9028,1983-07-16,"R16","Hawthorn",19,23,137,"Collingwood",14,16,100,"Princes Park",37,1983,"Regular",16,"Home","Hawthorn","Collingwood",37
9029,1983-07-16,"R16","Melbourne",10,19,79,"Geelong",10,13,73,"M.C.G.",6,1983,"Regular",16,"Home","Melbourne","Geelong",6
9030,1983-07-16,"R16","St Kilda",20,9,129,"Sydney",14,16,100,"Moorabbin Oval",29,1983,"Regular",16,"Home","St Kilda","Sydney",29
9031,1983-07-23,"R17","Geelong",11,7,73,"Carlton",15,18,108,"Kardinia Park",-35,1983,"Regular",17,"Away","Carlton","Geelong",35
9032,1983-07-23,"R17","North Melbourne",24,8,152,"Collingwood",14,14,98,"Waverley Park",54,1983,"Regular",17,"Home","North Melbourne","Collingwood",54
9033,1983-07-23,"R17","Footscray",16,11,107,"Essendon",18,17,125,"Western Oval",-18,1983,"Regular",17,"Away","Essendon","Footscray",18
9034,1983-07-23,"R17","Fitzroy",20,18,138,"St Kilda",22,17,149,"Junction Oval",-11,1983,"Regular",17,"Away","St Kilda","Fitzroy",11
9035,1983-07-23,"R17","Richmond",11,16,82,"Hawthorn",22,14,146,"M.C.G.",-64,1983,"Regular",17,"Away","Hawthorn","Richmond",64
9036,1983-07-24,"R17","Sydney",18,17,125,"Melbourne",16,16,112,"S.C.G.",13,1983,"Regular",17,"Home","Sydney","Melbourne",13
9037,1983-07-30,"R18","Carlton",17,17,119,"Sydney",11,9,75,"Princes Park",44,1983,"Regular",18,"Home","Carlton","Sydney",44
9038,1983-07-30,"R18","Collingwood",12,10,82,"Footscray",9,19,73,"Victoria Park",9,1983,"Regular",18,"Home","Collingwood","Footscray",9
9039,1983-07-30,"R18","Essendon",6,14,50,"Richmond",19,10,124,"Windy Hill",-74,1983,"Regular",18,"Away","Richmond","Essendon",74
9040,1983-07-30,"R18","Geelong",7,7,49,"Fitzroy",16,15,111,"Waverley Park",-62,1983,"Regular",18,"Away","Fitzroy","Geelong",62
9041,1983-07-30,"R18","North Melbourne",12,18,90,"Hawthorn",15,7,97,"Arden St",-7,1983,"Regular",18,"Away","Hawthorn","North Melbourne",7
9042,1983-07-30,"R18","St Kilda",11,15,81,"Melbourne",14,14,98,"Moorabbin Oval",-17,1983,"Regular",18,"Away","Melbourne","St Kilda",17
9043,1983-08-05,"R19","Sydney",10,15,75,"Geelong",20,21,141,"S.C.G.",-66,1983,"Regular",19,"Away","Geelong","Sydney",66
9044,1983-08-06,"R19","Carlton",25,18,168,"St Kilda",8,13,61,"Princes Park",107,1983,"Regular",19,"Home","Carlton","St Kilda",107
9045,1983-08-06,"R19","Richmond",11,13,79,"Collingwood",13,11,89,"M.C.G.",-10,1983,"Regular",19,"Away","Collingwood","Richmond",10
9046,1983-08-06,"R19","Essendon",23,18,156,"Hawthorn",16,14,110,"Windy Hill",46,1983,"Regular",19,"Home","Essendon","Hawthorn",46
9047,1983-08-06,"R19","Fitzroy",22,29,161,"Melbourne",11,9,75,"Junction Oval",86,1983,"Regular",19,"Home","Fitzroy","Melbourne",86
9048,1983-08-06,"R19","Footscray",10,11,71,"North Melbourne",25,14,164,"Waverley Park",-93,1983,"Regular",19,"Away","North Melbourne","Footscray",93
9049,1983-08-13,"R20","Hawthorn",15,22,112,"Carlton",20,9,129,"Princes Park",-17,1983,"Regular",20,"Away","Carlton","Hawthorn",17
9050,1983-08-13,"R20","Collingwood",28,14,182,"Sydney",18,12,120,"Victoria Park",62,1983,"Regular",20,"Home","Collingwood","Sydney",62
9051,1983-08-13,"R20","Melbourne",19,10,124,"Essendon",21,15,141,"M.C.G.",-17,1983,"Regular",20,"Away","Essendon","Melbourne",17
9052,1983-08-13,"R20","Footscray",19,11,125,"Fitzroy",14,15,99,"Western Oval",26,1983,"Regular",20,"Home","Footscray","Fitzroy",26
9053,1983-08-13,"R20","North Melbourne",16,20,116,"Geelong",11,18,84,"Arden St",32,1983,"Regular",20,"Home","North Melbourne","Geelong",32
9054,1983-08-13,"R20","Richmond",9,11,65,"St Kilda",21,14,140,"Waverley Park",-75,1983,"Regular",20,"Away","St Kilda","Richmond",75
9055,1983-08-20,"R21","Carlton",18,18,126,"North Melbourne",13,15,93,"Princes Park",33,1983,"Regular",21,"Home","Carlton","North Melbourne",33
9056,1983-08-20,"R21","Fitzroy",19,13,127,"Collingwood",7,21,63,"Junction Oval",64,1983,"Regular",21,"Home","Fitzroy","Collingwood",64
9057,1983-08-20,"R21","Geelong",12,11,83,"Essendon",26,9,165,"Kardinia Park",-82,1983,"Regular",21,"Away","Essendon","Geelong",82
9058,1983-08-20,"R21","St Kilda",13,16,94,"Footscray",16,4,100,"Moorabbin Oval",-6,1983,"Regular",21,"Away","Footscray","St Kilda",6
9059,1983-08-20,"R21","Hawthorn",25,22,172,"Melbourne",8,9,57,"Waverley Park",115,1983,"Regular",21,"Home","Hawthorn","Melbourne",115
9060,1983-08-21,"R21","Sydney",10,13,73,"Richmond",15,24,114,"S.C.G.",-41,1983,"Regular",21,"Away","Richmond","Sydney",41
9061,1983-08-27,"R22","Essendon",18,10,118,"Carlton",8,19,67,"Waverley Park",51,1983,"Regular",22,"Home","Essendon","Carlton",51
9062,1983-08-27,"R22","Collingwood",24,11,155,"St Kilda",14,8,92,"Victoria Park",63,1983,"Regular",22,"Home","Collingwood","St Kilda",63
9063,1983-08-27,"R22","Richmond",12,21,93,"Fitzroy",19,13,127,"M.C.G.",-34,1983,"Regular",22,"Away","Fitzroy","Richmond",34
9064,1983-08-27,"R22","Footscray",17,12,114,"Sydney",10,12,72,"Western Oval",42,1983,"Regular",22,"Home","Footscray","Sydney",42
9065,1983-08-27,"R22","Geelong",11,11,77,"Hawthorn",24,13,157,"Kardinia Park",-80,1983,"Regular",22,"Away","Hawthorn","Geelong",80
9066,1983-08-27,"R22","North Melbourne",21,22,148,"Melbourne",10,15,75,"Arden St",73,1983,"Regular",22,"Home","North Melbourne","Melbourne",73
9067,1983-09-03,"EF","Essendon",17,12,114,"Carlton",12,9,81,"Waverley Park",33,1983,"Finals",23,"Home","Essendon","Carlton",33
9068,1983-09-03,"QF","Hawthorn",19,13,127,"Fitzroy",19,9,123,"M.C.G.",4,1983,"Finals",23,"Home","Hawthorn","Fitzroy",4
9069,1983-09-10,"SF","Fitzroy",12,14,86,"Essendon",16,13,109,"M.C.G.",-23,1983,"Finals",24,"Away","Essendon","Fitzroy",23
9070,1983-09-10,"SF","North Melbourne",6,12,48,"Hawthorn",13,10,88,"Waverley Park",-40,1983,"Finals",24,"Away","Hawthorn","North Melbourne",40
9071,1983-09-17,"PF","North Melbourne",12,6,78,"Essendon",25,14,164,"Waverley Park",-86,1983,"Finals",25,"Away","Essendon","North Melbourne",86
9072,1983-09-24,"GF","Hawthorn",20,20,140,"Essendon",8,9,57,"M.C.G.",83,1983,"Finals",26,"Home","Hawthorn","Essendon",83
9073,1984-03-31,"R1","North Melbourne",9,8,62,"Carlton",31,13,199,"Waverley Park",-137,1984,"Regular",1,"Away","Carlton","North Melbourne",137
9074,1984-03-31,"R1","Collingwood",18,12,120,"Melbourne",15,17,107,"Victoria Park",13,1984,"Regular",1,"Home","Collingwood","Melbourne",13
9075,1984-03-31,"R1","St Kilda",14,13,97,"Essendon",19,20,134,"Moorabbin Oval",-37,1984,"Regular",1,"Away","Essendon","St Kilda",37
9076,1984-03-31,"R1","Geelong",23,10,148,"Fitzroy",15,9,99,"Kardinia Park",49,1984,"Regular",1,"Home","Geelong","Fitzroy",49
9077,1984-03-31,"R1","Footscray",18,14,122,"Richmond",11,17,83,"Western Oval",39,1984,"Regular",1,"Home","Footscray","Richmond",39
9078,1984-03-31,"R1","Hawthorn",17,22,124,"Sydney",13,11,89,"Princes Park",35,1984,"Regular",1,"Home","Hawthorn","Sydney",35
9079,1984-04-07,"R2","Fitzroy",16,15,111,"Carlton",18,13,121,"Junction Oval",-10,1984,"Regular",2,"Away","Carlton","Fitzroy",10
9080,1984-04-07,"R2","Collingwood",22,17,149,"St Kilda",7,14,56,"Victoria Park",93,1984,"Regular",2,"Home","Collingwood","St Kilda",93
9081,1984-04-07,"R2","Essendon",16,14,110,"Hawthorn",17,14,116,"Windy Hill",-6,1984,"Regular",2,"Away","Hawthorn","Essendon",6
9082,1984-04-07,"R2","Geelong",16,9,105,"Footscray",9,11,65,"Waverley Park",40,1984,"Regular",2,"Home","Geelong","Footscray",40
9083,1984-04-07,"R2","Richmond",15,17,107,"North Melbourne",14,9,93,"M.C.G.",14,1984,"Regular",2,"Home","Richmond","North Melbourne",14
9084,1984-04-08,"R2","Sydney",16,16,112,"Melbourne",13,20,98,"S.C.G.",14,1984,"Regular",2,"Home","Sydney","Melbourne",14
9085,1984-04-14,"R3","Carlton",15,7,97,"Geelong",19,12,126,"Princes Park",-29,1984,"Regular",3,"Away","Geelong","Carlton",29
9086,1984-04-14,"R3","Essendon",26,13,169,"Collingwood",16,10,106,"Windy Hill",63,1984,"Regular",3,"Home","Essendon","Collingwood",63
9087,1984-04-14,"R3","Fitzroy",16,9,105,"Richmond",22,19,151,"Waverley Park",-46,1984,"Regular",3,"Away","Richmond","Fitzroy",46
9088,1984-04-14,"R3","North Melbourne",14,17,101,"Footscray",25,14,164,"Arden St",-63,1984,"Regular",3,"Away","Footscray","North Melbourne",63
9089,1984-04-14,"R3","Melbourne",20,12,132,"Hawthorn",20,18,138,"M.C.G.",-6,1984,"Regular",3,"Away","Hawthorn","Melbourne",6
9090,1984-04-14,"R3","St Kilda",18,8,116,"Sydney",22,13,145,"Moorabbin Oval",-29,1984,"Regular",3,"Away","Sydney","St Kilda",29
9091,1984-04-21,"R4","Richmond",14,13,97,"Carlton",23,13,151,"M.C.G.",-54,1984,"Regular",4,"Away","Carlton","Richmond",54
9092,1984-04-21,"R4","Collingwood",15,13,103,"Sydney",17,4,106,"Victoria Park",-3,1984,"Regular",4,"Away","Sydney","Collingwood",3
9093,1984-04-21,"R4","Melbourne",14,7,91,"Essendon",17,24,126,"Waverley Park",-35,1984,"Regular",4,"Away","Essendon","Melbourne",35
9094,1984-04-23,"R4","Fitzroy",21,14,140,"Footscray",9,16,70,"Junction Oval",70,1984,"Regular",4,"Home","Fitzroy","Footscray",70
9095,1984-04-23,"R4","Geelong",9,11,65,"North Melbourne",11,13,79,"Kardinia Park",-14,1984,"Regular",4,"Away","North Melbourne","Geelong",14
9096,1984-04-23,"R4","Hawthorn",23,21,159,"St Kilda",14,15,99,"Princes Park",60,1984,"Regular",4,"Home","Hawthorn","St Kilda",60
9097,1984-04-25,"R5","Carlton",9,17,71,"Collingwood",10,16,76,"Waverley Park",-5,1984,"Regular",5,"Away","Collingwood","Carlton",5
9098,1984-04-25,"R5","Richmond",12,14,86,"Essendon",20,15,135,"M.C.G.",-49,1984,"Regular",5,"Away","Essendon","Richmond",49
9099,1984-04-28,"R5","Footscray",13,16,94,"Hawthorn",22,9,141,"Western Oval",-47,1984,"Regular",5,"Away","Hawthorn","Footscray",47
9100,1984-04-28,"R5","St Kilda",10,11,71,"Geelong",15,12,102,"Moorabbin Oval",-31,1984,"Regular",5,"Away","Geelong","St Kilda",31
9101,1984-04-28,"R5","North Melbourne",16,17,113,"Melbourne",14,14,98,"M.C.G.",15,1984,"Regular",5,"Home","North Melbourne","Melbourne",15
9102,1984-04-29,"R5","Sydney",17,17,119,"Fitzroy",15,14,104,"S.C.G.",15,1984,"Regular",5,"Home","Sydney","Fitzroy",15
9103,1984-05-05,"R6","Carlton",15,14,104,"St Kilda",13,12,90,"Princes Park",14,1984,"Regular",6,"Home","Carlton","St Kilda",14
9104,1984-05-05,"R6","Collingwood",15,18,108,"North Melbourne",12,15,87,"Victoria Park",21,1984,"Regular",6,"Home","Collingwood","North Melbourne",21
9105,1984-05-05,"R6","Fitzroy",13,15,93,"Essendon",22,12,144,"Junction Oval",-51,1984,"Regular",6,"Away","Essendon","Fitzroy",51
9106,1984-05-05,"R6","Footscray",11,18,84,"Sydney",11,11,77,"Western Oval",7,1984,"Regular",6,"Home","Footscray","Sydney",7
9107,1984-05-05,"R6","Melbourne",23,10,148,"Geelong",12,13,85,"M.C.G.",63,1984,"Regular",6,"Home","Melbourne","Geelong",63
9108,1984-05-05,"R6","Hawthorn",11,15,81,"Richmond",17,18,120,"Waverley Park",-39,1984,"Regular",6,"Away","Richmond","Hawthorn",39
9109,1984-05-12,"R7","Melbourne",16,9,105,"Carlton",18,14,122,"M.C.G.",-17,1984,"Regular",7,"Away","Carlton","Melbourne",17
9110,1984-05-12,"R7","Geelong",11,17,83,"Collingwood",19,14,128,"Kardinia Park",-45,1984,"Regular",7,"Away","Collingwood","Geelong",45
9111,1984-05-12,"R7","Essendon",12,10,82,"Footscray",16,8,104,"Windy Hill",-22,1984,"Regular",7,"Away","Footscray","Essendon",22
9112,1984-05-12,"R7","Hawthorn",20,15,135,"Fitzroy",16,8,104,"Princes Park",31,1984,"Regular",7,"Home","Hawthorn","Fitzroy",31
9113,1984-05-12,"R7","North Melbourne",14,17,101,"St Kilda",22,16,148,"Waverley Park",-47,1984,"Regular",7,"Away","St Kilda","North Melbourne",47
9114,1984-05-13,"R7","Sydney",17,20,122,"Richmond",18,21,129,"S.C.G.",-7,1984,"Regular",7,"Away","Richmond","Sydney",7
9115,1984-05-19,"R8","Carlton",12,11,83,"Hawthorn",23,13,151,"Princes Park",-68,1984,"Regular",8,"Away","Hawthorn","Carlton",68
9116,1984-05-19,"R8","Richmond",15,19,109,"Collingwood",13,17,95,"M.C.G.",14,1984,"Regular",8,"Home","Richmond","Collingwood",14
9117,1984-05-19,"R8","Essendon",19,19,133,"Geelong",14,6,90,"Waverley Park",43,1984,"Regular",8,"Home","Essendon","Geelong",43
9118,1984-05-19,"R8","Fitzroy",12,9,81,"Melbourne",13,14,92,"Junction Oval",-11,1984,"Regular",8,"Away","Melbourne","Fitzroy",11
9119,1984-05-19,"R8","St Kilda",13,11,89,"Footscray",9,17,71,"Moorabbin Oval",18,1984,"Regular",8,"Home","St Kilda","Footscray",18
9120,1984-05-19,"R8","North Melbourne",18,19,127,"Sydney",19,20,134,"Arden St",-7,1984,"Regular",8,"Away","Sydney","North Melbourne",7
9121,1984-05-26,"R9","Essendon",16,17,113,"Carlton",9,12,66,"Windy Hill",47,1984,"Regular",9,"Home","Essendon","Carlton",47
9122,1984-05-26,"R9","Collingwood",15,19,109,"Fitzroy",11,16,82,"Victoria Park",27,1984,"Regular",9,"Home","Collingwood","Fitzroy",27
9123,1984-05-26,"R9","Footscray",11,15,81,"Melbourne",23,21,159,"Waverley Park",-78,1984,"Regular",9,"Away","Melbourne","Footscray",78
9124,1984-05-26,"R9","Hawthorn",21,17,143,"North Melbourne",13,8,86,"Princes Park",57,1984,"Regular",9,"Home","Hawthorn","North Melbourne",57
9125,1984-05-26,"R9","Richmond",24,8,152,"St Kilda",12,16,88,"M.C.G.",64,1984,"Regular",9,"Home","Richmond","St Kilda",64
9126,1984-05-27,"R9","Sydney",16,15,111,"Geelong",7,27,69,"S.C.G.",42,1984,"Regular",9,"Home","Sydney","Geelong",42
9127,1984-06-02,"R10","Footscray",15,10,100,"Collingwood",13,17,95,"Western Oval",5,1984,"Regular",10,"Home","Footscray","Collingwood",5
9128,1984-06-02,"R10","North Melbourne",15,16,106,"Essendon",16,12,108,"Arden St",-2,1984,"Regular",10,"Away","Essendon","North Melbourne",2
9129,1984-06-02,"R10","St Kilda",11,17,83,"Fitzroy",22,15,147,"Waverley Park",-64,1984,"Regular",10,"Away","Fitzroy","St Kilda",64
9130,1984-06-02,"R10","Geelong",17,11,113,"Hawthorn",11,19,85,"Kardinia Park",28,1984,"Regular",10,"Home","Geelong","Hawthorn",28
9131,1984-06-02,"R10","Melbourne",15,13,103,"Richmond",11,10,76,"M.C.G.",27,1984,"Regular",10,"Home","Melbourne","Richmond",27
9132,1984-06-03,"R10","Sydney",12,15,87,"Carlton",20,19,139,"S.C.G.",-52,1984,"Regular",10,"Away","Carlton","Sydney",52
9133,1984-06-09,"R11","Essendon",20,15,135,"Sydney",14,10,94,"Windy Hill",41,1984,"Regular",11,"Home","Essendon","Sydney",41
9134,1984-06-09,"R11","Richmond",16,15,111,"Geelong",17,21,123,"M.C.G.",-12,1984,"Regular",11,"Away","Geelong","Richmond",12
9135,1984-06-09,"R11","St Kilda",13,13,91,"Melbourne",19,13,127,"Moorabbin Oval",-36,1984,"Regular",11,"Away","Melbourne","St Kilda",36
9136,1984-06-11,"R11","Carlton",22,11,143,"Footscray",16,13,109,"Princes Park",34,1984,"Regular",11,"Home","Carlton","Footscray",34
9137,1984-06-11,"R11","Collingwood",14,8,92,"Hawthorn",18,16,124,"Waverley Park",-32,1984,"Regular",11,"Away","Hawthorn","Collingwood",32
9138,1984-06-11,"R11","Fitzroy",25,16,166,"North Melbourne",23,14,152,"Junction Oval",14,1984,"Regular",11,"Home","Fitzroy","North Melbourne",14
9139,1984-06-16,"R12","Carlton",9,13,67,"Fitzroy",10,12,72,"Waverley Park",-5,1984,"Regular",12,"Away","Fitzroy","Carlton",5
9140,1984-06-16,"R12","St Kilda",11,6,72,"Collingwood",11,12,78,"Moorabbin Oval",-6,1984,"Regular",12,"Away","Collingwood","St Kilda",6
9141,1984-06-16,"R12","Hawthorn",12,21,93,"Essendon",6,10,46,"Princes Park",47,1984,"Regular",12,"Home","Hawthorn","Essendon",47
9142,1984-06-16,"R12","Footscray",13,11,89,"Geelong",10,13,73,"Western Oval",16,1984,"Regular",12,"Home","Footscray","Geelong",16
9143,1984-06-16,"R12","Melbourne",21,17,143,"Sydney",5,16,46,"M.C.G.",97,1984,"Regular",12,"Home","Melbourne","Sydney",97
9144,1984-06-16,"R12","North Melbourne",14,10,94,"Richmond",16,14,110,"Arden St",-16,1984,"Regular",12,"Away","Richmond","North Melbourne",16
9145,1984-06-23,"R13","Geelong",4,17,41,"Carlton",10,18,78,"Kardinia Park",-37,1984,"Regular",13,"Away","Carlton","Geelong",37
9146,1984-06-23,"R13","Collingwood",12,17,89,"Essendon",19,9,123,"Victoria Park",-34,1984,"Regular",13,"Away","Essendon","Collingwood",34
9147,1984-06-23,"R13","Richmond",11,15,81,"Fitzroy",14,14,98,"M.C.G.",-17,1984,"Regular",13,"Away","Fitzroy","Richmond",17
9148,1984-06-23,"R13","Footscray",11,11,77,"North Melbourne",9,8,62,"Waverley Park",15,1984,"Regular",13,"Home","Footscray","North Melbourne",15
9149,1984-06-23,"R13","Hawthorn",13,12,90,"Melbourne",15,17,107,"Princes Park",-17,1984,"Regular",13,"Away","Melbourne","Hawthorn",17
9150,1984-06-24,"R13","Sydney",15,11,101,"St Kilda",19,12,126,"S.C.G.",-25,1984,"Regular",13,"Away","St Kilda","Sydney",25
9151,1984-06-30,"R14","Carlton",23,14,152,"Richmond",4,13,37,"Princes Park",115,1984,"Regular",14,"Home","Carlton","Richmond",115
9152,1984-06-30,"R14","Essendon",14,15,99,"Melbourne",7,14,56,"Waverley Park",43,1984,"Regular",14,"Home","Essendon","Melbourne",43
9153,1984-06-30,"R14","Footscray",13,13,91,"Fitzroy",11,11,77,"Western Oval",14,1984,"Regular",14,"Home","Footscray","Fitzroy",14
9154,1984-06-30,"R14","North Melbourne",16,11,107,"Geelong",19,11,125,"M.C.G.",-18,1984,"Regular",14,"Away","Geelong","North Melbourne",18
9155,1984-06-30,"R14","St Kilda",4,6,30,"Hawthorn",19,20,134,"Moorabbin Oval",-104,1984,"Regular",14,"Away","Hawthorn","St Kilda",104
9156,1984-07-01,"R14","Sydney",14,16,100,"Collingwood",19,17,131,"S.C.G.",-31,1984,"Regular",14,"Away","Collingwood","Sydney",31
9157,1984-07-07,"R15","Collingwood",9,16,70,"Carlton",14,13,97,"Waverley Park",-27,1984,"Regular",15,"Away","Carlton","Collingwood",27
9158,1984-07-07,"R15","Essendon",14,10,94,"Richmond",7,19,61,"Windy Hill",33,1984,"Regular",15,"Home","Essendon","Richmond",33
9159,1984-07-07,"R15","Fitzroy",9,14,68,"Sydney",14,12,96,"Junction Oval",-28,1984,"Regular",15,"Away","Sydney","Fitzroy",28
9160,1984-07-07,"R15","Hawthorn",16,14,110,"Footscray",10,16,76,"Princes Park",34,1984,"Regular",15,"Home","Hawthorn","Footscray",34
9161,1984-07-07,"R15","Geelong",15,12,102,"St Kilda",13,11,89,"Kardinia Park",13,1984,"Regular",15,"Home","Geelong","St Kilda",13
9162,1984-07-07,"R15","Melbourne",18,9,117,"North Melbourne",10,14,74,"M.C.G.",43,1984,"Regular",15,"Home","Melbourne","North Melbourne",43
9163,1984-07-14,"R16","Essendon",20,7,127,"Fitzroy",9,12,66,"Windy Hill",61,1984,"Regular",16,"Home","Essendon","Fitzroy",61
9164,1984-07-14,"R16","Richmond",14,13,97,"Hawthorn",28,17,185,"Waverley Park",-88,1984,"Regular",16,"Away","Hawthorn","Richmond",88
9165,1984-07-15,"R16","Sydney",16,17,113,"Footscray",12,15,87,"S.C.G.",26,1984,"Regular",16,"Home","Sydney","Footscray",26
9166,1984-07-21,"R16","St Kilda",16,9,105,"Carlton",13,6,84,"Moorabbin Oval",21,1984,"Regular",16,"Home","St Kilda","Carlton",21
9167,1984-07-21,"R16","North Melbourne",14,17,101,"Collingwood",21,20,146,"M.C.G.",-45,1984,"Regular",16,"Away","Collingwood","North Melbourne",45
9168,1984-07-21,"R16","Geelong",20,10,130,"Melbourne",15,18,108,"Kardinia Park",22,1984,"Regular",16,"Home","Geelong","Melbourne",22
9169,1984-07-28,"R17","Carlton",7,10,52,"Melbourne",3,8,26,"Princes Park",26,1984,"Regular",17,"Home","Carlton","Melbourne",26
9170,1984-07-28,"R17","Collingwood",6,19,55,"Geelong",4,5,29,"Victoria Park",26,1984,"Regular",17,"Home","Collingwood","Geelong",26
9171,1984-07-28,"R17","Footscray",3,14,32,"Essendon",4,10,34,"Western Oval",-2,1984,"Regular",17,"Away","Essendon","Footscray",2
9172,1984-07-28,"R17","Fitzroy",11,11,77,"Hawthorn",10,7,67,"Junction Oval",10,1984,"Regular",17,"Home","Fitzroy","Hawthorn",10
9173,1984-07-28,"R17","St Kilda",5,12,42,"North Melbourne",5,14,44,"Waverley Park",-2,1984,"Regular",17,"Away","North Melbourne","St Kilda",2
9174,1984-07-28,"R17","Richmond",12,19,91,"Sydney",3,10,28,"M.C.G.",63,1984,"Regular",17,"Home","Richmond","Sydney",63
9175,1984-08-04,"R18","Hawthorn",21,14,140,"Carlton",16,12,108,"Princes Park",32,1984,"Regular",18,"Home","Hawthorn","Carlton",32
9176,1984-08-04,"R18","Collingwood",19,14,128,"Richmond",12,20,92,"Victoria Park",36,1984,"Regular",18,"Home","Collingwood","Richmond",36
9177,1984-08-04,"R18","Geelong",12,17,89,"Essendon",19,22,136,"Waverley Park",-47,1984,"Regular",18,"Away","Essendon","Geelong",47
9178,1984-08-04,"R18","Melbourne",17,18,120,"Fitzroy",22,20,152,"M.C.G.",-32,1984,"Regular",18,"Away","Fitzroy","Melbourne",32
9179,1984-08-04,"R18","Footscray",16,16,112,"St Kilda",11,13,79,"Western Oval",33,1984,"Regular",18,"Home","Footscray","St Kilda",33
9180,1984-08-05,"R18","Sydney",17,6,108,"North Melbourne",18,15,123,"S.C.G.",-15,1984,"Regular",18,"Away","North Melbourne","Sydney",15
9181,1984-08-11,"R19","Carlton",12,18,90,"Essendon",15,12,102,"Princes Park",-12,1984,"Regular",19,"Away","Essendon","Carlton",12
9182,1984-08-11,"R19","Fitzroy",14,19,103,"Collingwood",9,7,61,"Waverley Park",42,1984,"Regular",19,"Home","Fitzroy","Collingwood",42
9183,1984-08-11,"R19","Melbourne",15,13,103,"Footscray",20,15,135,"M.C.G.",-32,1984,"Regular",19,"Away","Footscray","Melbourne",32
9184,1984-08-11,"R19","Geelong",16,17,113,"Sydney",14,8,92,"Kardinia Park",21,1984,"Regular",19,"Home","Geelong","Sydney",21
9185,1984-08-11,"R19","North Melbourne",17,20,122,"Hawthorn",7,9,51,"Arden St",71,1984,"Regular",19,"Home","North Melbourne","Hawthorn",71
9186,1984-08-11,"R19","St Kilda",11,15,81,"Richmond",10,14,74,"Moorabbin Oval",7,1984,"Regular",19,"Home","St Kilda","Richmond",7
9187,1984-08-18,"R20","Carlton",16,15,111,"North Melbourne",14,14,98,"Princes Park",13,1984,"Regular",20,"Home","Carlton","North Melbourne",13
9188,1984-08-18,"R20","Melbourne",9,17,71,"Collingwood",15,13,103,"M.C.G.",-32,1984,"Regular",20,"Away","Collingwood","Melbourne",32
9189,1984-08-18,"R20","Essendon",22,6,138,"St Kilda",13,5,83,"Windy Hill",55,1984,"Regular",20,"Home","Essendon","St Kilda",55
9190,1984-08-18,"R20","Fitzroy",20,11,131,"Geelong",14,9,93,"Junction Oval",38,1984,"Regular",20,"Home","Fitzroy","Geelong",38
9191,1984-08-18,"R20","Richmond",12,13,85,"Footscray",9,11,65,"Waverley Park",20,1984,"Regular",20,"Home","Richmond","Footscray",20
9192,1984-08-19,"R20","Sydney",11,19,85,"Hawthorn",25,24,174,"S.C.G.",-89,1984,"Regular",20,"Away","Hawthorn","Sydney",89
9193,1984-08-25,"R21","Footscray",14,9,93,"Carlton",7,16,58,"Western Oval",35,1984,"Regular",21,"Home","Footscray","Carlton",35
9194,1984-08-25,"R21","Hawthorn",16,23,119,"Collingwood",15,14,104,"Princes Park",15,1984,"Regular",21,"Home","Hawthorn","Collingwood",15
9195,1984-08-25,"R21","North Melbourne",15,21,111,"Fitzroy",26,9,165,"M.C.G.",-54,1984,"Regular",21,"Away","Fitzroy","North Melbourne",54
9196,1984-08-25,"R21","Geelong",14,29,113,"Richmond",9,9,63,"Kardinia Park",50,1984,"Regular",21,"Home","Geelong","Richmond",50
9197,1984-08-25,"R21","Melbourne",14,16,100,"St Kilda",9,8,62,"Waverley Park",38,1984,"Regular",21,"Home","Melbourne","St Kilda",38
9198,1984-08-26,"R21","Sydney",23,17,155,"Essendon",14,15,99,"S.C.G.",56,1984,"Regular",21,"Home","Sydney","Essendon",56
9199,1984-09-01,"R22","Carlton",20,19,139,"Sydney",15,13,103,"Princes Park",36,1984,"Regular",22,"Home","Carlton","Sydney",36
9200,1984-09-01,"R22","Collingwood",16,18,114,"Footscray",9,17,71,"Victoria Park",43,1984,"Regular",22,"Home","Collingwood","Footscray",43
9201,1984-09-01,"R22","Essendon",27,7,169,"North Melbourne",19,17,131,"Windy Hill",38,1984,"Regular",22,"Home","Essendon","North Melbourne",38
9202,1984-09-01,"R22","Fitzroy",24,20,164,"St Kilda",15,17,107,"Junction Oval",57,1984,"Regular",22,"Home","Fitzroy","St Kilda",57
9203,1984-09-01,"R22","Hawthorn",25,14,164,"Geelong",14,11,95,"Waverley Park",69,1984,"Regular",22,"Home","Hawthorn","Geelong",69
9204,1984-09-01,"R22","Richmond",21,19,145,"Melbourne",18,9,117,"M.C.G.",28,1984,"Regular",22,"Home","Richmond","Melbourne",28
9205,1984-09-08,"QF","Hawthorn",18,14,122,"Carlton",13,14,92,"Waverley Park",30,1984,"Finals",23,"Home","Hawthorn","Carlton",30
9206,1984-09-09,"EF","Collingwood",23,15,153,"Fitzroy",15,17,107,"M.C.G.",46,1984,"Finals",23,"Home","Collingwood","Fitzroy",46
9207,1984-09-15,"SF","Carlton",14,9,93,"Collingwood",17,16,118,"Waverley Park",-25,1984,"Finals",24,"Away","Collingwood","Carlton",25
9208,1984-09-16,"SF","Essendon",15,15,105,"Hawthorn",16,17,113,"M.C.G.",-8,1984,"Finals",24,"Away","Hawthorn","Essendon",8
9209,1984-09-22,"PF","Essendon",28,6,174,"Collingwood",5,11,41,"Waverley Park",133,1984,"Finals",25,"Home","Essendon","Collingwood",133
9210,1984-09-29,"GF","Essendon",14,21,105,"Hawthorn",12,9,81,"M.C.G.",24,1984,"Finals",26,"Home","Essendon","Hawthorn",24
9211,1985-03-23,"R3","Essendon",17,12,114,"Hawthorn",15,10,100,"Waverley Park",14,1985,"Regular",3,"Home","Essendon","Hawthorn",14
9212,1985-03-29,"R1","North Melbourne",15,13,103,"Collingwood",21,15,141,"M.C.G.",-38,1985,"Regular",1,"Away","Collingwood","North Melbourne",38
9213,1985-03-30,"R1","Carlton",17,10,112,"Footscray",22,10,142,"Princes Park",-30,1985,"Regular",1,"Away","Footscray","Carlton",30
9214,1985-03-30,"R1","Essendon",21,11,137,"Richmond",18,12,120,"Windy Hill",17,1985,"Regular",1,"Home","Essendon","Richmond",17
9215,1985-03-30,"R1","Melbourne",20,8,128,"Fitzroy",14,18,102,"M.C.G.",26,1985,"Regular",1,"Home","Melbourne","Fitzroy",26
9216,1985-03-30,"R1","Geelong",20,8,128,"Hawthorn",14,16,100,"Waverley Park",28,1985,"Regular",1,"Home","Geelong","Hawthorn",28
9217,1985-03-30,"R1","St Kilda",8,18,66,"Sydney",26,20,176,"Moorabbin Oval",-110,1985,"Regular",1,"Away","Sydney","St Kilda",110
9218,1985-04-06,"R2","St Kilda",2,17,29,"Carlton",25,19,169,"Moorabbin Oval",-140,1985,"Regular",2,"Away","Carlton","St Kilda",140
9219,1985-04-06,"R2","Geelong",14,12,96,"Collingwood",18,11,119,"Kardinia Park",-23,1985,"Regular",2,"Away","Collingwood","Geelong",23
9220,1985-04-06,"R2","Richmond",12,16,88,"Sydney",13,14,92,"M.C.G.",-4,1985,"Regular",2,"Away","Sydney","Richmond",4
9221,1985-04-08,"R2","Fitzroy",8,15,63,"Essendon",24,22,166,"Victoria Park",-103,1985,"Regular",2,"Away","Essendon","Fitzroy",103
9222,1985-04-08,"R2","Footscray",20,14,134,"North Melbourne",16,12,108,"Waverley Park",26,1985,"Regular",2,"Home","Footscray","North Melbourne",26
9223,1985-04-08,"R2","Hawthorn",25,20,170,"Melbourne",14,18,102,"Princes Park",68,1985,"Regular",2,"Home","Hawthorn","Melbourne",68
9224,1985-04-13,"R3","Carlton",22,13,145,"North Melbourne",22,15,147,"Princes Park",-2,1985,"Regular",3,"Away","North Melbourne","Carlton",2
9225,1985-04-13,"R3","Collingwood",19,9,123,"Melbourne",16,17,113,"Victoria Park",10,1985,"Regular",3,"Home","Collingwood","Melbourne",10
9226,1985-04-13,"R3","Footscray",26,14,170,"Geelong",16,9,105,"Western Oval",65,1985,"Regular",3,"Home","Footscray","Geelong",65
9227,1985-04-13,"R3","Richmond",31,25,211,"St Kilda",14,14,98,"M.C.G.",113,1985,"Regular",3,"Home","Richmond","St Kilda",113
9228,1985-04-14,"R3","Sydney",18,12,120,"Fitzroy",26,15,171,"S.C.G.",-51,1985,"Regular",3,"Away","Fitzroy","Sydney",51
9229,1985-04-20,"R4","Carlton",24,17,161,"Geelong",13,11,89,"Princes Park",72,1985,"Regular",4,"Home","Carlton","Geelong",72
9230,1985-04-20,"R4","Essendon",13,8,86,"Collingwood",12,10,82,"Windy Hill",4,1985,"Regular",4,"Home","Essendon","Collingwood",4
9231,1985-04-20,"R4","Fitzroy",12,14,86,"Richmond",15,13,103,"Victoria Park",-17,1985,"Regular",4,"Away","Richmond","Fitzroy",17
9232,1985-04-20,"R4","Melbourne",14,18,102,"Footscray",12,11,83,"Waverley Park",19,1985,"Regular",4,"Home","Melbourne","Footscray",19
9233,1985-04-20,"R4","North Melbourne",16,15,111,"St Kilda",11,6,72,"M.C.G.",39,1985,"Regular",4,"Home","North Melbourne","St Kilda",39
9234,1985-04-21,"R4","Sydney",5,14,44,"Hawthorn",8,15,63,"S.C.G.",-19,1985,"Regular",4,"Away","Hawthorn","Sydney",19
9235,1985-04-25,"R5","Melbourne",18,13,121,"Carlton",13,14,92,"M.C.G.",29,1985,"Regular",5,"Home","Melbourne","Carlton",29
9236,1985-04-25,"R5","St Kilda",19,12,126,"Fitzroy",18,14,122,"Waverley Park",4,1985,"Regular",5,"Home","St Kilda","Fitzroy",4
9237,1985-04-27,"R5","Collingwood",15,15,105,"Sydney",13,12,90,"Victoria Park",15,1985,"Regular",5,"Home","Collingwood","Sydney",15
9238,1985-04-27,"R5","Footscray",18,17,125,"Essendon",11,18,84,"Western Oval",41,1985,"Regular",5,"Home","Footscray","Essendon",41
9239,1985-04-27,"R5","Geelong",16,23,119,"North Melbourne",14,9,93,"Kardinia Park",26,1985,"Regular",5,"Home","Geelong","North Melbourne",26
9240,1985-04-27,"R5","Hawthorn",21,23,149,"Richmond",29,14,188,"Princes Park",-39,1985,"Regular",5,"Away","Richmond","Hawthorn",39
9241,1985-05-04,"R6","Essendon",27,14,176,"Carlton",8,19,67,"Windy Hill",109,1985,"Regular",6,"Home","Essendon","Carlton",109
9242,1985-05-04,"R6","Richmond",16,10,106,"Collingwood",13,10,88,"Waverley Park",18,1985,"Regular",6,"Home","Richmond","Collingwood",18
9243,1985-05-04,"R6","Fitzroy",15,12,102,"Hawthorn",19,16,130,"Victoria Park",-28,1985,"Regular",6,"Away","Hawthorn","Fitzroy",28
9244,1985-05-04,"R6","St Kilda",16,12,108,"Geelong",15,21,111,"Moorabbin Oval",-3,1985,"Regular",6,"Away","Geelong","St Kilda",3
9245,1985-05-04,"R6","Melbourne",20,11,131,"North Melbourne",20,12,132,"M.C.G.",-1,1985,"Regular",6,"Away","North Melbourne","Melbourne",1
9246,1985-05-05,"R6","Sydney",25,11,161,"Footscray",11,17,83,"S.C.G.",78,1985,"Regular",6,"Home","Sydney","Footscray",78
9247,1985-05-11,"R7","Collingwood",11,15,81,"Fitzroy",25,10,160,"Victoria Park",-79,1985,"Regular",7,"Away","Fitzroy","Collingwood",79
9248,1985-05-11,"R7","North Melbourne",22,20,152,"Essendon",14,9,93,"Waverley Park",59,1985,"Regular",7,"Home","North Melbourne","Essendon",59
9249,1985-05-11,"R7","Richmond",15,11,101,"Footscray",23,13,151,"M.C.G.",-50,1985,"Regular",7,"Away","Footscray","Richmond",50
9250,1985-05-11,"R7","Geelong",12,13,85,"Melbourne",5,10,40,"Kardinia Park",45,1985,"Regular",7,"Home","Geelong","Melbourne",45
9251,1985-05-11,"R7","Hawthorn",28,15,183,"St Kilda",8,9,57,"Princes Park",126,1985,"Regular",7,"Home","Hawthorn","St Kilda",126
9252,1985-05-12,"R7","Sydney",11,17,83,"Carlton",12,16,88,"S.C.G.",-5,1985,"Regular",7,"Away","Carlton","Sydney",5
9253,1985-05-18,"R8","Carlton",11,18,84,"Richmond",9,13,67,"Princes Park",17,1985,"Regular",8,"Home","Carlton","Richmond",17
9254,1985-05-18,"R8","Collingwood",8,9,57,"Hawthorn",6,10,46,"Victoria Park",11,1985,"Regular",8,"Home","Collingwood","Hawthorn",11
9255,1985-05-18,"R8","Geelong",8,11,59,"Essendon",10,15,75,"Kardinia Park",-16,1985,"Regular",8,"Away","Essendon","Geelong",16
9256,1985-05-18,"R8","Footscray",11,7,73,"Fitzroy",12,15,87,"Western Oval",-14,1985,"Regular",8,"Away","Fitzroy","Footscray",14
9257,1985-05-18,"R8","Melbourne",16,10,106,"St Kilda",7,12,54,"Waverley Park",52,1985,"Regular",8,"Home","Melbourne","St Kilda",52
9258,1985-05-18,"R8","North Melbourne",11,8,74,"Sydney",6,10,46,"M.C.G.",28,1985,"Regular",8,"Home","North Melbourne","Sydney",28
9259,1985-05-25,"R9","Fitzroy",19,9,123,"Carlton",18,16,124,"Waverley Park",-1,1985,"Regular",9,"Away","Carlton","Fitzroy",1
9260,1985-05-25,"R9","St Kilda",20,17,137,"Collingwood",24,18,162,"Moorabbin Oval",-25,1985,"Regular",9,"Away","Collingwood","St Kilda",25
9261,1985-05-25,"R9","Essendon",23,15,153,"Melbourne",9,17,71,"Windy Hill",82,1985,"Regular",9,"Home","Essendon","Melbourne",82
9262,1985-05-25,"R9","Hawthorn",17,24,126,"Footscray",16,11,107,"Princes Park",19,1985,"Regular",9,"Home","Hawthorn","Footscray",19
9263,1985-05-25,"R9","Richmond",16,15,111,"North Melbourne",18,19,127,"M.C.G.",-16,1985,"Regular",9,"Away","North Melbourne","Richmond",16
9264,1985-05-26,"R9","Sydney",13,11,89,"Geelong",16,21,117,"S.C.G.",-28,1985,"Regular",9,"Away","Geelong","Sydney",28
9265,1985-06-01,"R10","Carlton",9,14,68,"Hawthorn",22,15,147,"Princes Park",-79,1985,"Regular",10,"Away","Hawthorn","Carlton",79
9266,1985-06-01,"R10","St Kilda",18,12,120,"Essendon",21,20,146,"Moorabbin Oval",-26,1985,"Regular",10,"Away","Essendon","St Kilda",26
9267,1985-06-01,"R10","Fitzroy",17,15,117,"North Melbourne",19,14,128,"Victoria Park",-11,1985,"Regular",10,"Away","North Melbourne","Fitzroy",11
9268,1985-06-01,"R10","Richmond",10,10,70,"Geelong",18,12,120,"Waverley Park",-50,1985,"Regular",10,"Away","Geelong","Richmond",50
9269,1985-06-01,"R10","Melbourne",15,19,109,"Sydney",14,8,92,"M.C.G.",17,1985,"Regular",10,"Home","Melbourne","Sydney",17
9270,1985-06-02,"R10","Footscray",16,10,106,"Collingwood",12,8,80,"M.C.G.",26,1985,"Regular",10,"Home","Footscray","Collingwood",26
9271,1985-06-08,"R11","Essendon",17,11,113,"Sydney",11,5,71,"Windy Hill",42,1985,"Regular",11,"Home","Essendon","Sydney",42
9272,1985-06-08,"R11","Footscray",15,21,111,"St Kilda",13,12,90,"Western Oval",21,1985,"Regular",11,"Home","Footscray","St Kilda",21
9273,1985-06-08,"R11","Melbourne",15,11,101,"Richmond",17,19,121,"M.C.G.",-20,1985,"Regular",11,"Away","Richmond","Melbourne",20
9274,1985-06-10,"R11","Collingwood",13,9,87,"Carlton",16,14,110,"Waverley Park",-23,1985,"Regular",11,"Away","Carlton","Collingwood",23
9275,1985-06-10,"R11","Geelong",17,8,110,"Fitzroy",20,21,141,"Kardinia Park",-31,1985,"Regular",11,"Away","Fitzroy","Geelong",31
9276,1985-06-10,"R11","North Melbourne",17,11,113,"Hawthorn",17,11,113,"M.C.G.",0,1985,"Regular",11,"Home","North Melbourne","Hawthorn",0
9277,1985-06-15,"R12","Footscray",13,8,86,"Carlton",5,9,39,"Western Oval",47,1985,"Regular",12,"Home","Footscray","Carlton",47
9278,1985-06-15,"R12","Collingwood",9,10,64,"North Melbourne",14,17,101,"Victoria Park",-37,1985,"Regular",12,"Away","North Melbourne","Collingwood",37
9279,1985-06-15,"R12","Richmond",10,9,69,"Essendon",23,12,150,"M.C.G.",-81,1985,"Regular",12,"Away","Essendon","Richmond",81
9280,1985-06-15,"R12","Fitzroy",11,15,81,"Melbourne",6,11,47,"Waverley Park",34,1985,"Regular",12,"Home","Fitzroy","Melbourne",34
9281,1985-06-15,"R12","Hawthorn",17,15,117,"Geelong",13,10,88,"Princes Park",29,1985,"Regular",12,"Home","Hawthorn","Geelong",29
9282,1985-06-16,"R12","Sydney",23,21,159,"St Kilda",13,14,92,"S.C.G.",67,1985,"Regular",12,"Home","Sydney","St Kilda",67
9283,1985-06-22,"R13","Carlton",20,19,139,"St Kilda",16,11,107,"Princes Park",32,1985,"Regular",13,"Home","Carlton","St Kilda",32
9284,1985-06-22,"R13","Collingwood",12,13,85,"Geelong",13,13,91,"Victoria Park",-6,1985,"Regular",13,"Away","Geelong","Collingwood",6
9285,1985-06-22,"R13","Essendon",21,14,140,"Fitzroy",16,17,113,"Windy Hill",27,1985,"Regular",13,"Home","Essendon","Fitzroy",27
9286,1985-06-22,"R13","North Melbourne",9,21,75,"Footscray",11,11,77,"Waverley Park",-2,1985,"Regular",13,"Away","Footscray","North Melbourne",2
9287,1985-06-22,"R13","Melbourne",12,9,81,"Hawthorn",11,31,97,"M.C.G.",-16,1985,"Regular",13,"Away","Hawthorn","Melbourne",16
9288,1985-06-23,"R13","Sydney",19,23,137,"Richmond",8,12,60,"S.C.G.",77,1985,"Regular",13,"Home","Sydney","Richmond",77
9289,1985-06-28,"R14","North Melbourne",10,15,75,"Carlton",22,19,151,"M.C.G.",-76,1985,"Regular",14,"Away","Carlton","North Melbourne",76
9290,1985-06-29,"R14","Melbourne",12,13,85,"Collingwood",23,19,157,"M.C.G.",-72,1985,"Regular",14,"Away","Collingwood","Melbourne",72
9291,1985-06-29,"R14","Hawthorn",15,11,101,"Essendon",21,11,137,"Waverley Park",-36,1985,"Regular",14,"Away","Essendon","Hawthorn",36
9292,1985-06-29,"R14","Fitzroy",13,17,95,"Sydney",11,14,80,"Victoria Park",15,1985,"Regular",14,"Home","Fitzroy","Sydney",15
9293,1985-06-29,"R14","Geelong",17,22,124,"Footscray",23,8,146,"Kardinia Park",-22,1985,"Regular",14,"Away","Footscray","Geelong",22
9294,1985-06-29,"R14","St Kilda",12,9,81,"Richmond",17,15,117,"Moorabbin Oval",-36,1985,"Regular",14,"Away","Richmond","St Kilda",36
9295,1985-07-06,"R15","Geelong",16,8,104,"Carlton",19,16,130,"Kardinia Park",-26,1985,"Regular",15,"Away","Carlton","Geelong",26
9296,1985-07-06,"R15","Collingwood",11,12,78,"Essendon",13,11,89,"Victoria Park",-11,1985,"Regular",15,"Away","Essendon","Collingwood",11
9297,1985-07-06,"R15","Richmond",21,16,142,"Fitzroy",17,16,118,"M.C.G.",24,1985,"Regular",15,"Home","Richmond","Fitzroy",24
9298,1985-07-06,"R15","Footscray",26,13,169,"Melbourne",6,13,49,"Western Oval",120,1985,"Regular",15,"Home","Footscray","Melbourne",120
9299,1985-07-06,"R15","Hawthorn",23,18,156,"Sydney",12,11,83,"Princes Park",73,1985,"Regular",15,"Home","Hawthorn","Sydney",73
9300,1985-07-06,"R15","St Kilda",11,9,75,"North Melbourne",21,13,139,"Waverley Park",-64,1985,"Regular",15,"Away","North Melbourne","St Kilda",64
9301,1985-07-13,"R16","Fitzroy",16,13,109,"St Kilda",18,10,118,"Victoria Park",-9,1985,"Regular",16,"Away","St Kilda","Fitzroy",9
9302,1985-07-13,"R16","Richmond",17,11,113,"Hawthorn",27,18,180,"M.C.G.",-67,1985,"Regular",16,"Away","Hawthorn","Richmond",67
9303,1985-07-20,"R16","Carlton",14,15,99,"Melbourne",5,9,39,"Waverley Park",60,1985,"Regular",16,"Home","Carlton","Melbourne",60
9304,1985-07-20,"R16","Essendon",17,10,112,"Footscray",13,10,88,"Windy Hill",24,1985,"Regular",16,"Home","Essendon","Footscray",24
9305,1985-07-20,"R16","North Melbourne",12,19,91,"Geelong",20,11,131,"M.C.G.",-40,1985,"Regular",16,"Away","Geelong","North Melbourne",40
9306,1985-07-21,"R16","Sydney",17,21,123,"Collingwood",29,11,185,"S.C.G.",-62,1985,"Regular",16,"Away","Collingwood","Sydney",62
9307,1985-07-27,"R17","Carlton",18,12,120,"Essendon",10,8,68,"Princes Park",52,1985,"Regular",17,"Home","Carlton","Essendon",52
9308,1985-07-27,"R17","Collingwood",13,8,86,"Richmond",11,12,78,"Victoria Park",8,1985,"Regular",17,"Home","Collingwood","Richmond",8
9309,1985-07-27,"R17","Hawthorn",19,20,134,"Fitzroy",8,14,62,"Waverley Park",72,1985,"Regular",17,"Home","Hawthorn","Fitzroy",72
9310,1985-07-27,"R17","Footscray",15,15,105,"Sydney",11,13,79,"Western Oval",26,1985,"Regular",17,"Home","Footscray","Sydney",26
9311,1985-07-27,"R17","Geelong",14,18,102,"St Kilda",12,9,81,"Kardinia Park",21,1985,"Regular",17,"Home","Geelong","St Kilda",21
9312,1985-07-27,"R17","North Melbourne",17,12,114,"Melbourne",16,14,110,"M.C.G.",4,1985,"Regular",17,"Home","North Melbourne","Melbourne",4
9313,1985-08-03,"R18","Carlton",19,13,127,"Sydney",14,9,93,"Princes Park",34,1985,"Regular",18,"Home","Carlton","Sydney",34
9314,1985-08-03,"R18","Fitzroy",14,21,105,"Collingwood",14,10,94,"Victoria Park",11,1985,"Regular",18,"Home","Fitzroy","Collingwood",11
9315,1985-08-03,"R18","Essendon",25,16,166,"North Melbourne",8,14,62,"Windy Hill",104,1985,"Regular",18,"Home","Essendon","North Melbourne",104
9316,1985-08-03,"R18","Footscray",25,16,166,"Richmond",17,6,108,"Waverley Park",58,1985,"Regular",18,"Home","Footscray","Richmond",58
9317,1985-08-03,"R18","Melbourne",12,14,86,"Geelong",21,18,144,"M.C.G.",-58,1985,"Regular",18,"Away","Geelong","Melbourne",58
9318,1985-08-03,"R18","St Kilda",13,16,94,"Hawthorn",20,15,135,"Moorabbin Oval",-41,1985,"Regular",18,"Away","Hawthorn","St Kilda",41
9319,1985-08-10,"R19","Richmond",11,14,80,"Carlton",23,15,153,"M.C.G.",-73,1985,"Regular",19,"Away","Carlton","Richmond",73
9320,1985-08-10,"R19","Hawthorn",15,6,96,"Collingwood",8,16,64,"Princes Park",32,1985,"Regular",19,"Home","Hawthorn","Collingwood",32
9321,1985-08-10,"R19","Essendon",13,11,89,"Geelong",8,16,64,"Waverley Park",25,1985,"Regular",19,"Home","Essendon","Geelong",25
9322,1985-08-10,"R19","Fitzroy",10,12,72,"Footscray",12,5,77,"Victoria Park",-5,1985,"Regular",19,"Away","Footscray","Fitzroy",5
9323,1985-08-10,"R19","St Kilda",7,8,50,"Melbourne",8,11,59,"Moorabbin Oval",-9,1985,"Regular",19,"Away","Melbourne","St Kilda",9
9324,1985-08-11,"R19","Sydney",12,22,94,"North Melbourne",14,15,99,"S.C.G.",-5,1985,"Regular",19,"Away","North Melbourne","Sydney",5
9325,1985-08-17,"R20","Carlton",12,15,87,"Fitzroy",8,11,59,"Princes Park",28,1985,"Regular",20,"Home","Carlton","Fitzroy",28
9326,1985-08-17,"R20","Collingwood",17,18,120,"St Kilda",9,15,69,"Waverley Park",51,1985,"Regular",20,"Home","Collingwood","St Kilda",51
9327,1985-08-17,"R20","Melbourne",15,7,97,"Essendon",17,10,112,"M.C.G.",-15,1985,"Regular",20,"Away","Essendon","Melbourne",15
9328,1985-08-17,"R20","Footscray",5,13,43,"Hawthorn",5,8,38,"Western Oval",5,1985,"Regular",20,"Home","Footscray","Hawthorn",5
9329,1985-08-17,"R20","Geelong",13,13,91,"Sydney",9,10,64,"Kardinia Park",27,1985,"Regular",20,"Home","Geelong","Sydney",27
9330,1985-08-17,"R20","North Melbourne",16,20,116,"Richmond",9,12,66,"Arden St",50,1985,"Regular",20,"Home","North Melbourne","Richmond",50
9331,1985-08-24,"R21","Hawthorn",15,17,107,"Carlton",12,12,84,"Princes Park",23,1985,"Regular",21,"Home","Hawthorn","Carlton",23
9332,1985-08-24,"R21","Collingwood",9,10,64,"Footscray",15,19,109,"Victoria Park",-45,1985,"Regular",21,"Away","Footscray","Collingwood",45
9333,1985-08-24,"R21","Essendon",27,22,184,"St Kilda",14,7,91,"Windy Hill",93,1985,"Regular",21,"Home","Essendon","St Kilda",93
9334,1985-08-24,"R21","North Melbourne",17,22,124,"Fitzroy",17,14,116,"M.C.G.",8,1985,"Regular",21,"Home","North Melbourne","Fitzroy",8
9335,1985-08-24,"R21","Geelong",12,7,79,"Richmond",16,15,111,"Waverley Park",-32,1985,"Regular",21,"Away","Richmond","Geelong",32
9336,1985-08-25,"R21","Sydney",24,21,165,"Melbourne",14,13,97,"S.C.G.",68,1985,"Regular",21,"Home","Sydney","Melbourne",68
9337,1985-08-31,"R22","Carlton",12,9,81,"Collingwood",11,9,75,"Waverley Park",6,1985,"Regular",22,"Home","Carlton","Collingwood",6
9338,1985-08-31,"R22","Fitzroy",14,13,97,"Geelong",17,18,120,"Victoria Park",-23,1985,"Regular",22,"Away","Geelong","Fitzroy",23
9339,1985-08-31,"R22","St Kilda",12,12,84,"Footscray",8,18,66,"Moorabbin Oval",18,1985,"Regular",22,"Home","St Kilda","Footscray",18
9340,1985-08-31,"R22","Hawthorn",23,21,159,"North Melbourne",14,11,95,"Princes Park",64,1985,"Regular",22,"Home","Hawthorn","North Melbourne",64
9341,1985-08-31,"R22","Richmond",20,12,132,"Melbourne",13,13,91,"M.C.G.",41,1985,"Regular",22,"Home","Richmond","Melbourne",41
9342,1985-09-01,"R22","Sydney",11,12,78,"Essendon",24,21,165,"S.C.G.",-87,1985,"Regular",22,"Away","Essendon","Sydney",87
9343,1985-09-07,"EF","Carlton",16,11,107,"North Melbourne",20,6,126,"Waverley Park",-19,1985,"Finals",23,"Away","North Melbourne","Carlton",19
9344,1985-09-08,"QF","Footscray",8,14,62,"Hawthorn",22,23,155,"M.C.G.",-93,1985,"Finals",23,"Away","Hawthorn","Footscray",93
9345,1985-09-14,"SF","Essendon",14,18,102,"Hawthorn",9,8,62,"Waverley Park",40,1985,"Finals",24,"Home","Essendon","Hawthorn",40
9346,1985-09-15,"SF","Footscray",19,23,137,"North Melbourne",16,11,107,"M.C.G.",30,1985,"Finals",24,"Home","Footscray","North Melbourne",30
9347,1985-09-21,"PF","Footscray",15,9,99,"Hawthorn",16,13,109,"Waverley Park",-10,1985,"Finals",25,"Away","Hawthorn","Footscray",10
9348,1985-09-28,"GF","Essendon",26,14,170,"Hawthorn",14,8,92,"M.C.G.",78,1985,"Finals",26,"Home","Essendon","Hawthorn",78
9349,1986-03-29,"R1","Collingwood",10,8,68,"Essendon",19,19,133,"Victoria Park",-65,1986,"Regular",1,"Away","Essendon","Collingwood",65
9350,1986-03-29,"R1","Geelong",11,18,84,"Fitzroy",16,16,112,"Kardinia Park",-28,1986,"Regular",1,"Away","Fitzroy","Geelong",28
9351,1986-03-29,"R1","Richmond",19,14,128,"Melbourne",20,18,138,"M.C.G.",-10,1986,"Regular",1,"Away","Melbourne","Richmond",10
9352,1986-03-31,"R1","Hawthorn",17,11,113,"Carlton",11,11,77,"Waverley Park",36,1986,"Regular",1,"Home","Hawthorn","Carlton",36
9353,1986-03-31,"R1","Footscray",14,23,107,"St Kilda",12,18,90,"Western Oval",17,1986,"Regular",1,"Home","Footscray","St Kilda",17
9354,1986-03-31,"R1","North Melbourne",15,11,101,"Sydney",20,6,126,"M.C.G.",-25,1986,"Regular",1,"Away","Sydney","North Melbourne",25
9355,1986-04-04,"R2","North Melbourne",16,12,108,"Hawthorn",17,9,111,"M.C.G.",-3,1986,"Regular",2,"Away","Hawthorn","North Melbourne",3
9356,1986-04-05,"R2","Carlton",18,17,125,"Richmond",15,5,95,"Princes Park",30,1986,"Regular",2,"Home","Carlton","Richmond",30
9357,1986-04-05,"R2","Essendon",21,22,148,"Geelong",7,9,51,"Windy Hill",97,1986,"Regular",2,"Home","Essendon","Geelong",97
9358,1986-04-05,"R2","Fitzroy",10,19,79,"Footscray",10,9,69,"Waverley Park",10,1986,"Regular",2,"Home","Fitzroy","Footscray",10
9359,1986-04-05,"R2","Melbourne",21,10,136,"St Kilda",16,12,108,"M.C.G.",28,1986,"Regular",2,"Home","Melbourne","St Kilda",28
9360,1986-04-06,"R2","Sydney",19,20,134,"Collingwood",15,10,100,"S.C.G.",34,1986,"Regular",2,"Home","Sydney","Collingwood",34
9361,1986-04-12,"R3","St Kilda",10,9,69,"Carlton",24,13,157,"Moorabbin Oval",-88,1986,"Regular",3,"Away","Carlton","St Kilda",88
9362,1986-04-12,"R3","North Melbourne",17,10,112,"Collingwood",9,15,69,"M.C.G.",43,1986,"Regular",3,"Home","North Melbourne","Collingwood",43
9363,1986-04-12,"R3","Footscray",11,15,81,"Essendon",13,11,89,"Waverley Park",-8,1986,"Regular",3,"Away","Essendon","Footscray",8
9364,1986-04-12,"R3","Fitzroy",14,20,104,"Melbourne",13,10,88,"Victoria Park",16,1986,"Regular",3,"Home","Fitzroy","Melbourne",16
9365,1986-04-12,"R3","Geelong",15,15,105,"Sydney",19,18,132,"Kardinia Park",-27,1986,"Regular",3,"Away","Sydney","Geelong",27
9366,1986-04-12,"R3","Hawthorn",22,22,154,"Richmond",15,9,99,"Princes Park",55,1986,"Regular",3,"Home","Hawthorn","Richmond",55
9367,1986-04-19,"R4","Carlton",22,24,156,"Fitzroy",10,15,75,"Princes Park",81,1986,"Regular",4,"Home","Carlton","Fitzroy",81
9368,1986-04-19,"R4","Collingwood",20,16,136,"Geelong",13,13,91,"Victoria Park",45,1986,"Regular",4,"Home","Collingwood","Geelong",45
9369,1986-04-19,"R4","Essendon",27,8,170,"Melbourne",17,6,108,"Windy Hill",62,1986,"Regular",4,"Home","Essendon","Melbourne",62
9370,1986-04-19,"R4","St Kilda",17,14,116,"Hawthorn",19,14,128,"Moorabbin Oval",-12,1986,"Regular",4,"Away","Hawthorn","St Kilda",12
9371,1986-04-19,"R4","Richmond",17,11,113,"North Melbourne",14,12,96,"Waverley Park",17,1986,"Regular",4,"Home","Richmond","North Melbourne",17
9372,1986-04-20,"R4","Sydney",20,22,142,"Footscray",9,12,66,"S.C.G.",76,1986,"Regular",4,"Home","Sydney","Footscray",76
9373,1986-04-25,"R5","Carlton",10,11,71,"Essendon",8,7,55,"Waverley Park",16,1986,"Regular",5,"Home","Carlton","Essendon",16
9374,1986-04-25,"R5","Melbourne",14,17,101,"Sydney",16,14,110,"M.C.G.",-9,1986,"Regular",5,"Away","Sydney","Melbourne",9
9375,1986-04-25,"R5","North Melbourne",24,10,154,"Geelong",14,8,92,"M.C.G.",62,1986,"Regular",5,"Home","North Melbourne","Geelong",62
9376,1986-04-26,"R5","Footscray",10,20,80,"Collingwood",10,13,73,"Western Oval",7,1986,"Regular",5,"Home","Footscray","Collingwood",7
9377,1986-04-26,"R5","Fitzroy",13,26,104,"Hawthorn",13,12,90,"Victoria Park",14,1986,"Regular",5,"Home","Fitzroy","Hawthorn",14
9378,1986-04-26,"R5","Richmond",20,15,135,"St Kilda",11,18,84,"M.C.G.",51,1986,"Regular",5,"Home","Richmond","St Kilda",51
9379,1986-05-02,"R6","North Melbourne",19,25,139,"St Kilda",15,13,103,"M.C.G.",36,1986,"Regular",6,"Home","North Melbourne","St Kilda",36
9380,1986-05-03,"R6","Melbourne",11,17,83,"Collingwood",17,19,121,"M.C.G.",-38,1986,"Regular",6,"Away","Collingwood","Melbourne",38
9381,1986-05-03,"R6","Hawthorn",19,12,126,"Essendon",15,12,102,"Waverley Park",24,1986,"Regular",6,"Home","Hawthorn","Essendon",24
9382,1986-05-03,"R6","Fitzroy",18,13,121,"Richmond",17,20,122,"Princes Park",-1,1986,"Regular",6,"Away","Richmond","Fitzroy",1
9383,1986-05-03,"R6","Geelong",16,14,110,"Footscray",13,13,91,"Kardinia Park",19,1986,"Regular",6,"Home","Geelong","Footscray",19
9384,1986-05-04,"R6","Sydney",18,12,120,"Carlton",13,20,98,"S.C.G.",22,1986,"Regular",6,"Home","Sydney","Carlton",22
9385,1986-05-10,"R7","Collingwood",9,15,69,"Carlton",16,13,109,"Victoria Park",-40,1986,"Regular",7,"Away","Carlton","Collingwood",40
9386,1986-05-10,"R7","Richmond",16,9,105,"Essendon",21,19,145,"M.C.G.",-40,1986,"Regular",7,"Away","Essendon","Richmond",40
9387,1986-05-10,"R7","St Kilda",10,14,74,"Fitzroy",12,15,87,"Moorabbin Oval",-13,1986,"Regular",7,"Away","Fitzroy","St Kilda",13
9388,1986-05-10,"R7","Footscray",14,11,95,"North Melbourne",10,17,77,"Western Oval",18,1986,"Regular",7,"Home","Footscray","North Melbourne",18
9389,1986-05-10,"R7","Geelong",12,17,89,"Melbourne",7,16,58,"Waverley Park",31,1986,"Regular",7,"Home","Geelong","Melbourne",31
9390,1986-05-10,"R7","Hawthorn",18,25,133,"Sydney",15,10,100,"Princes Park",33,1986,"Regular",7,"Home","Hawthorn","Sydney",33
9391,1986-05-17,"R8","Carlton",20,14,134,"Geelong",16,9,105,"Princes Park",29,1986,"Regular",8,"Home","Carlton","Geelong",29
9392,1986-05-17,"R8","Collingwood",8,11,59,"Hawthorn",15,14,104,"Waverley Park",-45,1986,"Regular",8,"Away","Hawthorn","Collingwood",45
9393,1986-05-17,"R8","Essendon",22,14,146,"St Kilda",12,12,84,"Windy Hill",62,1986,"Regular",8,"Home","Essendon","St Kilda",62
9394,1986-05-17,"R8","Fitzroy",14,13,97,"North Melbourne",18,12,120,"Victoria Park",-23,1986,"Regular",8,"Away","North Melbourne","Fitzroy",23
9395,1986-05-17,"R8","Melbourne",20,12,132,"Footscray",11,14,80,"M.C.G.",52,1986,"Regular",8,"Home","Melbourne","Footscray",52
9396,1986-05-18,"R8","Sydney",16,15,111,"Richmond",16,16,112,"S.C.G.",-1,1986,"Regular",8,"Away","Richmond","Sydney",1
9397,1986-05-24,"R9","Footscray",7,8,50,"Carlton",4,12,36,"Western Oval",14,1986,"Regular",9,"Home","Footscray","Carlton",14
9398,1986-05-24,"R9","Richmond",11,10,76,"Collingwood",16,16,112,"M.C.G.",-36,1986,"Regular",9,"Away","Collingwood","Richmond",36
9399,1986-05-24,"R9","Fitzroy",18,7,115,"Essendon",10,10,70,"Victoria Park",45,1986,"Regular",9,"Home","Fitzroy","Essendon",45
9400,1986-05-24,"R9","North Melbourne",12,11,83,"Melbourne",6,12,48,"Waverley Park",35,1986,"Regular",9,"Home","North Melbourne","Melbourne",35
9401,1986-05-24,"R9","St Kilda",5,8,38,"Sydney",6,11,47,"Moorabbin Oval",-9,1986,"Regular",9,"Away","Sydney","St Kilda",9
9402,1986-05-25,"R9","Geelong",12,14,86,"Hawthorn",19,5,119,"Kardinia Park",-33,1986,"Regular",9,"Away","Hawthorn","Geelong",33
9403,1986-05-30,"R10","North Melbourne",21,11,137,"Essendon",18,13,121,"M.C.G.",16,1986,"Regular",10,"Home","North Melbourne","Essendon",16
9404,1986-05-31,"R10","Melbourne",6,13,49,"Carlton",25,15,165,"M.C.G.",-116,1986,"Regular",10,"Away","Carlton","Melbourne",116
9405,1986-05-31,"R10","Collingwood",19,19,133,"St Kilda",14,7,91,"Waverley Park",42,1986,"Regular",10,"Home","Collingwood","St Kilda",42
9406,1986-05-31,"R10","Hawthorn",11,13,79,"Footscray",16,12,108,"Princes Park",-29,1986,"Regular",10,"Away","Footscray","Hawthorn",29
9407,1986-05-31,"R10","Geelong",19,12,126,"Richmond",16,14,110,"Kardinia Park",16,1986,"Regular",10,"Home","Geelong","Richmond",16
9408,1986-06-01,"R10","Sydney",18,18,126,"Fitzroy",14,17,101,"S.C.G.",25,1986,"Regular",10,"Home","Sydney","Fitzroy",25
9409,1986-06-07,"R11","Collingwood",18,14,122,"Fitzroy",11,12,78,"Victoria Park",44,1986,"Regular",11,"Home","Collingwood","Fitzroy",44
9410,1986-06-07,"R11","St Kilda",13,10,88,"Geelong",19,12,126,"Waverley Park",-38,1986,"Regular",11,"Away","Geelong","St Kilda",38
9411,1986-06-07,"R11","Hawthorn",21,19,145,"Melbourne",9,6,60,"Princes Park",85,1986,"Regular",11,"Home","Hawthorn","Melbourne",85
9412,1986-06-09,"R11","Carlton",22,10,142,"North Melbourne",9,10,64,"Princes Park",78,1986,"Regular",11,"Home","Carlton","North Melbourne",78
9413,1986-06-09,"R11","Essendon",9,4,58,"Sydney",10,18,78,"Windy Hill",-20,1986,"Regular",11,"Away","Sydney","Essendon",20
9414,1986-06-09,"R11","Richmond",15,7,97,"Footscray",12,8,80,"M.C.G.",17,1986,"Regular",11,"Home","Richmond","Footscray",17
9415,1986-06-13,"R12","Sydney",13,13,91,"North Melbourne",14,11,95,"S.C.G.",-4,1986,"Regular",12,"Away","North Melbourne","Sydney",4
9416,1986-06-14,"R12","Essendon",13,16,94,"Collingwood",18,12,120,"Waverley Park",-26,1986,"Regular",12,"Away","Collingwood","Essendon",26
9417,1986-06-14,"R12","Fitzroy",22,13,145,"Geelong",11,11,77,"Victoria Park",68,1986,"Regular",12,"Home","Fitzroy","Geelong",68
9418,1986-06-14,"R12","St Kilda",10,15,75,"Footscray",24,10,154,"Moorabbin Oval",-79,1986,"Regular",12,"Away","Footscray","St Kilda",79
9419,1986-06-14,"R12","Melbourne",17,23,125,"Richmond",21,8,134,"M.C.G.",-9,1986,"Regular",12,"Away","Richmond","Melbourne",9
9420,1986-06-15,"R12","Carlton",16,14,110,"Hawthorn",19,19,133,"M.C.G.",-23,1986,"Regular",12,"Away","Hawthorn","Carlton",23
9421,1986-06-21,"R13","Richmond",11,7,73,"Carlton",19,18,132,"Waverley Park",-59,1986,"Regular",13,"Away","Carlton","Richmond",59
9422,1986-06-21,"R13","Collingwood",14,11,95,"Sydney",14,12,96,"Victoria Park",-1,1986,"Regular",13,"Away","Sydney","Collingwood",1
9423,1986-06-21,"R13","Geelong",11,11,77,"Essendon",12,17,89,"Kardinia Park",-12,1986,"Regular",13,"Away","Essendon","Geelong",12
9424,1986-06-21,"R13","Footscray",22,11,143,"Fitzroy",8,7,55,"Western Oval",88,1986,"Regular",13,"Home","Footscray","Fitzroy",88
9425,1986-06-21,"R13","Hawthorn",21,26,152,"North Melbourne",13,14,92,"Princes Park",60,1986,"Regular",13,"Home","Hawthorn","North Melbourne",60
9426,1986-06-21,"R13","St Kilda",15,11,101,"Melbourne",7,7,49,"Moorabbin Oval",52,1986,"Regular",13,"Home","St Kilda","Melbourne",52
9427,1986-06-28,"R14","Carlton",24,19,163,"St Kilda",11,10,76,"Princes Park",87,1986,"Regular",14,"Home","Carlton","St Kilda",87
9428,1986-06-28,"R14","Collingwood",17,13,115,"North Melbourne",9,14,68,"Victoria Park",47,1986,"Regular",14,"Home","Collingwood","North Melbourne",47
9429,1986-06-28,"R14","Essendon",8,8,56,"Footscray",12,13,85,"Windy Hill",-29,1986,"Regular",14,"Away","Footscray","Essendon",29
9430,1986-06-28,"R14","Melbourne",17,13,115,"Fitzroy",11,5,71,"Waverley Park",44,1986,"Regular",14,"Home","Melbourne","Fitzroy",44
9431,1986-06-28,"R14","Richmond",11,8,74,"Hawthorn",26,19,175,"M.C.G.",-101,1986,"Regular",14,"Away","Hawthorn","Richmond",101
9432,1986-06-29,"R14","Sydney",17,11,113,"Geelong",13,13,91,"S.C.G.",22,1986,"Regular",14,"Home","Sydney","Geelong",22
9433,1986-07-04,"R15","North Melbourne",13,8,86,"Richmond",16,18,114,"M.C.G.",-28,1986,"Regular",15,"Away","Richmond","North Melbourne",28
9434,1986-07-05,"R15","Fitzroy",8,11,59,"Carlton",7,11,53,"Waverley Park",6,1986,"Regular",15,"Home","Fitzroy","Carlton",6
9435,1986-07-05,"R15","Geelong",8,10,58,"Collingwood",19,15,129,"Kardinia Park",-71,1986,"Regular",15,"Away","Collingwood","Geelong",71
9436,1986-07-05,"R15","Melbourne",8,12,60,"Essendon",27,20,182,"M.C.G.",-122,1986,"Regular",15,"Away","Essendon","Melbourne",122
9437,1986-07-05,"R15","Footscray",11,4,70,"Sydney",12,14,86,"Western Oval",-16,1986,"Regular",15,"Away","Sydney","Footscray",16
9438,1986-07-05,"R15","Hawthorn",8,11,59,"St Kilda",5,8,38,"Princes Park",21,1986,"Regular",15,"Home","Hawthorn","St Kilda",21
9439,1986-07-12,"R16","North Melbourne",13,14,92,"Carlton",22,17,149,"M.C.G.",-57,1986,"Regular",16,"Away","Carlton","North Melbourne",57
9440,1986-07-12,"R16","Geelong",16,16,112,"St Kilda",13,7,85,"Kardinia Park",27,1986,"Regular",16,"Home","Geelong","St Kilda",27
9441,1986-07-12,"R16","Melbourne",6,14,50,"Hawthorn",17,15,117,"Waverley Park",-67,1986,"Regular",16,"Away","Hawthorn","Melbourne",67
9442,1986-07-13,"R16","Sydney",24,18,162,"Essendon",15,13,103,"S.C.G.",59,1986,"Regular",16,"Home","Sydney","Essendon",59
9443,1986-07-19,"R16","Fitzroy",12,13,85,"Collingwood",20,12,132,"Waverley Park",-47,1986,"Regular",16,"Away","Collingwood","Fitzroy",47
9444,1986-07-19,"R16","Footscray",17,20,122,"Richmond",14,11,95,"Western Oval",27,1986,"Regular",16,"Home","Footscray","Richmond",27
9445,1986-07-20,"R17","Essendon",15,15,105,"Carlton",11,14,80,"M.C.G.",25,1986,"Regular",17,"Home","Essendon","Carlton",25
9446,1986-07-26,"R17","Collingwood",11,10,76,"Footscray",9,11,65,"M.C.G.",11,1986,"Regular",17,"Home","Collingwood","Footscray",11
9447,1986-07-26,"R17","Hawthorn",6,9,45,"Fitzroy",14,12,96,"Princes Park",-51,1986,"Regular",17,"Away","Fitzroy","Hawthorn",51
9448,1986-07-26,"R17","Geelong",19,9,123,"North Melbourne",22,10,142,"Waverley Park",-19,1986,"Regular",17,"Away","North Melbourne","Geelong",19
9449,1986-07-26,"R17","St Kilda",20,9,129,"Richmond",7,12,54,"Moorabbin Oval",75,1986,"Regular",17,"Home","St Kilda","Richmond",75
9450,1986-07-27,"R17","Sydney",29,15,189,"Melbourne",9,11,65,"S.C.G.",124,1986,"Regular",17,"Home","Sydney","Melbourne",124
9451,1986-08-02,"R18","Carlton",15,14,104,"Sydney",12,15,87,"Princes Park",17,1986,"Regular",18,"Home","Carlton","Sydney",17
9452,1986-08-02,"R18","Collingwood",13,14,92,"Melbourne",16,9,105,"Victoria Park",-13,1986,"Regular",18,"Away","Melbourne","Collingwood",13
9453,1986-08-02,"R18","Essendon",21,11,137,"Hawthorn",6,14,50,"Windy Hill",87,1986,"Regular",18,"Home","Essendon","Hawthorn",87
9454,1986-08-02,"R18","Richmond",11,19,85,"Fitzroy",13,16,94,"M.C.G.",-9,1986,"Regular",18,"Away","Fitzroy","Richmond",9
9455,1986-08-02,"R18","Footscray",11,13,79,"Geelong",10,16,76,"Waverley Park",3,1986,"Regular",18,"Home","Footscray","Geelong",3
9456,1986-08-02,"R18","St Kilda",13,12,90,"North Melbourne",19,13,127,"Moorabbin Oval",-37,1986,"Regular",18,"Away","North Melbourne","St Kilda",37
9457,1986-08-09,"R19","Essendon",23,16,154,"Richmond",11,9,75,"Waverley Park",79,1986,"Regular",19,"Home","Essendon","Richmond",79
9458,1986-08-09,"R19","Fitzroy",24,16,160,"St Kilda",11,9,75,"Victoria Park",85,1986,"Regular",19,"Home","Fitzroy","St Kilda",85
9459,1986-08-09,"R19","Melbourne",18,19,127,"Geelong",17,18,120,"M.C.G.",7,1986,"Regular",19,"Home","Melbourne","Geelong",7
9460,1986-08-09,"R19","North Melbourne",20,20,140,"Footscray",10,23,83,"M.C.G.",57,1986,"Regular",19,"Home","North Melbourne","Footscray",57
9461,1986-08-10,"R19","Carlton",21,10,136,"Collingwood",12,15,87,"M.C.G.",49,1986,"Regular",19,"Home","Carlton","Collingwood",49
9462,1986-08-10,"R19","Sydney",10,13,73,"Hawthorn",27,9,171,"S.C.G.",-98,1986,"Regular",19,"Away","Hawthorn","Sydney",98
9463,1986-08-16,"R20","Geelong",16,12,108,"Carlton",10,19,79,"Kardinia Park",29,1986,"Regular",20,"Home","Geelong","Carlton",29
9464,1986-08-16,"R20","Hawthorn",20,24,144,"Collingwood",10,12,72,"Princes Park",72,1986,"Regular",20,"Home","Hawthorn","Collingwood",72
9465,1986-08-16,"R20","St Kilda",6,12,48,"Essendon",11,16,82,"Moorabbin Oval",-34,1986,"Regular",20,"Away","Essendon","St Kilda",34
9466,1986-08-16,"R20","North Melbourne",14,9,93,"Fitzroy",9,7,61,"Waverley Park",32,1986,"Regular",20,"Home","North Melbourne","Fitzroy",32
9467,1986-08-16,"R20","Footscray",19,14,128,"Melbourne",10,11,71,"Western Oval",57,1986,"Regular",20,"Home","Footscray","Melbourne",57
9468,1986-08-16,"R20","Richmond",14,12,96,"Sydney",21,18,144,"M.C.G.",-48,1986,"Regular",20,"Away","Sydney","Richmond",48
9469,1986-08-23,"R21","Carlton",23,13,151,"Footscray",10,12,72,"Waverley Park",79,1986,"Regular",21,"Home","Carlton","Footscray",79
9470,1986-08-23,"R21","Collingwood",23,18,156,"Richmond",8,7,55,"Victoria Park",101,1986,"Regular",21,"Home","Collingwood","Richmond",101
9471,1986-08-23,"R21","Essendon",8,13,61,"Fitzroy",14,12,96,"Windy Hill",-35,1986,"Regular",21,"Away","Fitzroy","Essendon",35
9472,1986-08-23,"R21","Hawthorn",35,15,225,"Geelong",13,12,90,"Princes Park",135,1986,"Regular",21,"Home","Hawthorn","Geelong",135
9473,1986-08-23,"R21","Melbourne",28,14,182,"North Melbourne",14,13,97,"M.C.G.",85,1986,"Regular",21,"Home","Melbourne","North Melbourne",85
9474,1986-08-24,"R21","Sydney",20,20,140,"St Kilda",16,15,111,"S.C.G.",29,1986,"Regular",21,"Home","Sydney","St Kilda",29
9475,1986-08-30,"R22","Carlton",20,19,139,"Melbourne",6,17,53,"Princes Park",86,1986,"Regular",22,"Home","Carlton","Melbourne",86
9476,1986-08-30,"R22","St Kilda",11,7,73,"Collingwood",18,17,125,"Waverley Park",-52,1986,"Regular",22,"Away","Collingwood","St Kilda",52
9477,1986-08-30,"R22","Essendon",10,19,79,"North Melbourne",15,11,101,"Windy Hill",-22,1986,"Regular",22,"Away","North Melbourne","Essendon",22
9478,1986-08-30,"R22","Fitzroy",9,19,73,"Sydney",8,15,63,"Victoria Park",10,1986,"Regular",22,"Home","Fitzroy","Sydney",10
9479,1986-08-30,"R22","Footscray",7,13,55,"Hawthorn",19,11,125,"Western Oval",-70,1986,"Regular",22,"Away","Hawthorn","Footscray",70
9480,1986-08-30,"R22","Richmond",15,14,104,"Geelong",20,16,136,"M.C.G.",-32,1986,"Regular",22,"Away","Geelong","Richmond",32
9481,1986-09-06,"EF","Fitzroy",8,10,58,"Essendon",8,9,57,"Waverley Park",1,1986,"Finals",23,"Home","Fitzroy","Essendon",1
9482,1986-09-07,"QF","Sydney",15,14,104,"Carlton",18,12,120,"M.C.G.",-16,1986,"Finals",23,"Away","Carlton","Sydney",16
9483,1986-09-13,"SF","Hawthorn",13,6,84,"Carlton",16,16,112,"Waverley Park",-28,1986,"Finals",24,"Away","Carlton","Hawthorn",28
9484,1986-09-14,"SF","Sydney",13,11,89,"Fitzroy",13,16,94,"M.C.G.",-5,1986,"Finals",24,"Away","Fitzroy","Sydney",5
9485,1986-09-20,"PF","Hawthorn",16,14,110,"Fitzroy",7,12,54,"Waverley Park",56,1986,"Finals",25,"Home","Hawthorn","Fitzroy",56
9486,1986-09-27,"GF","Hawthorn",16,14,110,"Carlton",9,14,68,"M.C.G.",42,1986,"Finals",26,"Home","Hawthorn","Carlton",42
9487,1987-03-27,"R1","North Melbourne",15,14,104,"Brisbane Lions",19,23,137,"M.C.G.",-33,1987,"Regular",1,"Away","Brisbane Lions","North Melbourne",33
9488,1987-03-28,"R1","Carlton",15,14,104,"Hawthorn",22,17,149,"Princes Park",-45,1987,"Regular",1,"Away","Hawthorn","Carlton",45
9489,1987-03-28,"R1","Collingwood",11,8,74,"Sydney",25,15,165,"Victoria Park",-91,1987,"Regular",1,"Away","Sydney","Collingwood",91
9490,1987-03-28,"R1","Footscray",9,8,62,"Essendon",19,7,121,"Waverley Park",-59,1987,"Regular",1,"Away","Essendon","Footscray",59
9491,1987-03-28,"R1","Melbourne",19,14,128,"Fitzroy",12,17,89,"M.C.G.",39,1987,"Regular",1,"Home","Melbourne","Fitzroy",39
9492,1987-03-28,"R1","St Kilda",15,11,101,"Geelong",14,18,102,"Moorabbin Oval",-1,1987,"Regular",1,"Away","Geelong","St Kilda",1
9493,1987-03-29,"R1","West Coast",20,13,133,"Richmond",16,23,119,"Subiaco",14,1987,"Regular",1,"Home","West Coast","Richmond",14
9494,1987-04-03,"R2","North Melbourne",13,14,92,"Melbourne",7,17,59,"M.C.G.",33,1987,"Regular",2,"Home","North Melbourne","Melbourne",33
9495,1987-04-04,"R2","Geelong",19,17,131,"Brisbane Lions",23,12,150,"Kardinia Park",-19,1987,"Regular",2,"Away","Brisbane Lions","Geelong",19
9496,1987-04-04,"R2","Collingwood",17,5,107,"Carlton",16,18,114,"Waverley Park",-7,1987,"Regular",2,"Away","Carlton","Collingwood",7
9497,1987-04-04,"R2","Essendon",17,17,119,"West Coast",17,12,114,"Windy Hill",5,1987,"Regular",2,"Home","Essendon","West Coast",5
9498,1987-04-04,"R2","Fitzroy",23,21,159,"St Kilda",17,13,115,"Princes Park",44,1987,"Regular",2,"Home","Fitzroy","St Kilda",44
9499,1987-04-04,"R2","Richmond",13,15,93,"Hawthorn",23,17,155,"M.C.G.",-62,1987,"Regular",2,"Away","Hawthorn","Richmond",62
9500,1987-04-05,"R2","Sydney",27,25,187,"Footscray",11,13,79,"S.C.G.",108,1987,"Regular",2,"Home","Sydney","Footscray",108
9501,1987-04-10,"R3","Fitzroy",20,9,129,"North Melbourne",7,13,55,"Waverley Park",74,1987,"Regular",3,"Home","Fitzroy","North Melbourne",74
9502,1987-04-11,"R3","St Kilda",21,7,133,"Brisbane Lions",11,17,83,"Moorabbin Oval",50,1987,"Regular",3,"Home","St Kilda","Brisbane Lions",50
9503,1987-04-11,"R3","Footscray",5,10,40,"Carlton",18,19,127,"Western Oval",-87,1987,"Regular",3,"Away","Carlton","Footscray",87
9504,1987-04-11,"R3","Hawthorn",20,25,145,"Collingwood",10,8,68,"Princes Park",77,1987,"Regular",3,"Home","Hawthorn","Collingwood",77
9505,1987-04-11,"R3","Richmond",19,16,130,"Essendon",12,12,84,"M.C.G.",46,1987,"Regular",3,"Home","Richmond","Essendon",46
9506,1987-04-11,"R3","Geelong",18,20,128,"Melbourne",13,16,94,"Kardinia Park",34,1987,"Regular",3,"Home","Geelong","Melbourne",34
9507,1987-04-12,"R3","West Coast",14,13,97,"Sydney",18,16,124,"Subiaco",-27,1987,"Regular",3,"Away","Sydney","West Coast",27
9508,1987-04-18,"R4","Carlton",29,17,191,"West Coast",15,14,104,"Princes Park",87,1987,"Regular",4,"Home","Carlton","West Coast",87
9509,1987-04-18,"R4","Geelong",18,19,127,"North Melbourne",19,22,136,"Kardinia Park",-9,1987,"Regular",4,"Away","North Melbourne","Geelong",9
9510,1987-04-18,"R4","Melbourne",21,13,139,"St Kilda",14,8,92,"M.C.G.",47,1987,"Regular",4,"Home","Melbourne","St Kilda",47
9511,1987-04-19,"R4","Brisbane Lions",16,18,114,"Fitzroy",20,9,129,"Carrara",-15,1987,"Regular",4,"Away","Fitzroy","Brisbane Lions",15
9512,1987-04-20,"R4","Collingwood",16,14,110,"Richmond",15,10,100,"Waverley Park",10,1987,"Regular",4,"Home","Collingwood","Richmond",10
9513,1987-04-20,"R4","Essendon",17,11,113,"Sydney",9,12,66,"Windy Hill",47,1987,"Regular",4,"Home","Essendon","Sydney",47
9514,1987-04-20,"R4","Footscray",14,12,96,"Hawthorn",7,13,55,"Western Oval",41,1987,"Regular",4,"Home","Footscray","Hawthorn",41
9515,1987-04-24,"R5","North Melbourne",18,19,127,"St Kilda",16,14,110,"M.C.G.",17,1987,"Regular",5,"Home","North Melbourne","St Kilda",17
9516,1987-04-25,"R5","Carlton",17,14,116,"Essendon",9,8,62,"Waverley Park",54,1987,"Regular",5,"Home","Carlton","Essendon",54
9517,1987-04-25,"R5","Collingwood",14,5,89,"Footscray",12,13,85,"Victoria Park",4,1987,"Regular",5,"Home","Collingwood","Footscray",4
9518,1987-04-25,"R5","Geelong",29,10,184,"Fitzroy",17,7,109,"Kardinia Park",75,1987,"Regular",5,"Home","Geelong","Fitzroy",75
9519,1987-04-25,"R5","Hawthorn",13,14,92,"West Coast",15,14,104,"Princes Park",-12,1987,"Regular",5,"Away","West Coast","Hawthorn",12
9520,1987-04-25,"R5","Richmond",19,12,126,"Sydney",21,20,146,"M.C.G.",-20,1987,"Regular",5,"Away","Sydney","Richmond",20
9521,1987-04-26,"R5","Brisbane Lions",12,14,86,"Melbourne",12,9,81,"Carrara",5,1987,"Regular",5,"Home","Brisbane Lions","Melbourne",5
9522,1987-05-01,"R6","Sydney",13,16,94,"Carlton",12,15,87,"S.C.G.",7,1987,"Regular",6,"Home","Sydney","Carlton",7
9523,1987-05-02,"R6","Collingwood",16,9,105,"Brisbane Lions",8,10,58,"Victoria Park",47,1987,"Regular",6,"Home","Collingwood","Brisbane Lions",47
9524,1987-05-02,"R6","Essendon",14,12,96,"Geelong",13,18,96,"Windy Hill",0,1987,"Regular",6,"Home","Essendon","Geelong",0
9525,1987-05-02,"R6","Footscray",11,12,78,"St Kilda",4,10,34,"Waverley Park",44,1987,"Regular",6,"Home","Footscray","St Kilda",44
9526,1987-05-02,"R6","Melbourne",16,14,110,"Richmond",9,15,69,"M.C.G.",41,1987,"Regular",6,"Home","Melbourne","Richmond",41
9527,1987-05-03,"R6","Fitzroy",15,14,104,"Hawthorn",16,17,113,"M.C.G.",-9,1987,"Regular",6,"Away","Hawthorn","Fitzroy",9
9528,1987-05-03,"R6","West Coast",24,18,162,"North Melbourne",13,10,88,"Subiaco",74,1987,"Regular",6,"Home","West Coast","North Melbourne",74
9529,1987-05-08,"R7","West Coast",10,21,81,"Brisbane Lions",8,14,62,"W.A.C.A.",19,1987,"Regular",7,"Home","West Coast","Brisbane Lions",19
9530,1987-05-09,"R7","Carlton",22,18,150,"Geelong",14,10,94,"Waverley Park",56,1987,"Regular",7,"Home","Carlton","Geelong",56
9531,1987-05-09,"R7","Melbourne",18,18,126,"Collingwood",12,8,80,"M.C.G.",46,1987,"Regular",7,"Home","Melbourne","Collingwood",46
9532,1987-05-09,"R7","Fitzroy",25,9,159,"Essendon",21,8,134,"Princes Park",25,1987,"Regular",7,"Home","Fitzroy","Essendon",25
9533,1987-05-09,"R7","Footscray",13,10,88,"North Melbourne",19,8,122,"Western Oval",-34,1987,"Regular",7,"Away","North Melbourne","Footscray",34
9534,1987-05-09,"R7","St Kilda",21,11,137,"Richmond",17,12,114,"Moorabbin Oval",23,1987,"Regular",7,"Home","St Kilda","Richmond",23
9535,1987-05-10,"R7","Sydney",18,14,122,"Hawthorn",17,12,114,"S.C.G.",8,1987,"Regular",7,"Home","Sydney","Hawthorn",8
9536,1987-05-15,"R8","Sydney",13,9,87,"Fitzroy",16,20,116,"S.C.G.",-29,1987,"Regular",8,"Away","Fitzroy","Sydney",29
9537,1987-05-16,"R8","Collingwood",10,8,68,"Essendon",14,10,94,"Waverley Park",-26,1987,"Regular",8,"Away","Essendon","Collingwood",26
9538,1987-05-16,"R8","Melbourne",11,15,81,"Footscray",15,15,105,"M.C.G.",-24,1987,"Regular",8,"Away","Footscray","Melbourne",24
9539,1987-05-16,"R8","Hawthorn",17,10,112,"Geelong",10,5,65,"Princes Park",47,1987,"Regular",8,"Home","Hawthorn","Geelong",47
9540,1987-05-16,"R8","St Kilda",14,13,97,"West Coast",6,13,49,"Moorabbin Oval",48,1987,"Regular",8,"Home","St Kilda","West Coast",48
9541,1987-05-17,"R8","Brisbane Lions",22,12,144,"Richmond",15,19,109,"Carrara",35,1987,"Regular",8,"Home","Brisbane Lions","Richmond",35
9542,1987-05-17,"R8","North Melbourne",10,11,71,"Carlton",15,15,105,"M.C.G.",-34,1987,"Regular",8,"Away","Carlton","North Melbourne",34
9543,1987-05-22,"R9","Richmond",13,16,94,"North Melbourne",17,26,128,"M.C.G.",-34,1987,"Regular",9,"Away","North Melbourne","Richmond",34
9544,1987-05-23,"R9","Footscray",14,19,103,"Brisbane Lions",10,11,71,"Western Oval",32,1987,"Regular",9,"Home","Footscray","Brisbane Lions",32
9545,1987-05-23,"R9","Carlton",12,20,92,"Fitzroy",9,16,70,"Princes Park",22,1987,"Regular",9,"Home","Carlton","Fitzroy",22
9546,1987-05-23,"R9","Collingwood",15,15,105,"St Kilda",15,9,99,"Victoria Park",6,1987,"Regular",9,"Home","Collingwood","St Kilda",6
9547,1987-05-23,"R9","Hawthorn",25,15,165,"Essendon",7,9,51,"Waverley Park",114,1987,"Regular",9,"Home","Hawthorn","Essendon",114
9548,1987-05-24,"R9","Geelong",15,14,104,"Sydney",11,13,79,"Kardinia Park",25,1987,"Regular",9,"Home","Geelong","Sydney",25
9549,1987-05-24,"R9","West Coast",20,15,135,"Melbourne",18,11,119,"Subiaco",16,1987,"Regular",9,"Home","West Coast","Melbourne",16
9550,1987-05-30,"R10","Carlton",27,22,184,"Brisbane Lions",12,9,81,"Princes Park",103,1987,"Regular",10,"Home","Carlton","Brisbane Lions",103
9551,1987-05-30,"R10","Essendon",11,14,80,"Melbourne",15,12,102,"Windy Hill",-22,1987,"Regular",10,"Away","Melbourne","Essendon",22
9552,1987-05-30,"R10","Footscray",10,19,79,"Fitzroy",7,4,46,"Western Oval",33,1987,"Regular",10,"Home","Footscray","Fitzroy",33
9553,1987-05-30,"R10","Richmond",14,13,97,"Geelong",18,10,118,"M.C.G.",-21,1987,"Regular",10,"Away","Geelong","Richmond",21
9554,1987-05-30,"R10","Hawthorn",23,16,154,"St Kilda",15,8,98,"Waverley Park",56,1987,"Regular",10,"Home","Hawthorn","St Kilda",56
9555,1987-05-31,"R10","Sydney",20,16,136,"North Melbourne",23,7,145,"S.C.G.",-9,1987,"Regular",10,"Away","North Melbourne","Sydney",9
9556,1987-06-01,"R10","West Coast",19,23,137,"Collingwood",11,14,80,"Subiaco",57,1987,"Regular",10,"Home","West Coast","Collingwood",57
9557,1987-06-06,"R11","St Kilda",16,10,106,"Essendon",18,13,121,"Moorabbin Oval",-15,1987,"Regular",11,"Away","Essendon","St Kilda",15
9558,1987-06-06,"R11","Footscray",18,13,121,"West Coast",15,9,99,"Western Oval",22,1987,"Regular",11,"Home","Footscray","West Coast",22
9559,1987-06-06,"R11","North Melbourne",14,7,91,"Hawthorn",17,11,113,"Waverley Park",-22,1987,"Regular",11,"Away","Hawthorn","North Melbourne",22
9560,1987-06-07,"R11","Brisbane Lions",9,10,64,"Sydney",19,23,137,"Carrara",-73,1987,"Regular",11,"Away","Sydney","Brisbane Lions",73
9561,1987-06-08,"R11","Melbourne",13,12,90,"Carlton",21,9,135,"M.C.G.",-45,1987,"Regular",11,"Away","Carlton","Melbourne",45
9562,1987-06-08,"R11","Geelong",17,13,115,"Collingwood",17,8,110,"Waverley Park",5,1987,"Regular",11,"Home","Geelong","Collingwood",5
9563,1987-06-08,"R11","Fitzroy",18,15,123,"Richmond",22,17,149,"Princes Park",-26,1987,"Regular",11,"Away","Richmond","Fitzroy",26
9564,1987-06-12,"R12","North Melbourne",15,10,100,"Essendon",9,10,64,"M.C.G.",36,1987,"Regular",12,"Home","North Melbourne","Essendon",36
9565,1987-06-13,"R12","Carlton",12,25,97,"St Kilda",14,12,96,"Princes Park",1,1987,"Regular",12,"Home","Carlton","St Kilda",1
9566,1987-06-13,"R12","Collingwood",15,16,106,"Fitzroy",11,14,80,"Victoria Park",26,1987,"Regular",12,"Home","Collingwood","Fitzroy",26
9567,1987-06-13,"R12","Richmond",11,8,74,"Footscray",21,16,142,"Waverley Park",-68,1987,"Regular",12,"Away","Footscray","Richmond",68
9568,1987-06-13,"R12","Geelong",13,13,91,"West Coast",12,13,85,"Kardinia Park",6,1987,"Regular",12,"Home","Geelong","West Coast",6
9569,1987-06-13,"R12","Melbourne",11,10,76,"Sydney",17,10,112,"M.C.G.",-36,1987,"Regular",12,"Away","Sydney","Melbourne",36
9570,1987-06-14,"R12","Brisbane Lions",11,4,70,"Hawthorn",24,21,165,"Carrara",-95,1987,"Regular",12,"Away","Hawthorn","Brisbane Lions",95
9571,1987-06-19,"R13","West Coast",16,18,114,"Fitzroy",5,12,42,"W.A.C.A.",72,1987,"Regular",13,"Home","West Coast","Fitzroy",72
9572,1987-06-20,"R13","Essendon",9,10,64,"Brisbane Lions",3,9,27,"Windy Hill",37,1987,"Regular",13,"Home","Essendon","Brisbane Lions",37
9573,1987-06-20,"R13","Richmond",4,3,27,"Carlton",6,7,43,"M.C.G.",-16,1987,"Regular",13,"Away","Carlton","Richmond",16
9574,1987-06-20,"R13","Collingwood",2,6,18,"North Melbourne",10,12,72,"Waverley Park",-54,1987,"Regular",13,"Away","North Melbourne","Collingwood",54
9575,1987-06-20,"R13","Footscray",13,11,89,"Geelong",8,2,50,"Western Oval",39,1987,"Regular",13,"Home","Footscray","Geelong",39
9576,1987-06-20,"R13","Hawthorn",6,8,44,"Melbourne",8,9,57,"Princes Park",-13,1987,"Regular",13,"Away","Melbourne","Hawthorn",13
9577,1987-06-21,"R13","Sydney",20,14,134,"St Kilda",11,9,75,"S.C.G.",59,1987,"Regular",13,"Home","Sydney","St Kilda",59
9578,1987-06-26,"R14","Sydney",14,17,101,"Collingwood",10,14,74,"S.C.G.",27,1987,"Regular",14,"Home","Sydney","Collingwood",27
9579,1987-06-27,"R14","Hawthorn",12,8,80,"Carlton",12,7,79,"Waverley Park",1,1987,"Regular",14,"Home","Hawthorn","Carlton",1
9580,1987-06-27,"R14","Essendon",7,10,52,"Footscray",9,10,64,"Windy Hill",-12,1987,"Regular",14,"Away","Footscray","Essendon",12
9581,1987-06-27,"R14","Fitzroy",11,16,82,"Melbourne",4,10,34,"Princes Park",48,1987,"Regular",14,"Home","Fitzroy","Melbourne",48
9582,1987-06-27,"R14","Geelong",13,20,98,"St Kilda",3,9,27,"Kardinia Park",71,1987,"Regular",14,"Home","Geelong","St Kilda",71
9583,1987-06-27,"R14","Richmond",9,19,73,"West Coast",9,15,69,"M.C.G.",4,1987,"Regular",14,"Home","Richmond","West Coast",4
9584,1987-06-28,"R14","Brisbane Lions",17,11,113,"North Melbourne",23,13,151,"Carrara",-38,1987,"Regular",14,"Away","North Melbourne","Brisbane Lions",38
9585,1987-07-03,"R15","West Coast",18,10,118,"Essendon",21,20,146,"W.A.C.A.",-28,1987,"Regular",15,"Away","Essendon","West Coast",28
9586,1987-07-04,"R15","St Kilda",20,14,134,"Fitzroy",15,10,100,"Moorabbin Oval",34,1987,"Regular",15,"Home","St Kilda","Fitzroy",34
9587,1987-07-04,"R15","Footscray",10,13,73,"Sydney",16,10,106,"Waverley Park",-33,1987,"Regular",15,"Away","Sydney","Footscray",33
9588,1987-07-04,"R15","Hawthorn",19,20,134,"Richmond",11,11,77,"Princes Park",57,1987,"Regular",15,"Home","Hawthorn","Richmond",57
9589,1987-07-04,"R15","Melbourne",15,20,110,"North Melbourne",16,16,112,"M.C.G.",-2,1987,"Regular",15,"Away","North Melbourne","Melbourne",2
9590,1987-07-05,"R15","Brisbane Lions",18,11,119,"Geelong",10,18,78,"Carrara",41,1987,"Regular",15,"Home","Brisbane Lions","Geelong",41
9591,1987-07-05,"R15","Carlton",20,16,136,"Collingwood",15,22,112,"M.C.G.",24,1987,"Regular",15,"Home","Carlton","Collingwood",24
9592,1987-07-10,"R17","West Coast",15,17,107,"Carlton",15,14,104,"W.A.C.A.",3,1987,"Regular",17,"Home","West Coast","Carlton",3
9593,1987-07-11,"R16","Essendon",21,11,137,"Richmond",12,11,83,"Windy Hill",54,1987,"Regular",16,"Home","Essendon","Richmond",54
9594,1987-07-11,"R16","North Melbourne",23,18,156,"Fitzroy",19,9,123,"M.C.G.",33,1987,"Regular",16,"Home","North Melbourne","Fitzroy",33
9595,1987-07-11,"R17","Hawthorn",25,12,162,"Footscray",9,11,65,"Princes Park",97,1987,"Regular",17,"Home","Hawthorn","Footscray",97
9596,1987-07-12,"R16","Brisbane Lions",14,9,93,"St Kilda",18,13,121,"Carrara",-28,1987,"Regular",16,"Away","St Kilda","Brisbane Lions",28
9597,1987-07-18,"R16","Carlton",20,13,133,"Footscray",12,6,78,"Princes Park",55,1987,"Regular",16,"Home","Carlton","Footscray",55
9598,1987-07-18,"R16","Collingwood",5,13,43,"Hawthorn",25,18,168,"Victoria Park",-125,1987,"Regular",16,"Away","Hawthorn","Collingwood",125
9599,1987-07-18,"R17","North Melbourne",11,13,79,"Geelong",27,14,176,"M.C.G.",-97,1987,"Regular",17,"Away","Geelong","North Melbourne",97
9600,1987-07-18,"R17","St Kilda",18,6,114,"Melbourne",9,14,68,"Waverley Park",46,1987,"Regular",17,"Home","St Kilda","Melbourne",46
9601,1987-07-19,"R16","Sydney",30,21,201,"West Coast",10,11,71,"S.C.G.",130,1987,"Regular",16,"Home","Sydney","West Coast",130
9602,1987-07-25,"R17","Fitzroy",17,29,131,"Brisbane Lions",16,10,106,"Princes Park",25,1987,"Regular",17,"Home","Fitzroy","Brisbane Lions",25
9603,1987-07-25,"R17","Richmond",18,20,128,"Collingwood",14,5,89,"M.C.G.",39,1987,"Regular",17,"Home","Richmond","Collingwood",39
9604,1987-07-25,"R16","Melbourne",18,9,117,"Geelong",11,11,77,"Waverley Park",40,1987,"Regular",16,"Home","Melbourne","Geelong",40
9605,1987-07-26,"R17","Sydney",36,20,236,"Essendon",11,7,73,"S.C.G.",163,1987,"Regular",17,"Home","Sydney","Essendon",163
9606,1987-07-31,"R18","Sydney",31,12,198,"Richmond",15,17,107,"S.C.G.",91,1987,"Regular",18,"Home","Sydney","Richmond",91
9607,1987-08-01,"R18","Melbourne",22,21,153,"Brisbane Lions",14,15,99,"M.C.G.",54,1987,"Regular",18,"Home","Melbourne","Brisbane Lions",54
9608,1987-08-01,"R18","Essendon",10,9,69,"Carlton",10,10,70,"Waverley Park",-1,1987,"Regular",18,"Away","Carlton","Essendon",1
9609,1987-08-01,"R18","Footscray",9,11,65,"Collingwood",8,6,54,"Western Oval",11,1987,"Regular",18,"Home","Footscray","Collingwood",11
9610,1987-08-01,"R18","Fitzroy",20,9,129,"Geelong",12,15,87,"Princes Park",42,1987,"Regular",18,"Home","Fitzroy","Geelong",42
9611,1987-08-01,"R18","St Kilda",15,16,106,"North Melbourne",11,15,81,"Moorabbin Oval",25,1987,"Regular",18,"Home","St Kilda","North Melbourne",25
9612,1987-08-02,"R18","West Coast",17,13,115,"Hawthorn",17,12,114,"Subiaco",1,1987,"Regular",18,"Home","West Coast","Hawthorn",1
9613,1987-08-07,"R19","West Coast",15,19,109,"North Melbourne",18,12,120,"W.A.C.A.",-11,1987,"Regular",19,"Away","North Melbourne","West Coast",11
9614,1987-08-08,"R19","Carlton",17,21,123,"Sydney",8,7,55,"Princes Park",68,1987,"Regular",19,"Home","Carlton","Sydney",68
9615,1987-08-08,"R19","Geelong",12,20,92,"Essendon",9,11,65,"Kardinia Park",27,1987,"Regular",19,"Home","Geelong","Essendon",27
9616,1987-08-08,"R19","Hawthorn",26,9,165,"Fitzroy",16,9,105,"Waverley Park",60,1987,"Regular",19,"Home","Hawthorn","Fitzroy",60
9617,1987-08-08,"R19","St Kilda",15,14,104,"Footscray",15,11,101,"Moorabbin Oval",3,1987,"Regular",19,"Home","St Kilda","Footscray",3
9618,1987-08-08,"R19","Richmond",15,10,100,"Melbourne",17,17,119,"M.C.G.",-19,1987,"Regular",19,"Away","Melbourne","Richmond",19
9619,1987-08-09,"R19","Brisbane Lions",11,11,77,"Collingwood",14,16,100,"Carrara",-23,1987,"Regular",19,"Away","Collingwood","Brisbane Lions",23
9620,1987-08-15,"R20","Geelong",13,10,88,"Carlton",24,12,156,"Kardinia Park",-68,1987,"Regular",20,"Away","Carlton","Geelong",68
9621,1987-08-15,"R20","Collingwood",8,11,59,"Melbourne",15,24,114,"Victoria Park",-55,1987,"Regular",20,"Away","Melbourne","Collingwood",55
9622,1987-08-15,"R20","Essendon",20,7,127,"Fitzroy",11,20,86,"Windy Hill",41,1987,"Regular",20,"Home","Essendon","Fitzroy",41
9623,1987-08-15,"R20","North Melbourne",18,17,125,"Footscray",18,17,125,"M.C.G.",0,1987,"Regular",20,"Home","North Melbourne","Footscray",0
9624,1987-08-15,"R20","Hawthorn",20,22,142,"Sydney",15,7,97,"Princes Park",45,1987,"Regular",20,"Home","Hawthorn","Sydney",45
9625,1987-08-15,"R20","Richmond",19,19,133,"St Kilda",8,9,57,"Waverley Park",76,1987,"Regular",20,"Home","Richmond","St Kilda",76
9626,1987-08-16,"R20","Brisbane Lions",18,11,119,"West Coast",21,14,140,"Carrara",-21,1987,"Regular",20,"Away","West Coast","Brisbane Lions",21
9627,1987-08-21,"R21","Melbourne",18,21,129,"West Coast",10,8,68,"M.C.G.",61,1987,"Regular",21,"Home","Melbourne","West Coast",61
9628,1987-08-22,"R21","Fitzroy",12,12,84,"Carlton",17,22,124,"Princes Park",-40,1987,"Regular",21,"Away","Carlton","Fitzroy",40
9629,1987-08-22,"R21","St Kilda",15,17,107,"Collingwood",8,10,58,"Moorabbin Oval",49,1987,"Regular",21,"Home","St Kilda","Collingwood",49
9630,1987-08-22,"R21","Essendon",9,10,64,"Hawthorn",17,12,114,"Waverley Park",-50,1987,"Regular",21,"Away","Hawthorn","Essendon",50
9631,1987-08-22,"R21","North Melbourne",18,14,122,"Richmond",11,18,84,"M.C.G.",38,1987,"Regular",21,"Home","North Melbourne","Richmond",38
9632,1987-08-23,"R21","Brisbane Lions",10,11,71,"Footscray",22,21,153,"Carrara",-82,1987,"Regular",21,"Away","Footscray","Brisbane Lions",82
9633,1987-08-23,"R21","Sydney",18,14,122,"Geelong",18,23,131,"S.C.G.",-9,1987,"Regular",21,"Away","Geelong","Sydney",9
9634,1987-08-28,"R22","Richmond",17,11,113,"Brisbane Lions",26,13,169,"M.C.G.",-56,1987,"Regular",22,"Away","Brisbane Lions","Richmond",56
9635,1987-08-29,"R22","Carlton",20,9,129,"North Melbourne",19,11,125,"Waverley Park",4,1987,"Regular",22,"Home","Carlton","North Melbourne",4
9636,1987-08-29,"R22","Fitzroy",20,13,133,"Sydney",20,21,141,"Princes Park",-8,1987,"Regular",22,"Away","Sydney","Fitzroy",8
9637,1987-08-29,"R22","Footscray",10,8,68,"Melbourne",12,11,83,"Western Oval",-15,1987,"Regular",22,"Away","Melbourne","Footscray",15
9638,1987-08-29,"R22","Geelong",17,21,123,"Hawthorn",19,12,126,"Kardinia Park",-3,1987,"Regular",22,"Away","Hawthorn","Geelong",3
9639,1987-08-30,"R22","Essendon",21,13,139,"Collingwood",23,6,144,"M.C.G.",-5,1987,"Regular",22,"Away","Collingwood","Essendon",5
9640,1987-08-30,"R22","West Coast",26,19,175,"St Kilda",13,9,87,"Subiaco",88,1987,"Regular",22,"Home","West Coast","St Kilda",88
9641,1987-09-05,"QF","Hawthorn",23,18,156,"Sydney",8,9,57,"Waverley Park",99,1987,"Finals",23,"Home","Hawthorn","Sydney",99
9642,1987-09-06,"EF","North Melbourne",5,10,40,"Melbourne",22,26,158,"M.C.G.",-118,1987,"Finals",23,"Away","Melbourne","North Melbourne",118
9643,1987-09-12,"SF","Carlton",11,14,80,"Hawthorn",10,5,65,"Waverley Park",15,1987,"Finals",24,"Home","Carlton","Hawthorn",15
9644,1987-09-13,"SF","Sydney",10,13,73,"Melbourne",21,23,149,"M.C.G.",-76,1987,"Finals",24,"Away","Melbourne","Sydney",76
9645,1987-09-19,"PF","Hawthorn",11,14,80,"Melbourne",10,18,78,"Waverley Park",2,1987,"Finals",25,"Home","Hawthorn","Melbourne",2
9646,1987-09-26,"GF","Carlton",15,14,104,"Hawthorn",9,17,71,"M.C.G.",33,1987,"Finals",26,"Home","Carlton","Hawthorn",33
9647,1988-04-02,"R1","Carlton",18,18,126,"Hawthorn",15,21,111,"Princes Park",15,1988,"Regular",1,"Home","Carlton","Hawthorn",15
9648,1988-04-02,"R1","Essendon",25,14,164,"North Melbourne",12,10,82,"Windy Hill",82,1988,"Regular",1,"Home","Essendon","North Melbourne",82
9649,1988-04-02,"R1","Geelong",11,17,83,"West Coast",14,20,104,"Kardinia Park",-21,1988,"Regular",1,"Away","West Coast","Geelong",21
9650,1988-04-03,"R1","Brisbane Lions",10,15,75,"Collingwood",11,17,83,"Carrara",-8,1988,"Regular",1,"Away","Collingwood","Brisbane Lions",8
9651,1988-04-04,"R1","Fitzroy",20,20,140,"St Kilda",17,16,118,"Princes Park",22,1988,"Regular",1,"Home","Fitzroy","St Kilda",22
9652,1988-04-04,"R1","Footscray",16,6,102,"Sydney",11,10,76,"Waverley Park",26,1988,"Regular",1,"Home","Footscray","Sydney",26
9653,1988-04-04,"R1","Richmond",16,12,108,"Melbourne",23,16,154,"M.C.G.",-46,1988,"Regular",1,"Away","Melbourne","Richmond",46
9654,1988-04-08,"R2","West Coast",26,19,175,"Essendon",11,10,76,"W.A.C.A.",99,1988,"Regular",2,"Home","West Coast","Essendon",99
9655,1988-04-09,"R2","Carlton",19,15,129,"Brisbane Lions",7,19,61,"Princes Park",68,1988,"Regular",2,"Home","Carlton","Brisbane Lions",68
9656,1988-04-09,"R2","Collingwood",15,12,102,"Fitzroy",9,16,70,"Victoria Park",32,1988,"Regular",2,"Home","Collingwood","Fitzroy",32
9657,1988-04-09,"R2","Footscray",9,12,66,"Melbourne",13,8,86,"Western Oval",-20,1988,"Regular",2,"Away","Melbourne","Footscray",20
9658,1988-04-09,"R2","North Melbourne",20,7,127,"Geelong",21,16,142,"M.C.G.",-15,1988,"Regular",2,"Away","Geelong","North Melbourne",15
9659,1988-04-09,"R2","Hawthorn",26,15,171,"Richmond",12,14,86,"Waverley Park",85,1988,"Regular",2,"Home","Hawthorn","Richmond",85
9660,1988-04-10,"R2","Sydney",9,12,66,"St Kilda",7,13,55,"S.C.G.",11,1988,"Regular",2,"Home","Sydney","St Kilda",11
9661,1988-04-16,"R3","Essendon",11,13,79,"Carlton",23,13,151,"Windy Hill",-72,1988,"Regular",3,"Away","Carlton","Essendon",72
9662,1988-04-16,"R3","Richmond",12,8,80,"Collingwood",23,12,150,"Waverley Park",-70,1988,"Regular",3,"Away","Collingwood","Richmond",70
9663,1988-04-16,"R3","Footscray",16,12,108,"Fitzroy",7,15,57,"Western Oval",51,1988,"Regular",3,"Home","Footscray","Fitzroy",51
9664,1988-04-16,"R3","Melbourne",9,18,72,"Geelong",9,10,64,"M.C.G.",8,1988,"Regular",3,"Home","Melbourne","Geelong",8
9665,1988-04-16,"R3","Hawthorn",17,12,114,"Sydney",13,15,93,"Princes Park",21,1988,"Regular",3,"Home","Hawthorn","Sydney",21
9666,1988-04-16,"R3","St Kilda",17,6,108,"North Melbourne",11,16,82,"Moorabbin Oval",26,1988,"Regular",3,"Home","St Kilda","North Melbourne",26
9667,1988-04-17,"R3","Brisbane Lions",10,14,74,"West Coast",29,18,192,"W.A.C.A.",-118,1988,"Regular",3,"Away","West Coast","Brisbane Lions",118
9668,1988-04-22,"R4","Melbourne",13,18,96,"Brisbane Lions",5,11,41,"M.C.G.",55,1988,"Regular",4,"Home","Melbourne","Brisbane Lions",55
9669,1988-04-23,"R4","Collingwood",13,16,94,"West Coast",8,7,55,"Victoria Park",39,1988,"Regular",4,"Home","Collingwood","West Coast",39
9670,1988-04-23,"R4","Hawthorn",17,18,120,"Fitzroy",15,16,106,"Princes Park",14,1988,"Regular",4,"Home","Hawthorn","Fitzroy",14
9671,1988-04-23,"R4","North Melbourne",19,11,125,"Footscray",13,9,87,"Waverley Park",38,1988,"Regular",4,"Home","North Melbourne","Footscray",38
9672,1988-04-24,"R4","Sydney",10,20,80,"Carlton",24,22,166,"S.C.G.",-86,1988,"Regular",4,"Away","Carlton","Sydney",86
9673,1988-04-25,"R4","St Kilda",10,9,69,"Essendon",14,7,91,"Moorabbin Oval",-22,1988,"Regular",4,"Away","Essendon","St Kilda",22
9674,1988-04-25,"R4","Richmond",11,16,82,"Geelong",24,17,161,"M.C.G.",-79,1988,"Regular",4,"Away","Geelong","Richmond",79
9675,1988-04-29,"R5","West Coast",14,16,100,"Footscray",14,9,93,"W.A.C.A.",7,1988,"Regular",5,"Home","West Coast","Footscray",7
9676,1988-04-30,"R5","St Kilda",12,12,84,"Brisbane Lions",13,15,93,"Moorabbin Oval",-9,1988,"Regular",5,"Away","Brisbane Lions","St Kilda",9
9677,1988-04-30,"R5","Carlton",10,9,69,"Collingwood",14,13,97,"Waverley Park",-28,1988,"Regular",5,"Away","Collingwood","Carlton",28
9678,1988-04-30,"R5","Geelong",17,14,116,"Essendon",13,14,92,"Kardinia Park",24,1988,"Regular",5,"Home","Geelong","Essendon",24
9679,1988-04-30,"R5","Fitzroy",12,19,91,"Richmond",23,15,153,"Princes Park",-62,1988,"Regular",5,"Away","Richmond","Fitzroy",62
9680,1988-04-30,"R5","North Melbourne",19,14,128,"Hawthorn",31,19,205,"M.C.G.",-77,1988,"Regular",5,"Away","Hawthorn","North Melbourne",77
9681,1988-05-01,"R5","Sydney",12,17,89,"Melbourne",17,14,116,"S.C.G.",-27,1988,"Regular",5,"Away","Melbourne","Sydney",27
9682,1988-05-06,"R6","North Melbourne",17,21,123,"West Coast",17,8,110,"M.C.G.",13,1988,"Regular",6,"Home","North Melbourne","West Coast",13
9683,1988-05-07,"R6","Carlton",10,12,72,"St Kilda",4,8,32,"Princes Park",40,1988,"Regular",6,"Home","Carlton","St Kilda",40
9684,1988-05-07,"R6","Collingwood",13,13,91,"Hawthorn",14,9,93,"Waverley Park",-2,1988,"Regular",6,"Away","Hawthorn","Collingwood",2
9685,1988-05-07,"R6","Melbourne",9,14,68,"Essendon",16,5,101,"M.C.G.",-33,1988,"Regular",6,"Away","Essendon","Melbourne",33
9686,1988-05-07,"R6","Footscray",12,19,91,"Richmond",5,16,46,"Western Oval",45,1988,"Regular",6,"Home","Footscray","Richmond",45
9687,1988-05-08,"R6","Brisbane Lions",17,11,113,"Fitzroy",16,15,111,"Carrara",2,1988,"Regular",6,"Home","Brisbane Lions","Fitzroy",2
9688,1988-05-08,"R6","Geelong",16,15,111,"Sydney",17,12,114,"Kardinia Park",-3,1988,"Regular",6,"Away","Sydney","Geelong",3
9689,1988-05-13,"R7","West Coast",17,10,112,"St Kilda",3,18,36,"W.A.C.A.",76,1988,"Regular",7,"Home","West Coast","St Kilda",76
9690,1988-05-14,"R7","Geelong",15,14,104,"Carlton",14,9,93,"Waverley Park",11,1988,"Regular",7,"Home","Geelong","Carlton",11
9691,1988-05-14,"R7","Essendon",17,17,119,"Collingwood",11,9,75,"Windy Hill",44,1988,"Regular",7,"Home","Essendon","Collingwood",44
9692,1988-05-14,"R7","Fitzroy",15,16,106,"Sydney",9,13,67,"Princes Park",39,1988,"Regular",7,"Home","Fitzroy","Sydney",39
9693,1988-05-14,"R7","Melbourne",15,21,111,"Hawthorn",13,12,90,"M.C.G.",21,1988,"Regular",7,"Home","Melbourne","Hawthorn",21
9694,1988-05-15,"R7","Brisbane Lions",10,12,72,"Footscray",9,17,71,"Carrara",1,1988,"Regular",7,"Home","Brisbane Lions","Footscray",1
9695,1988-05-15,"R7","Richmond",11,7,73,"North Melbourne",22,18,150,"M.C.G.",-77,1988,"Regular",7,"Away","North Melbourne","Richmond",77
9696,1988-05-20,"R8","Sydney",11,21,87,"Brisbane Lions",17,13,115,"S.C.G.",-28,1988,"Regular",8,"Away","Brisbane Lions","Sydney",28
9697,1988-05-21,"R8","Carlton",19,20,134,"North Melbourne",19,7,121,"Waverley Park",13,1988,"Regular",8,"Home","Carlton","North Melbourne",13
9698,1988-05-21,"R8","Collingwood",13,10,88,"Footscray",11,16,82,"Victoria Park",6,1988,"Regular",8,"Home","Collingwood","Footscray",6
9699,1988-05-21,"R8","Essendon",20,17,137,"Richmond",13,11,89,"Windy Hill",48,1988,"Regular",8,"Home","Essendon","Richmond",48
9700,1988-05-21,"R8","Fitzroy",12,17,89,"Melbourne",17,13,115,"Princes Park",-26,1988,"Regular",8,"Away","Melbourne","Fitzroy",26
9701,1988-05-22,"R8","Geelong",16,12,108,"St Kilda",17,12,114,"Kardinia Park",-6,1988,"Regular",8,"Away","St Kilda","Geelong",6
9702,1988-05-22,"R8","West Coast",9,9,63,"Hawthorn",17,14,116,"Subiaco",-53,1988,"Regular",8,"Away","Hawthorn","West Coast",53
9703,1988-05-27,"R9","Essendon",29,20,194,"Brisbane Lions",8,6,54,"M.C.G.",140,1988,"Regular",9,"Home","Essendon","Brisbane Lions",140
9704,1988-05-28,"R9","North Melbourne",4,11,35,"Collingwood",11,17,83,"Waverley Park",-48,1988,"Regular",9,"Away","Collingwood","North Melbourne",48
9705,1988-05-28,"R9","Geelong",20,13,133,"Fitzroy",15,10,100,"Kardinia Park",33,1988,"Regular",9,"Home","Geelong","Fitzroy",33
9706,1988-05-28,"R9","Hawthorn",23,16,154,"Footscray",9,11,65,"Princes Park",89,1988,"Regular",9,"Home","Hawthorn","Footscray",89
9707,1988-05-28,"R9","St Kilda",16,10,106,"Melbourne",11,12,78,"Moorabbin Oval",28,1988,"Regular",9,"Home","St Kilda","Melbourne",28
9708,1988-05-28,"R9","Richmond",10,13,73,"Sydney",20,16,136,"M.C.G.",-63,1988,"Regular",9,"Away","Sydney","Richmond",63
9709,1988-05-29,"R9","West Coast",12,15,87,"Carlton",15,10,100,"Subiaco",-13,1988,"Regular",9,"Away","Carlton","West Coast",13
9710,1988-06-03,"R10","Sydney",11,11,77,"Essendon",8,7,55,"S.C.G.",22,1988,"Regular",10,"Home","Sydney","Essendon",22
9711,1988-06-04,"R10","Footscray",11,9,75,"Carlton",15,6,96,"Western Oval",-21,1988,"Regular",10,"Away","Carlton","Footscray",21
9712,1988-06-04,"R10","Collingwood",10,11,71,"Melbourne",12,12,84,"Waverley Park",-13,1988,"Regular",10,"Away","Melbourne","Collingwood",13
9713,1988-06-04,"R10","Fitzroy",24,13,157,"North Melbourne",18,16,124,"Princes Park",33,1988,"Regular",10,"Home","Fitzroy","North Melbourne",33
9714,1988-06-04,"R10","St Kilda",17,19,121,"Hawthorn",21,11,137,"M.C.G.",-16,1988,"Regular",10,"Away","Hawthorn","St Kilda",16
9715,1988-06-05,"R10","Brisbane Lions",16,13,109,"Geelong",24,18,162,"Carrara",-53,1988,"Regular",10,"Away","Geelong","Brisbane Lions",53
9716,1988-06-05,"R10","Richmond",16,20,116,"West Coast",10,15,75,"M.C.G.",41,1988,"Regular",10,"Home","Richmond","West Coast",41
9717,1988-06-10,"R11","Sydney",18,24,132,"North Melbourne",19,11,125,"S.C.G.",7,1988,"Regular",11,"Home","Sydney","North Melbourne",7
9718,1988-06-11,"R11","Carlton",21,18,144,"Fitzroy",15,11,101,"Princes Park",43,1988,"Regular",11,"Home","Carlton","Fitzroy",43
9719,1988-06-11,"R11","St Kilda",7,9,51,"Footscray",11,12,78,"Waverley Park",-27,1988,"Regular",11,"Away","Footscray","St Kilda",27
9720,1988-06-12,"R11","Brisbane Lions",23,13,151,"Richmond",15,13,103,"Carrara",48,1988,"Regular",11,"Home","Brisbane Lions","Richmond",48
9721,1988-06-13,"R11","Geelong",9,10,64,"Collingwood",16,7,103,"Kardinia Park",-39,1988,"Regular",11,"Away","Collingwood","Geelong",39
9722,1988-06-13,"R11","Hawthorn",17,16,118,"Essendon",10,8,68,"Princes Park",50,1988,"Regular",11,"Home","Hawthorn","Essendon",50
9723,1988-06-13,"R11","Melbourne",13,15,93,"West Coast",10,13,73,"M.C.G.",20,1988,"Regular",11,"Home","Melbourne","West Coast",20
9724,1988-06-17,"R12","Richmond",15,20,110,"Carlton",12,21,93,"M.C.G.",17,1988,"Regular",12,"Home","Richmond","Carlton",17
9725,1988-06-18,"R12","Hawthorn",10,20,80,"Brisbane Lions",2,5,17,"Princes Park",63,1988,"Regular",12,"Home","Hawthorn","Brisbane Lions",63
9726,1988-06-18,"R12","St Kilda",3,12,30,"Collingwood",7,9,51,"Moorabbin Oval",-21,1988,"Regular",12,"Away","Collingwood","St Kilda",21
9727,1988-06-18,"R12","Fitzroy",7,9,51,"Essendon",4,9,33,"Waverley Park",18,1988,"Regular",12,"Home","Fitzroy","Essendon",18
9728,1988-06-18,"R12","Footscray",7,14,56,"Geelong",3,12,30,"Western Oval",26,1988,"Regular",12,"Home","Footscray","Geelong",26
9729,1988-06-18,"R12","North Melbourne",10,14,74,"Melbourne",7,19,61,"M.C.G.",13,1988,"Regular",12,"Home","North Melbourne","Melbourne",13
9730,1988-06-19,"R12","Sydney",14,20,104,"West Coast",8,13,61,"S.C.G.",43,1988,"Regular",12,"Home","Sydney","West Coast",43
9731,1988-06-25,"R13","North Melbourne",22,19,151,"Brisbane Lions",13,7,85,"M.C.G.",66,1988,"Regular",13,"Home","North Melbourne","Brisbane Lions",66
9732,1988-06-25,"R13","Melbourne",10,6,66,"Carlton",5,13,43,"Waverley Park",23,1988,"Regular",13,"Home","Melbourne","Carlton",23
9733,1988-06-25,"R13","Collingwood",9,14,68,"Sydney",2,11,23,"Victoria Park",45,1988,"Regular",13,"Home","Collingwood","Sydney",45
9734,1988-06-25,"R13","Essendon",10,15,75,"Footscray",15,9,99,"Windy Hill",-24,1988,"Regular",13,"Away","Footscray","Essendon",24
9735,1988-06-25,"R13","Hawthorn",17,10,112,"Geelong",12,15,87,"Princes Park",25,1988,"Regular",13,"Home","Hawthorn","Geelong",25
9736,1988-06-25,"R13","St Kilda",8,18,66,"Richmond",5,11,41,"Moorabbin Oval",25,1988,"Regular",13,"Home","St Kilda","Richmond",25
9737,1988-06-26,"R13","West Coast",17,19,121,"Fitzroy",13,9,87,"Subiaco",34,1988,"Regular",13,"Home","West Coast","Fitzroy",34
9738,1988-07-01,"R14","Sydney",13,18,96,"Richmond",19,17,131,"S.C.G.",-35,1988,"Regular",14,"Away","Richmond","Sydney",35
9739,1988-07-02,"R14","Carlton",11,21,87,"Collingwood",16,14,110,"M.C.G.",-23,1988,"Regular",14,"Away","Collingwood","Carlton",23
9740,1988-07-02,"R14","Essendon",16,16,112,"West Coast",13,7,85,"Windy Hill",27,1988,"Regular",14,"Home","Essendon","West Coast",27
9741,1988-07-02,"R14","Fitzroy",10,11,71,"North Melbourne",15,20,110,"Waverley Park",-39,1988,"Regular",14,"Away","North Melbourne","Fitzroy",39
9742,1988-07-02,"R14","Footscray",11,11,77,"Hawthorn",15,15,105,"Western Oval",-28,1988,"Regular",14,"Away","Hawthorn","Footscray",28
9743,1988-07-02,"R14","Geelong",8,8,56,"Melbourne",13,11,89,"Kardinia Park",-33,1988,"Regular",14,"Away","Melbourne","Geelong",33
9744,1988-07-03,"R14","Brisbane Lions",14,15,99,"St Kilda",12,17,89,"Carrara",10,1988,"Regular",14,"Home","Brisbane Lions","St Kilda",10
9745,1988-07-09,"R15","St Kilda",9,11,65,"Carlton",10,9,69,"Moorabbin Oval",-4,1988,"Regular",15,"Away","Carlton","St Kilda",4
9746,1988-07-09,"R15","Fitzroy",21,16,142,"Collingwood",7,10,52,"Princes Park",90,1988,"Regular",15,"Home","Fitzroy","Collingwood",90
9747,1988-07-09,"R15","Footscray",12,8,80,"Richmond",8,7,55,"Waverley Park",25,1988,"Regular",15,"Home","Footscray","Richmond",25
9748,1988-07-09,"R15","Melbourne",8,9,57,"Sydney",19,16,130,"M.C.G.",-73,1988,"Regular",15,"Away","Sydney","Melbourne",73
9749,1988-07-10,"R15","Brisbane Lions",12,19,91,"Hawthorn",17,13,115,"Carrara",-24,1988,"Regular",15,"Away","Hawthorn","Brisbane Lions",24
9750,1988-07-10,"R15","North Melbourne",14,10,94,"Essendon",21,14,140,"M.C.G.",-46,1988,"Regular",15,"Away","Essendon","North Melbourne",46
9751,1988-07-10,"R15","West Coast",18,18,126,"Geelong",16,10,106,"Subiaco",20,1988,"Regular",15,"Home","West Coast","Geelong",20
9752,1988-07-15,"R16","West Coast",14,14,98,"Brisbane Lions",12,17,89,"W.A.C.A.",9,1988,"Regular",16,"Home","West Coast","Brisbane Lions",9
9753,1988-07-16,"R16","Carlton",21,15,141,"Geelong",14,14,98,"Princes Park",43,1988,"Regular",16,"Home","Carlton","Geelong",43
9754,1988-07-16,"R16","Melbourne",14,10,94,"Collingwood",6,12,48,"M.C.G.",46,1988,"Regular",16,"Home","Melbourne","Collingwood",46
9755,1988-07-16,"R16","Essendon",16,14,110,"Fitzroy",9,12,66,"Windy Hill",44,1988,"Regular",16,"Home","Essendon","Fitzroy",44
9756,1988-07-16,"R16","Richmond",17,13,115,"St Kilda",15,8,98,"Waverley Park",17,1988,"Regular",16,"Home","Richmond","St Kilda",17
9757,1988-07-17,"R16","North Melbourne",12,14,86,"Footscray",16,17,113,"M.C.G.",-27,1988,"Regular",16,"Away","Footscray","North Melbourne",27
9758,1988-07-17,"R16","Sydney",24,19,163,"Hawthorn",16,16,112,"S.C.G.",51,1988,"Regular",16,"Home","Sydney","Hawthorn",51
9759,1988-07-22,"R17","Fitzroy",19,20,134,"West Coast",8,16,64,"M.C.G.",70,1988,"Regular",17,"Home","Fitzroy","West Coast",70
9760,1988-07-23,"R17","Carlton",13,22,100,"Richmond",8,12,60,"Princes Park",40,1988,"Regular",17,"Home","Carlton","Richmond",40
9761,1988-07-23,"R17","Collingwood",14,8,92,"North Melbourne",13,14,92,"Victoria Park",0,1988,"Regular",17,"Home","Collingwood","North Melbourne",0
9762,1988-07-23,"R17","Geelong",17,13,115,"Footscray",10,9,69,"Kardinia Park",46,1988,"Regular",17,"Home","Geelong","Footscray",46
9763,1988-07-23,"R17","Melbourne",10,8,68,"Hawthorn",21,11,137,"Waverley Park",-69,1988,"Regular",17,"Away","Hawthorn","Melbourne",69
9764,1988-07-23,"R17","St Kilda",14,8,92,"Sydney",13,21,99,"Moorabbin Oval",-7,1988,"Regular",17,"Away","Sydney","St Kilda",7
9765,1988-07-24,"R17","Brisbane Lions",10,14,74,"Essendon",16,7,103,"Carrara",-29,1988,"Regular",17,"Away","Essendon","Brisbane Lions",29
9766,1988-07-29,"R18","Sydney",12,16,88,"Geelong",22,19,151,"S.C.G.",-63,1988,"Regular",18,"Away","Geelong","Sydney",63
9767,1988-07-30,"R18","Fitzroy",9,13,67,"Carlton",22,11,143,"Princes Park",-76,1988,"Regular",18,"Away","Carlton","Fitzroy",76
9768,1988-07-30,"R18","Collingwood",16,18,114,"St Kilda",11,14,80,"Victoria Park",34,1988,"Regular",18,"Home","Collingwood","St Kilda",34
9769,1988-07-30,"R18","Hawthorn",12,16,88,"Essendon",9,8,62,"Waverley Park",26,1988,"Regular",18,"Home","Hawthorn","Essendon",26
9770,1988-07-30,"R18","North Melbourne",16,13,109,"Richmond",21,14,140,"M.C.G.",-31,1988,"Regular",18,"Away","Richmond","North Melbourne",31
9771,1988-07-31,"R18","Footscray",11,18,84,"Brisbane Lions",5,13,43,"Western Oval",41,1988,"Regular",18,"Home","Footscray","Brisbane Lions",41
9772,1988-07-31,"R18","West Coast",18,14,122,"Melbourne",11,12,78,"Subiaco",44,1988,"Regular",18,"Home","West Coast","Melbourne",44
9773,1988-08-05,"R19","Collingwood",18,14,122,"Brisbane Lions",11,10,76,"M.C.G.",46,1988,"Regular",19,"Home","Collingwood","Brisbane Lions",46
9774,1988-08-06,"R19","Carlton",11,13,79,"Sydney",15,17,107,"Waverley Park",-28,1988,"Regular",19,"Away","Sydney","Carlton",28
9775,1988-08-06,"R19","Essendon",12,18,90,"Geelong",24,13,157,"Windy Hill",-67,1988,"Regular",19,"Away","Geelong","Essendon",67
9776,1988-08-06,"R19","Hawthorn",27,16,178,"Fitzroy",15,14,104,"Princes Park",74,1988,"Regular",19,"Home","Hawthorn","Fitzroy",74
9777,1988-08-06,"R19","Footscray",19,18,132,"St Kilda",9,9,63,"Western Oval",69,1988,"Regular",19,"Home","Footscray","St Kilda",69
9778,1988-08-06,"R19","Richmond",23,11,149,"Melbourne",20,11,131,"M.C.G.",18,1988,"Regular",19,"Home","Richmond","Melbourne",18
9779,1988-08-07,"R19","West Coast",16,19,115,"North Melbourne",12,12,84,"Subiaco",31,1988,"Regular",19,"Home","West Coast","North Melbourne",31
9780,1988-08-12,"R20","Richmond",11,20,86,"Brisbane Lions",14,16,100,"M.C.G.",-14,1988,"Regular",20,"Away","Brisbane Lions","Richmond",14
9781,1988-08-13,"R20","Carlton",20,21,141,"North Melbourne",20,17,137,"Princes Park",4,1988,"Regular",20,"Home","Carlton","North Melbourne",4
9782,1988-08-13,"R20","Collingwood",10,14,74,"Essendon",10,13,73,"Waverley Park",1,1988,"Regular",20,"Home","Collingwood","Essendon",1
9783,1988-08-13,"R20","Melbourne",14,16,100,"Footscray",17,8,110,"M.C.G.",-10,1988,"Regular",20,"Away","Footscray","Melbourne",10
9784,1988-08-13,"R20","St Kilda",13,10,88,"West Coast",14,13,97,"Moorabbin Oval",-9,1988,"Regular",20,"Away","West Coast","St Kilda",9
9785,1988-08-14,"R20","Sydney",24,16,160,"Fitzroy",14,13,97,"S.C.G.",63,1988,"Regular",20,"Home","Sydney","Fitzroy",63
9786,1988-08-14,"R20","Geelong",10,8,68,"Hawthorn",19,14,128,"Kardinia Park",-60,1988,"Regular",20,"Away","Hawthorn","Geelong",60
9787,1988-08-19,"R21","North Melbourne",16,17,113,"Sydney",14,17,101,"M.C.G.",12,1988,"Regular",21,"Home","North Melbourne","Sydney",12
9788,1988-08-20,"R21","Essendon",19,14,128,"Melbourne",13,12,90,"Windy Hill",38,1988,"Regular",21,"Home","Essendon","Melbourne",38
9789,1988-08-20,"R21","Fitzroy",19,13,127,"Footscray",17,11,113,"Princes Park",14,1988,"Regular",21,"Home","Fitzroy","Footscray",14
9790,1988-08-20,"R21","Geelong",22,14,146,"Richmond",16,12,108,"Kardinia Park",38,1988,"Regular",21,"Home","Geelong","Richmond",38
9791,1988-08-20,"R21","Hawthorn",18,15,123,"St Kilda",11,12,78,"Waverley Park",45,1988,"Regular",21,"Home","Hawthorn","St Kilda",45
9792,1988-08-21,"R21","Brisbane Lions",14,13,97,"Carlton",13,22,100,"Carrara",-3,1988,"Regular",21,"Away","Carlton","Brisbane Lions",3
9793,1988-08-21,"R21","West Coast",16,15,111,"Collingwood",7,9,51,"Subiaco",60,1988,"Regular",21,"Home","West Coast","Collingwood",60
9794,1988-08-26,"R22","Richmond",23,19,157,"Fitzroy",7,12,54,"M.C.G.",103,1988,"Regular",22,"Home","Richmond","Fitzroy",103
9795,1988-08-27,"R22","Melbourne",14,12,96,"Carlton",10,6,66,"M.C.G.",30,1988,"Regular",22,"Home","Melbourne","Carlton",30
9796,1988-08-27,"R22","Collingwood",19,15,129,"Geelong",14,10,94,"Victoria Park",35,1988,"Regular",22,"Home","Collingwood","Geelong",35
9797,1988-08-27,"R22","Essendon",12,12,84,"St Kilda",8,17,65,"Waverley Park",19,1988,"Regular",22,"Home","Essendon","St Kilda",19
9798,1988-08-27,"R22","Hawthorn",28,16,184,"North Melbourne",13,11,89,"Princes Park",95,1988,"Regular",22,"Home","Hawthorn","North Melbourne",95
9799,1988-08-28,"R22","Brisbane Lions",11,11,77,"Sydney",10,21,81,"Carrara",-4,1988,"Regular",22,"Away","Sydney","Brisbane Lions",4
9800,1988-08-28,"R22","Footscray",3,11,29,"West Coast",7,11,53,"Western Oval",-24,1988,"Regular",22,"Away","West Coast","Footscray",24
9801,1988-09-03,"EF","West Coast",10,11,71,"Melbourne",11,7,73,"Waverley Park",-2,1988,"Finals",23,"Away","Melbourne","West Coast",2
9802,1988-09-04,"QF","Collingwood",16,11,107,"Carlton",22,13,145,"M.C.G.",-38,1988,"Finals",23,"Away","Carlton","Collingwood",38
9803,1988-09-10,"SF","Hawthorn",9,12,66,"Carlton",6,9,45,"Waverley Park",21,1988,"Finals",24,"Home","Hawthorn","Carlton",21
9804,1988-09-11,"SF","Collingwood",12,10,82,"Melbourne",13,17,95,"M.C.G.",-13,1988,"Finals",24,"Away","Melbourne","Collingwood",13
9805,1988-09-17,"PF","Carlton",14,14,98,"Melbourne",19,6,120,"Waverley Park",-22,1988,"Finals",25,"Away","Melbourne","Carlton",22
9806,1988-09-24,"GF","Hawthorn",22,20,152,"Melbourne",6,20,56,"M.C.G.",96,1988,"Finals",26,"Home","Hawthorn","Melbourne",96
9807,1989-03-31,"R1","West Coast",14,12,96,"Essendon",17,10,112,"W.A.C.A.",-16,1989,"Regular",1,"Away","Essendon","West Coast",16
9808,1989-04-01,"R1","St Kilda",20,16,136,"Brisbane Lions",15,7,97,"Moorabbin Oval",39,1989,"Regular",1,"Home","St Kilda","Brisbane Lions",39
9809,1989-04-01,"R1","Carlton",10,13,73,"Footscray",19,18,132,"Princes Park",-59,1989,"Regular",1,"Away","Footscray","Carlton",59
9810,1989-04-01,"R1","Collingwood",13,15,93,"Hawthorn",11,17,83,"Waverley Park",10,1989,"Regular",1,"Home","Collingwood","Hawthorn",10
9811,1989-04-01,"R1","Melbourne",18,8,116,"Fitzroy",16,15,111,"M.C.G.",5,1989,"Regular",1,"Home","Melbourne","Fitzroy",5
9812,1989-04-02,"R1","North Melbourne",18,17,125,"Geelong",17,21,123,"M.C.G.",2,1989,"Regular",1,"Home","North Melbourne","Geelong",2
9813,1989-04-02,"R1","Sydney",12,17,89,"Richmond",11,7,73,"S.C.G.",16,1989,"Regular",1,"Home","Sydney","Richmond",16
9814,1989-04-08,"R2","St Kilda",13,18,96,"Carlton",13,14,92,"Moorabbin Oval",4,1989,"Regular",2,"Home","St Kilda","Carlton",4
9815,1989-04-08,"R2","Fitzroy",20,12,132,"Collingwood",16,11,107,"Princes Park",25,1989,"Regular",2,"Home","Fitzroy","Collingwood",25
9816,1989-04-08,"R2","Essendon",14,10,94,"Melbourne",9,14,68,"Windy Hill",26,1989,"Regular",2,"Home","Essendon","Melbourne",26
9817,1989-04-08,"R2","Richmond",24,12,156,"Footscray",13,10,88,"M.C.G.",68,1989,"Regular",2,"Home","Richmond","Footscray",68
9818,1989-04-08,"R2","North Melbourne",11,6,72,"Hawthorn",21,15,141,"Waverley Park",-69,1989,"Regular",2,"Away","Hawthorn","North Melbourne",69
9819,1989-04-09,"R2","Brisbane Lions",18,15,123,"Sydney",8,17,65,"Carrara",58,1989,"Regular",2,"Home","Brisbane Lions","Sydney",58
9820,1989-04-09,"R2","Geelong",26,19,175,"West Coast",11,14,80,"Kardinia Park",95,1989,"Regular",2,"Home","Geelong","West Coast",95
9821,1989-04-15,"R3","Collingwood",19,21,135,"Brisbane Lions",11,9,75,"Victoria Park",60,1989,"Regular",3,"Home","Collingwood","Brisbane Lions",60
9822,1989-04-15,"R3","Hawthorn",20,15,135,"Essendon",13,13,91,"Princes Park",44,1989,"Regular",3,"Home","Hawthorn","Essendon",44
9823,1989-04-15,"R3","St Kilda",19,8,122,"Fitzroy",19,18,132,"Waverley Park",-10,1989,"Regular",3,"Away","Fitzroy","St Kilda",10
9824,1989-04-15,"R3","Footscray",8,18,66,"North Melbourne",12,12,84,"Western Oval",-18,1989,"Regular",3,"Away","North Melbourne","Footscray",18
9825,1989-04-15,"R3","Richmond",8,13,61,"Melbourne",18,14,122,"M.C.G.",-61,1989,"Regular",3,"Away","Melbourne","Richmond",61
9826,1989-04-16,"R3","Geelong",16,21,117,"Carlton",9,10,64,"Kardinia Park",53,1989,"Regular",3,"Home","Geelong","Carlton",53
9827,1989-04-16,"R3","Sydney",20,14,134,"West Coast",11,17,83,"S.C.G.",51,1989,"Regular",3,"Home","Sydney","West Coast",51
9828,1989-04-21,"R4","Melbourne",11,13,79,"Brisbane Lions",7,11,53,"M.C.G.",26,1989,"Regular",4,"Home","Melbourne","Brisbane Lions",26
9829,1989-04-22,"R4","Collingwood",23,21,159,"St Kilda",14,11,95,"Victoria Park",64,1989,"Regular",4,"Home","Collingwood","St Kilda",64
9830,1989-04-22,"R4","Fitzroy",11,13,79,"Sydney",23,15,153,"Princes Park",-74,1989,"Regular",4,"Away","Sydney","Fitzroy",74
9831,1989-04-23,"R4","Footscray",12,15,87,"Geelong",14,15,99,"Western Oval",-12,1989,"Regular",4,"Away","Geelong","Footscray",12
9832,1989-04-23,"R4","West Coast",10,12,72,"North Melbourne",18,7,115,"W.A.C.A.",-43,1989,"Regular",4,"Away","North Melbourne","West Coast",43
9833,1989-04-25,"R4","Carlton",15,20,110,"Essendon",21,12,138,"Princes Park",-28,1989,"Regular",4,"Away","Essendon","Carlton",28
9834,1989-04-25,"R4","Richmond",9,12,66,"Hawthorn",15,20,110,"Waverley Park",-44,1989,"Regular",4,"Away","Hawthorn","Richmond",44
9835,1989-04-29,"R5","Hawthorn",18,17,125,"Carlton",10,11,71,"Waverley Park",54,1989,"Regular",5,"Home","Hawthorn","Carlton",54
9836,1989-04-29,"R5","Essendon",20,18,138,"St Kilda",12,12,84,"Windy Hill",54,1989,"Regular",5,"Home","Essendon","St Kilda",54
9837,1989-04-29,"R5","Fitzroy",16,17,113,"Geelong",16,16,112,"Princes Park",1,1989,"Regular",5,"Home","Fitzroy","Geelong",1
9838,1989-04-29,"R5","Melbourne",11,16,82,"Footscray",10,11,71,"M.C.G.",11,1989,"Regular",5,"Home","Melbourne","Footscray",11
9839,1989-04-30,"R5","Brisbane Lions",10,13,73,"West Coast",19,11,125,"Carrara",-52,1989,"Regular",5,"Away","West Coast","Brisbane Lions",52
9840,1989-04-30,"R5","Sydney",10,17,77,"Collingwood",9,12,66,"S.C.G.",11,1989,"Regular",5,"Home","Sydney","Collingwood",11
9841,1989-04-30,"R5","North Melbourne",20,14,134,"Richmond",26,15,171,"M.C.G.",-37,1989,"Regular",5,"Away","Richmond","North Melbourne",37
9842,1989-05-05,"R6","West Coast",12,9,81,"Fitzroy",12,17,89,"W.A.C.A.",-8,1989,"Regular",6,"Away","Fitzroy","West Coast",8
9843,1989-05-06,"R6","Carlton",15,12,102,"Richmond",9,12,66,"Waverley Park",36,1989,"Regular",6,"Home","Carlton","Richmond",36
9844,1989-05-06,"R6","Melbourne",9,10,64,"Collingwood",18,16,124,"M.C.G.",-60,1989,"Regular",6,"Away","Collingwood","Melbourne",60
9845,1989-05-06,"R6","Hawthorn",26,15,171,"Geelong",25,13,163,"Princes Park",8,1989,"Regular",6,"Home","Hawthorn","Geelong",8
9846,1989-05-06,"R6","St Kilda",13,17,95,"Sydney",9,13,67,"Moorabbin Oval",28,1989,"Regular",6,"Home","St Kilda","Sydney",28
9847,1989-05-07,"R6","Brisbane Lions",8,11,59,"Footscray",6,15,51,"Carrara",8,1989,"Regular",6,"Home","Brisbane Lions","Footscray",8
9848,1989-05-07,"R6","North Melbourne",17,19,121,"Essendon",16,9,105,"M.C.G.",16,1989,"Regular",6,"Home","North Melbourne","Essendon",16
9849,1989-05-12,"R7","Sydney",7,16,58,"North Melbourne",9,13,67,"S.C.G.",-9,1989,"Regular",7,"Away","North Melbourne","Sydney",9
9850,1989-05-13,"R7","Melbourne",12,14,86,"Carlton",11,14,80,"M.C.G.",6,1989,"Regular",7,"Home","Melbourne","Carlton",6
9851,1989-05-13,"R7","Collingwood",16,10,106,"Footscray",11,12,78,"Victoria Park",28,1989,"Regular",7,"Home","Collingwood","Footscray",28
9852,1989-05-13,"R7","Hawthorn",25,15,165,"Fitzroy",13,6,84,"Princes Park",81,1989,"Regular",7,"Home","Hawthorn","Fitzroy",81
9853,1989-05-13,"R7","Geelong",35,18,228,"St Kilda",16,13,109,"Kardinia Park",119,1989,"Regular",7,"Home","Geelong","St Kilda",119
9854,1989-05-13,"R7","Richmond",13,14,92,"West Coast",13,12,90,"Waverley Park",2,1989,"Regular",7,"Home","Richmond","West Coast",2
9855,1989-05-14,"R7","Brisbane Lions",12,9,81,"Essendon",17,10,112,"Carrara",-31,1989,"Regular",7,"Away","Essendon","Brisbane Lions",31
9856,1989-05-20,"R8","Geelong",26,23,179,"Brisbane Lions",6,14,50,"Kardinia Park",129,1989,"Regular",8,"Home","Geelong","Brisbane Lions",129
9857,1989-05-20,"R8","Carlton",12,8,80,"Collingwood",16,13,109,"Waverley Park",-29,1989,"Regular",8,"Away","Collingwood","Carlton",29
9858,1989-05-20,"R8","Essendon",21,19,145,"Richmond",12,15,87,"Windy Hill",58,1989,"Regular",8,"Home","Essendon","Richmond",58
9859,1989-05-20,"R8","Footscray",8,16,64,"Fitzroy",9,9,63,"Western Oval",1,1989,"Regular",8,"Home","Footscray","Fitzroy",1
9860,1989-05-20,"R8","Hawthorn",22,25,157,"Sydney",12,11,83,"Princes Park",74,1989,"Regular",8,"Home","Hawthorn","Sydney",74
9861,1989-05-20,"R8","St Kilda",18,7,115,"North Melbourne",17,10,112,"Moorabbin Oval",3,1989,"Regular",8,"Home","St Kilda","North Melbourne",3
9862,1989-05-21,"R8","West Coast",12,21,93,"Melbourne",13,17,95,"Subiaco",-2,1989,"Regular",8,"Away","Melbourne","West Coast",2
9863,1989-05-26,"R9","North Melbourne",25,15,165,"Brisbane Lions",10,11,71,"M.C.G.",94,1989,"Regular",9,"Home","North Melbourne","Brisbane Lions",94
9864,1989-05-27,"R9","Carlton",24,15,159,"Fitzroy",18,14,122,"Princes Park",37,1989,"Regular",9,"Home","Carlton","Fitzroy",37
9865,1989-05-27,"R9","Essendon",19,11,125,"Collingwood",7,16,58,"Waverley Park",67,1989,"Regular",9,"Home","Essendon","Collingwood",67
9866,1989-05-27,"R9","Richmond",10,17,77,"Geelong",32,19,211,"M.C.G.",-134,1989,"Regular",9,"Away","Geelong","Richmond",134
9867,1989-05-27,"R9","St Kilda",18,10,118,"West Coast",12,11,83,"Moorabbin Oval",35,1989,"Regular",9,"Home","St Kilda","West Coast",35
9868,1989-05-28,"R9","Footscray",10,13,73,"Hawthorn",17,15,117,"Western Oval",-44,1989,"Regular",9,"Away","Hawthorn","Footscray",44
9869,1989-05-28,"R9","Sydney",6,7,43,"Melbourne",6,16,52,"S.C.G.",-9,1989,"Regular",9,"Away","Melbourne","Sydney",9
9870,1989-06-02,"R10","North Melbourne",12,11,83,"Melbourne",16,17,113,"M.C.G.",-30,1989,"Regular",10,"Away","Melbourne","North Melbourne",30
9871,1989-06-03,"R10","Carlton",17,13,115,"Brisbane Lions",18,10,118,"Princes Park",-3,1989,"Regular",10,"Away","Brisbane Lions","Carlton",3
9872,1989-06-03,"R10","Collingwood",13,10,88,"Geelong",23,16,154,"M.C.G.",-66,1989,"Regular",10,"Away","Geelong","Collingwood",66
9873,1989-06-03,"R10","Essendon",18,14,122,"Fitzroy",10,9,69,"Windy Hill",53,1989,"Regular",10,"Home","Essendon","Fitzroy",53
9874,1989-06-03,"R10","Footscray",14,14,98,"Sydney",10,6,66,"Western Oval",32,1989,"Regular",10,"Home","Footscray","Sydney",32
9875,1989-06-03,"R10","St Kilda",13,21,99,"Richmond",13,14,92,"Waverley Park",7,1989,"Regular",10,"Home","St Kilda","Richmond",7
9876,1989-06-04,"R10","West Coast",15,15,105,"Hawthorn",16,14,110,"Subiaco",-5,1989,"Regular",10,"Away","Hawthorn","West Coast",5
9877,1989-06-09,"R11","Sydney",8,9,57,"Carlton",12,13,85,"S.C.G.",-28,1989,"Regular",11,"Away","Carlton","Sydney",28
9878,1989-06-10,"R11","Richmond",5,15,45,"Brisbane Lions",3,8,26,"M.C.G.",19,1989,"Regular",11,"Home","Richmond","Brisbane Lions",19
9879,1989-06-10,"R11","Fitzroy",1,8,14,"North Melbourne",6,13,49,"Princes Park",-35,1989,"Regular",11,"Away","North Melbourne","Fitzroy",35
9880,1989-06-10,"R11","Footscray",9,8,62,"St Kilda",7,12,54,"Waverley Park",8,1989,"Regular",11,"Home","Footscray","St Kilda",8
9881,1989-06-11,"R11","West Coast",11,15,81,"Collingwood",17,14,116,"Subiaco",-35,1989,"Regular",11,"Away","Collingwood","West Coast",35
9882,1989-06-12,"R11","Geelong",12,17,89,"Essendon",4,11,35,"M.C.G.",54,1989,"Regular",11,"Home","Geelong","Essendon",54
9883,1989-06-12,"R11","Hawthorn",8,6,54,"Melbourne",10,9,69,"Princes Park",-15,1989,"Regular",11,"Away","Melbourne","Hawthorn",15
9884,1989-06-16,"R12","West Coast",16,9,105,"Footscray",11,11,77,"W.A.C.A.",28,1989,"Regular",12,"Home","West Coast","Footscray",28
9885,1989-06-17,"R12","Carlton",7,9,51,"North Melbourne",5,10,40,"Princes Park",11,1989,"Regular",12,"Home","Carlton","North Melbourne",11
9886,1989-06-17,"R12","Collingwood",18,15,123,"Richmond",9,15,69,"Waverley Park",54,1989,"Regular",12,"Home","Collingwood","Richmond",54
9887,1989-06-17,"R12","Essendon",7,8,50,"Sydney",7,13,55,"Windy Hill",-5,1989,"Regular",12,"Away","Sydney","Essendon",5
9888,1989-06-17,"R12","Melbourne",2,8,20,"Geelong",13,11,89,"M.C.G.",-69,1989,"Regular",12,"Away","Geelong","Melbourne",69
9889,1989-06-17,"R12","St Kilda",8,6,54,"Hawthorn",10,12,72,"Moorabbin Oval",-18,1989,"Regular",12,"Away","Hawthorn","St Kilda",18
9890,1989-06-18,"R12","Brisbane Lions",18,6,114,"Fitzroy",19,14,128,"Carrara",-14,1989,"Regular",12,"Away","Fitzroy","Brisbane Lions",14
9891,1989-06-23,"R13","Hawthorn",15,16,106,"Brisbane Lions",4,11,35,"Waverley Park",71,1989,"Regular",13,"Home","Hawthorn","Brisbane Lions",71
9892,1989-06-24,"R13","Carlton",9,10,64,"West Coast",5,11,41,"Princes Park",23,1989,"Regular",13,"Home","Carlton","West Coast",23
9893,1989-06-24,"R13","Collingwood",14,24,108,"North Melbourne",8,8,56,"Victoria Park",52,1989,"Regular",13,"Home","Collingwood","North Melbourne",52
9894,1989-06-24,"R13","Essendon",3,10,28,"Footscray",3,5,23,"Windy Hill",5,1989,"Regular",13,"Home","Essendon","Footscray",5
9895,1989-06-24,"R13","Fitzroy",15,5,95,"Richmond",9,13,67,"Waverley Park",28,1989,"Regular",13,"Home","Fitzroy","Richmond",28
9896,1989-06-24,"R13","St Kilda",8,8,56,"Melbourne",10,4,64,"Moorabbin Oval",-8,1989,"Regular",13,"Away","Melbourne","St Kilda",8
9897,1989-06-25,"R13","Sydney",14,19,103,"Geelong",16,15,111,"S.C.G.",-8,1989,"Regular",13,"Away","Geelong","Sydney",8
9898,1989-07-07,"R14","North Melbourne",18,19,127,"St Kilda",9,13,67,"M.C.G.",60,1989,"Regular",14,"Home","North Melbourne","St Kilda",60
9899,1989-07-08,"R14","Essendon",9,7,61,"Carlton",8,10,58,"Waverley Park",3,1989,"Regular",14,"Home","Essendon","Carlton",3
9900,1989-07-08,"R14","Geelong",11,16,82,"Fitzroy",8,10,58,"Kardinia Park",24,1989,"Regular",14,"Home","Geelong","Fitzroy",24
9901,1989-07-08,"R14","Hawthorn",19,27,141,"West Coast",6,14,50,"Princes Park",91,1989,"Regular",14,"Home","Hawthorn","West Coast",91
9902,1989-07-08,"R14","Richmond",10,15,75,"Sydney",7,8,50,"M.C.G.",25,1989,"Regular",14,"Home","Richmond","Sydney",25
9903,1989-07-09,"R14","Brisbane Lions",14,15,99,"Melbourne",17,11,113,"Carrara",-14,1989,"Regular",14,"Away","Melbourne","Brisbane Lions",14
9904,1989-07-09,"R14","Footscray",15,15,105,"Collingwood",7,15,57,"Western Oval",48,1989,"Regular",14,"Home","Footscray","Collingwood",48
9905,1989-07-15,"R15","Collingwood",12,18,90,"Carlton",15,6,96,"Waverley Park",-6,1989,"Regular",15,"Away","Carlton","Collingwood",6
9906,1989-07-15,"R15","Essendon",25,10,160,"West Coast",1,12,18,"Windy Hill",142,1989,"Regular",15,"Home","Essendon","West Coast",142
9907,1989-07-15,"R15","Fitzroy",12,20,92,"St Kilda",13,8,86,"Princes Park",6,1989,"Regular",15,"Home","Fitzroy","St Kilda",6
9908,1989-07-15,"R15","Melbourne",17,15,117,"North Melbourne",11,15,81,"M.C.G.",36,1989,"Regular",15,"Home","Melbourne","North Melbourne",36
9909,1989-07-15,"R15","Brisbane Lions",11,11,77,"Geelong",22,19,151,"Carrara",-74,1989,"Regular",15,"Away","Geelong","Brisbane Lions",74
9910,1989-07-16,"R15","Sydney",16,21,117,"Footscray",10,17,77,"S.C.G.",40,1989,"Regular",15,"Home","Sydney","Footscray",40
9911,1989-07-16,"R15","Richmond",15,14,104,"Hawthorn",22,10,142,"M.C.G.",-38,1989,"Regular",15,"Away","Hawthorn","Richmond",38
9912,1989-07-22,"R16","Footscray",6,10,46,"Carlton",6,10,46,"Western Oval",0,1989,"Regular",16,"Home","Footscray","Carlton",0
9913,1989-07-22,"R16","Hawthorn",21,11,137,"Collingwood",11,11,77,"Princes Park",60,1989,"Regular",16,"Home","Hawthorn","Collingwood",60
9914,1989-07-22,"R16","Richmond",9,12,66,"Essendon",14,15,99,"M.C.G.",-33,1989,"Regular",16,"Away","Essendon","Richmond",33
9915,1989-07-22,"R16","Geelong",17,7,109,"Melbourne",16,16,112,"Waverley Park",-3,1989,"Regular",16,"Away","Melbourne","Geelong",3
9916,1989-07-22,"R16","Brisbane Lions",14,10,94,"St Kilda",12,18,90,"Carrara",4,1989,"Regular",16,"Home","Brisbane Lions","St Kilda",4
9917,1989-07-23,"R16","North Melbourne",8,18,66,"Fitzroy",16,11,107,"M.C.G.",-41,1989,"Regular",16,"Away","Fitzroy","North Melbourne",41
9918,1989-07-23,"R16","West Coast",16,16,112,"Sydney",9,16,70,"Subiaco",42,1989,"Regular",16,"Home","West Coast","Sydney",42
9919,1989-07-28,"R17","Richmond",6,15,51,"Fitzroy",18,15,123,"M.C.G.",-72,1989,"Regular",17,"Away","Fitzroy","Richmond",72
9920,1989-07-29,"R17","Carlton",15,16,106,"Melbourne",10,19,79,"Princes Park",27,1989,"Regular",17,"Home","Carlton","Melbourne",27
9921,1989-07-29,"R17","Geelong",14,20,104,"Collingwood",19,11,125,"M.C.G.",-21,1989,"Regular",17,"Away","Collingwood","Geelong",21
9922,1989-07-29,"R17","St Kilda",16,10,106,"Essendon",20,13,133,"Moorabbin Oval",-27,1989,"Regular",17,"Away","Essendon","St Kilda",27
9923,1989-07-29,"R17","North Melbourne",9,24,78,"Hawthorn",23,16,154,"Waverley Park",-76,1989,"Regular",17,"Away","Hawthorn","North Melbourne",76
9924,1989-07-30,"R17","Sydney",12,23,95,"Brisbane Lions",9,16,70,"S.C.G.",25,1989,"Regular",17,"Home","Sydney","Brisbane Lions",25
9925,1989-07-30,"R17","Footscray",10,12,72,"West Coast",16,13,109,"Western Oval",-37,1989,"Regular",17,"Away","West Coast","Footscray",37
9926,1989-08-05,"R18","Carlton",14,6,90,"Hawthorn",14,11,95,"Waverley Park",-5,1989,"Regular",18,"Away","Hawthorn","Carlton",5
9927,1989-08-05,"R18","Collingwood",11,15,81,"Sydney",12,13,85,"Victoria Park",-4,1989,"Regular",18,"Away","Sydney","Collingwood",4
9928,1989-08-05,"R18","Fitzroy",23,13,151,"Melbourne",15,13,103,"Princes Park",48,1989,"Regular",18,"Home","Fitzroy","Melbourne",48
9929,1989-08-05,"R18","St Kilda",13,12,90,"Geelong",17,11,113,"Moorabbin Oval",-23,1989,"Regular",18,"Away","Geelong","St Kilda",23
9930,1989-08-05,"R18","Brisbane Lions",25,17,167,"North Melbourne",12,12,84,"Carrara",83,1989,"Regular",18,"Home","Brisbane Lions","North Melbourne",83
9931,1989-08-06,"R18","Footscray",3,5,23,"Essendon",7,9,51,"Western Oval",-28,1989,"Regular",18,"Away","Essendon","Footscray",28
9932,1989-08-06,"R18","West Coast",19,16,130,"Richmond",10,19,79,"Subiaco",51,1989,"Regular",18,"Home","West Coast","Richmond",51
9933,1989-08-11,"R19","Richmond",11,10,76,"Carlton",15,14,104,"Waverley Park",-28,1989,"Regular",19,"Away","Carlton","Richmond",28
9934,1989-08-12,"R19","Essendon",15,11,101,"Brisbane Lions",7,5,47,"Windy Hill",54,1989,"Regular",19,"Home","Essendon","Brisbane Lions",54
9935,1989-08-12,"R19","Fitzroy",11,6,72,"West Coast",5,10,40,"Princes Park",32,1989,"Regular",19,"Home","Fitzroy","West Coast",32
9936,1989-08-12,"R19","Geelong",18,16,124,"Footscray",10,14,74,"Kardinia Park",50,1989,"Regular",19,"Home","Geelong","Footscray",50
9937,1989-08-12,"R19","Melbourne",9,9,63,"Hawthorn",12,15,87,"Waverley Park",-24,1989,"Regular",19,"Away","Hawthorn","Melbourne",24
9938,1989-08-13,"R19","North Melbourne",11,14,80,"Collingwood",11,12,78,"Waverley Park",2,1989,"Regular",19,"Home","North Melbourne","Collingwood",2
9939,1989-08-13,"R19","Sydney",25,9,159,"St Kilda",16,13,109,"S.C.G.",50,1989,"Regular",19,"Home","Sydney","St Kilda",50
9940,1989-08-18,"R20","West Coast",18,18,126,"Geelong",12,10,82,"W.A.C.A.",44,1989,"Regular",20,"Home","West Coast","Geelong",44
9941,1989-08-19,"R20","Carlton",20,13,133,"St Kilda",20,12,132,"Princes Park",1,1989,"Regular",20,"Home","Carlton","St Kilda",1
9942,1989-08-19,"R20","Fitzroy",10,11,71,"Collingwood",14,20,104,"Waverley Park",-33,1989,"Regular",20,"Away","Collingwood","Fitzroy",33
9943,1989-08-19,"R20","Essendon",19,14,128,"North Melbourne",17,10,112,"Windy Hill",16,1989,"Regular",20,"Home","Essendon","North Melbourne",16
9944,1989-08-19,"R20","Footscray",15,17,107,"Richmond",3,11,29,"Western Oval",78,1989,"Regular",20,"Home","Footscray","Richmond",78
9945,1989-08-19,"R20","Melbourne",14,14,98,"Sydney",12,15,87,"M.C.G.",11,1989,"Regular",20,"Home","Melbourne","Sydney",11
9946,1989-08-20,"R20","Brisbane Lions",12,5,77,"Hawthorn",9,7,61,"Carrara",16,1989,"Regular",20,"Home","Brisbane Lions","Hawthorn",16
9947,1989-08-25,"R21","Sydney",15,20,110,"Essendon",15,14,104,"S.C.G.",6,1989,"Regular",21,"Home","Sydney","Essendon",6
9948,1989-08-26,"R21","Fitzroy",10,8,68,"Brisbane Lions",12,9,81,"Waverley Park",-13,1989,"Regular",21,"Away","Brisbane Lions","Fitzroy",13
9949,1989-08-26,"R21","Collingwood",12,11,83,"Richmond",4,13,37,"Victoria Park",46,1989,"Regular",21,"Home","Collingwood","Richmond",46
9950,1989-08-26,"R21","Hawthorn",19,20,134,"Footscray",8,11,59,"Princes Park",75,1989,"Regular",21,"Home","Hawthorn","Footscray",75
9951,1989-08-26,"R21","Geelong",20,19,139,"North Melbourne",17,15,117,"Kardinia Park",22,1989,"Regular",21,"Home","Geelong","North Melbourne",22
9952,1989-08-26,"R21","Melbourne",10,12,72,"St Kilda",16,8,104,"M.C.G.",-32,1989,"Regular",21,"Away","St Kilda","Melbourne",32
9953,1989-08-27,"R21","West Coast",21,22,148,"Carlton",10,12,72,"Subiaco",76,1989,"Regular",21,"Home","West Coast","Carlton",76
9954,1989-09-01,"R22","North Melbourne",13,15,93,"Sydney",21,10,136,"M.C.G.",-43,1989,"Regular",22,"Away","Sydney","North Melbourne",43
9955,1989-09-02,"R22","Collingwood",20,9,129,"West Coast",11,14,80,"Victoria Park",49,1989,"Regular",22,"Home","Collingwood","West Coast",49
9956,1989-09-02,"R22","Melbourne",13,11,89,"Essendon",16,12,108,"M.C.G.",-19,1989,"Regular",22,"Away","Essendon","Melbourne",19
9957,1989-09-02,"R22","Fitzroy",13,18,96,"Footscray",12,9,81,"Princes Park",15,1989,"Regular",22,"Home","Fitzroy","Footscray",15
9958,1989-09-02,"R22","Geelong",23,24,162,"Richmond",12,14,86,"Kardinia Park",76,1989,"Regular",22,"Home","Geelong","Richmond",76
9959,1989-09-02,"R22","Hawthorn",28,13,181,"St Kilda",13,13,91,"Waverley Park",90,1989,"Regular",22,"Home","Hawthorn","St Kilda",90
9960,1989-09-03,"R22","Brisbane Lions",15,15,105,"Carlton",10,10,70,"Carrara",35,1989,"Regular",22,"Home","Brisbane Lions","Carlton",35
9961,1989-09-09,"EF","Melbourne",17,9,111,"Collingwood",13,10,88,"Waverley Park",23,1989,"Finals",23,"Home","Melbourne","Collingwood",23
9962,1989-09-10,"QF","Essendon",24,13,157,"Geelong",11,15,81,"M.C.G.",76,1989,"Finals",23,"Home","Essendon","Geelong",76
9963,1989-09-16,"SF","Hawthorn",16,16,112,"Essendon",11,10,76,"Waverley Park",36,1989,"Finals",24,"Home","Hawthorn","Essendon",36
9964,1989-09-17,"SF","Geelong",22,21,153,"Melbourne",12,18,90,"M.C.G.",63,1989,"Finals",24,"Home","Geelong","Melbourne",63
9965,1989-09-23,"PF","Essendon",10,10,70,"Geelong",24,20,164,"Waverley Park",-94,1989,"Finals",25,"Away","Geelong","Essendon",94
9966,1989-09-30,"GF","Hawthorn",21,18,144,"Geelong",21,12,138,"M.C.G.",6,1989,"Finals",26,"Home","Hawthorn","Geelong",6
9967,1990-03-31,"R1","Carlton",14,15,99,"Sydney",15,14,104,"Princes Park",-5,1990,"Regular",1,"Away","Sydney","Carlton",5
9968,1990-03-31,"R1","Essendon",20,21,141,"Fitzroy",8,12,60,"Windy Hill",81,1990,"Regular",1,"Home","Essendon","Fitzroy",81
9969,1990-03-31,"R1","Geelong",11,11,77,"Hawthorn",28,24,192,"Waverley Park",-115,1990,"Regular",1,"Away","Hawthorn","Geelong",115
9970,1990-03-31,"R1","North Melbourne",12,17,89,"Melbourne",22,10,142,"M.C.G.",-53,1990,"Regular",1,"Away","Melbourne","North Melbourne",53
9971,1990-03-31,"R1","Brisbane Lions",19,19,133,"Richmond",10,14,74,"Carrara",59,1990,"Regular",1,"Home","Brisbane Lions","Richmond",59
9972,1990-04-01,"R1","West Coast",14,16,100,"Collingwood",8,6,54,"Subiaco",46,1990,"Regular",1,"Home","West Coast","Collingwood",46
9973,1990-04-01,"R1","Footscray",11,15,81,"St Kilda",22,12,144,"Western Oval",-63,1990,"Regular",1,"Away","St Kilda","Footscray",63
9974,1990-04-06,"R2","Richmond",9,14,68,"North Melbourne",32,17,209,"M.C.G.",-141,1990,"Regular",2,"Away","North Melbourne","Richmond",141
9975,1990-04-07,"R2","Fitzroy",13,20,98,"Brisbane Lions",8,11,59,"Princes Park",39,1990,"Regular",2,"Home","Fitzroy","Brisbane Lions",39
9976,1990-04-07,"R2","Carlton",13,9,87,"Collingwood",19,8,122,"Waverley Park",-35,1990,"Regular",2,"Away","Collingwood","Carlton",35
9977,1990-04-07,"R2","Melbourne",18,20,128,"Geelong",13,13,91,"M.C.G.",37,1990,"Regular",2,"Home","Melbourne","Geelong",37
9978,1990-04-07,"R2","St Kilda",18,19,127,"West Coast",10,9,69,"Moorabbin Oval",58,1990,"Regular",2,"Home","St Kilda","West Coast",58
9979,1990-04-08,"R2","Essendon",24,15,159,"Hawthorn",14,13,97,"M.C.G.",62,1990,"Regular",2,"Home","Essendon","Hawthorn",62
9980,1990-04-08,"R2","Sydney",10,18,78,"Footscray",20,20,140,"S.C.G.",-62,1990,"Regular",2,"Away","Footscray","Sydney",62
9981,1990-04-14,"R3","St Kilda",11,10,76,"Carlton",14,8,92,"Waverley Park",-16,1990,"Regular",3,"Away","Carlton","St Kilda",16
9982,1990-04-14,"R3","Footscray",7,17,59,"West Coast",18,14,122,"Western Oval",-63,1990,"Regular",3,"Away","West Coast","Footscray",63
9983,1990-04-14,"R3","Hawthorn",15,21,111,"Richmond",10,21,81,"Princes Park",30,1990,"Regular",3,"Home","Hawthorn","Richmond",30
9984,1990-04-15,"R3","Brisbane Lions",14,11,95,"North Melbourne",17,11,113,"Carrara",-18,1990,"Regular",3,"Away","North Melbourne","Brisbane Lions",18
9985,1990-04-16,"R3","Collingwood",20,8,128,"Sydney",12,21,93,"Victoria Park",35,1990,"Regular",3,"Home","Collingwood","Sydney",35
9986,1990-04-16,"R3","Melbourne",18,14,122,"Essendon",14,11,95,"M.C.G.",27,1990,"Regular",3,"Home","Melbourne","Essendon",27
9987,1990-04-16,"R3","Geelong",22,18,150,"Fitzroy",11,11,77,"Kardinia Park",73,1990,"Regular",3,"Home","Geelong","Fitzroy",73
9988,1990-04-20,"R4","West Coast",17,18,120,"Carlton",10,10,70,"W.A.C.A.",50,1990,"Regular",4,"Home","West Coast","Carlton",50
9989,1990-04-21,"R4","Hawthorn",18,12,120,"Brisbane Lions",5,8,38,"Princes Park",82,1990,"Regular",4,"Home","Hawthorn","Brisbane Lions",82
9990,1990-04-21,"R4","Collingwood",14,12,96,"Footscray",11,12,78,"Victoria Park",18,1990,"Regular",4,"Home","Collingwood","Footscray",18
9991,1990-04-21,"R4","Richmond",6,13,49,"Essendon",18,19,127,"M.C.G.",-78,1990,"Regular",4,"Away","Essendon","Richmond",78
9992,1990-04-21,"R4","Fitzroy",9,10,64,"Melbourne",13,11,89,"Waverley Park",-25,1990,"Regular",4,"Away","Melbourne","Fitzroy",25
9993,1990-04-22,"R4","North Melbourne",15,22,112,"Geelong",20,23,143,"M.C.G.",-31,1990,"Regular",4,"Away","Geelong","North Melbourne",31
9994,1990-04-22,"R4","Sydney",13,19,97,"St Kilda",19,17,131,"S.C.G.",-34,1990,"Regular",4,"Away","St Kilda","Sydney",34
9995,1990-04-25,"R5","Carlton",10,16,76,"Footscray",15,13,103,"Princes Park",-27,1990,"Regular",5,"Away","Footscray","Carlton",27
9996,1990-04-25,"R5","Richmond",21,17,143,"Fitzroy",9,10,64,"M.C.G.",79,1990,"Regular",5,"Home","Richmond","Fitzroy",79
9997,1990-04-28,"R5","St Kilda",13,13,91,"Collingwood",12,20,92,"M.C.G.",-1,1990,"Regular",5,"Away","Collingwood","St Kilda",1
9998,1990-04-28,"R5","Essendon",11,15,81,"Geelong",12,17,89,"Waverley Park",-8,1990,"Regular",5,"Away","Geelong","Essendon",8
9999,1990-04-28,"R5","Hawthorn",16,12,108,"North Melbourne",10,18,78,"Princes Park",30,1990,"Regular",5,"Home","Hawthorn","North Melbourne",30
10000,1990-04-28,"R5","Brisbane Lions",8,13,61,"Melbourne",19,11,125,"Carrara",-64,1990,"Regular",5,"Away","Melbourne","Brisbane Lions",64
10001,1990-04-29,"R5","West Coast",19,14,128,"Sydney",10,7,67,"Subiaco",61,1990,"Regular",5,"Home","West Coast","Sydney",61
10002,1990-05-04,"R6","Richmond",9,14,68,"West Coast",15,13,103,"M.C.G.",-35,1990,"Regular",6,"Away","West Coast","Richmond",35
10003,1990-05-05,"R6","Geelong",23,13,151,"Brisbane Lions",12,8,80,"Kardinia Park",71,1990,"Regular",6,"Home","Geelong","Brisbane Lions",71
10004,1990-05-05,"R6","Carlton",20,13,133,"North Melbourne",14,19,103,"Princes Park",30,1990,"Regular",6,"Home","Carlton","North Melbourne",30
10005,1990-05-05,"R6","Collingwood",10,15,75,"Essendon",15,11,101,"M.C.G.",-26,1990,"Regular",6,"Away","Essendon","Collingwood",26
10006,1990-05-05,"R6","Footscray",12,10,82,"Fitzroy",5,20,50,"Waverley Park",32,1990,"Regular",6,"Home","Footscray","Fitzroy",32
10007,1990-05-05,"R6","St Kilda",15,14,104,"Hawthorn",14,17,101,"Moorabbin Oval",3,1990,"Regular",6,"Home","St Kilda","Hawthorn",3
10008,1990-05-06,"R6","Sydney",14,14,98,"Melbourne",12,21,93,"S.C.G.",5,1990,"Regular",6,"Home","Sydney","Melbourne",5
10009,1990-05-11,"R7","Melbourne",18,8,116,"West Coast",9,7,61,"M.C.G.",55,1990,"Regular",7,"Home","Melbourne","West Coast",55
10010,1990-05-12,"R7","Essendon",13,13,91,"Carlton",17,9,111,"Windy Hill",-20,1990,"Regular",7,"Away","Carlton","Essendon",20
10011,1990-05-12,"R7","Collingwood",13,14,92,"Hawthorn",13,16,94,"Waverley Park",-2,1990,"Regular",7,"Away","Hawthorn","Collingwood",2
10012,1990-05-12,"R7","Fitzroy",18,13,121,"St Kilda",15,13,103,"Princes Park",18,1990,"Regular",7,"Home","Fitzroy","St Kilda",18
10013,1990-05-12,"R7","North Melbourne",12,13,85,"Footscray",12,15,87,"M.C.G.",-2,1990,"Regular",7,"Away","Footscray","North Melbourne",2
10014,1990-05-13,"R7","Brisbane Lions",14,12,96,"Sydney",13,10,88,"Carrara",8,1990,"Regular",7,"Home","Brisbane Lions","Sydney",8
10015,1990-05-13,"R7","Geelong",9,28,82,"Richmond",13,18,96,"Kardinia Park",-14,1990,"Regular",7,"Away","Richmond","Geelong",14
10016,1990-05-18,"R8","Sydney",15,17,107,"Geelong",13,20,98,"S.C.G.",9,1990,"Regular",8,"Home","Sydney","Geelong",9
10017,1990-05-19,"R8","Carlton",18,18,126,"Hawthorn",9,5,59,"Waverley Park",67,1990,"Regular",8,"Home","Carlton","Hawthorn",67
10018,1990-05-19,"R8","Fitzroy",9,21,75,"Collingwood",17,18,120,"Princes Park",-45,1990,"Regular",8,"Away","Collingwood","Fitzroy",45
10019,1990-05-19,"R8","Melbourne",20,13,133,"Richmond",11,14,80,"M.C.G.",53,1990,"Regular",8,"Home","Melbourne","Richmond",53
10020,1990-05-19,"R8","St Kilda",12,22,94,"North Melbourne",11,12,78,"Moorabbin Oval",16,1990,"Regular",8,"Home","St Kilda","North Melbourne",16
10021,1990-05-20,"R8","West Coast",16,26,122,"Brisbane Lions",9,9,63,"Subiaco",59,1990,"Regular",8,"Home","West Coast","Brisbane Lions",59
10022,1990-05-20,"R8","Footscray",11,12,78,"Essendon",14,13,97,"Western Oval",-19,1990,"Regular",8,"Away","Essendon","Footscray",19
10023,1990-05-26,"R9","Carlton",18,15,123,"Fitzroy",11,16,82,"Princes Park",41,1990,"Regular",9,"Home","Carlton","Fitzroy",41
10024,1990-05-26,"R9","Collingwood",26,20,176,"North Melbourne",14,12,96,"Victoria Park",80,1990,"Regular",9,"Home","Collingwood","North Melbourne",80
10025,1990-05-26,"R9","Essendon",18,16,124,"St Kilda",17,11,113,"Windy Hill",11,1990,"Regular",9,"Home","Essendon","St Kilda",11
10026,1990-05-26,"R9","Hawthorn",14,8,92,"Melbourne",7,6,48,"Waverley Park",44,1990,"Regular",9,"Home","Hawthorn","Melbourne",44
10027,1990-05-26,"R9","Brisbane Lions",8,8,56,"Footscray",19,11,125,"Carrara",-69,1990,"Regular",9,"Away","Footscray","Brisbane Lions",69
10028,1990-05-27,"R9","West Coast",16,16,112,"Geelong",13,15,93,"Subiaco",19,1990,"Regular",9,"Home","West Coast","Geelong",19
10029,1990-05-27,"R9","Richmond",20,19,139,"Sydney",9,6,60,"M.C.G.",79,1990,"Regular",9,"Home","Richmond","Sydney",79
10030,1990-06-01,"R10","North Melbourne",17,16,118,"West Coast",13,12,90,"M.C.G.",28,1990,"Regular",10,"Home","North Melbourne","West Coast",28
10031,1990-06-02,"R10","St Kilda",21,22,148,"Brisbane Lions",10,11,71,"Moorabbin Oval",77,1990,"Regular",10,"Home","St Kilda","Brisbane Lions",77
10032,1990-06-02,"R10","Richmond",15,18,108,"Carlton",13,7,85,"M.C.G.",23,1990,"Regular",10,"Home","Richmond","Carlton",23
10033,1990-06-02,"R10","Collingwood",16,14,110,"Melbourne",9,4,58,"Waverley Park",52,1990,"Regular",10,"Home","Collingwood","Melbourne",52
10034,1990-06-02,"R10","Fitzroy",15,13,103,"Hawthorn",13,11,89,"Princes Park",14,1990,"Regular",10,"Home","Fitzroy","Hawthorn",14
10035,1990-06-03,"R10","Sydney",11,8,74,"Essendon",25,14,164,"S.C.G.",-90,1990,"Regular",10,"Away","Essendon","Sydney",90
10036,1990-06-03,"R10","Geelong",14,12,96,"Footscray",13,16,94,"Kardinia Park",2,1990,"Regular",10,"Home","Geelong","Footscray",2
10037,1990-06-09,"R11","Essendon",15,9,99,"West Coast",8,12,60,"Windy Hill",39,1990,"Regular",11,"Home","Essendon","West Coast",39
10038,1990-06-09,"R11","St Kilda",15,14,104,"Geelong",16,16,112,"Waverley Park",-8,1990,"Regular",11,"Away","Geelong","St Kilda",8
10039,1990-06-09,"R11","Hawthorn",19,18,132,"Sydney",11,17,83,"Princes Park",49,1990,"Regular",11,"Home","Hawthorn","Sydney",49
10040,1990-06-10,"R11","Brisbane Lions",10,13,73,"Collingwood",15,17,107,"Carrara",-34,1990,"Regular",11,"Away","Collingwood","Brisbane Lions",34
10041,1990-06-11,"R11","Melbourne",15,9,99,"Carlton",13,15,93,"M.C.G.",6,1990,"Regular",11,"Home","Melbourne","Carlton",6
10042,1990-06-11,"R11","Fitzroy",11,12,78,"North Melbourne",15,10,100,"Princes Park",-22,1990,"Regular",11,"Away","North Melbourne","Fitzroy",22
10043,1990-06-11,"R11","Footscray",15,6,96,"Richmond",12,10,82,"Western Oval",14,1990,"Regular",11,"Home","Footscray","Richmond",14
10044,1990-06-15,"R12","West Coast",16,9,105,"Hawthorn",12,10,82,"W.A.C.A.",23,1990,"Regular",12,"Home","West Coast","Hawthorn",23
10045,1990-06-16,"R12","Carlton",24,14,158,"Brisbane Lions",11,23,89,"Princes Park",69,1990,"Regular",12,"Home","Carlton","Brisbane Lions",69
10046,1990-06-16,"R12","Geelong",12,16,88,"Collingwood",14,15,99,"Waverley Park",-11,1990,"Regular",12,"Away","Collingwood","Geelong",11
10047,1990-06-16,"R12","Essendon",18,16,124,"North Melbourne",13,16,94,"Windy Hill",30,1990,"Regular",12,"Home","Essendon","North Melbourne",30
10048,1990-06-16,"R12","Richmond",18,20,128,"St Kilda",16,12,108,"M.C.G.",20,1990,"Regular",12,"Home","Richmond","St Kilda",20
10049,1990-06-17,"R12","Sydney",10,11,71,"Fitzroy",17,14,116,"S.C.G.",-45,1990,"Regular",12,"Away","Fitzroy","Sydney",45
10050,1990-06-17,"R12","Footscray",10,8,68,"Melbourne",15,11,101,"Western Oval",-33,1990,"Regular",12,"Away","Melbourne","Footscray",33
10051,1990-06-23,"R13","Carlton",18,15,123,"Geelong",13,26,104,"Princes Park",19,1990,"Regular",13,"Home","Carlton","Geelong",19
10052,1990-06-23,"R13","Melbourne",14,15,99,"St Kilda",20,12,132,"M.C.G.",-33,1990,"Regular",13,"Away","St Kilda","Melbourne",33
10053,1990-06-23,"R13","Brisbane Lions",7,13,55,"Essendon",15,19,109,"Carrara",-54,1990,"Regular",13,"Away","Essendon","Brisbane Lions",54
10054,1990-06-30,"R13","Collingwood",14,17,101,"Richmond",5,12,42,"Victoria Park",59,1990,"Regular",13,"Home","Collingwood","Richmond",59
10055,1990-06-30,"R13","Hawthorn",10,13,73,"Footscray",14,7,91,"Waverley Park",-18,1990,"Regular",13,"Away","Footscray","Hawthorn",18
10056,1990-06-30,"R13","North Melbourne",18,23,131,"Sydney",5,11,41,"M.C.G.",90,1990,"Regular",13,"Home","North Melbourne","Sydney",90
10057,1990-07-01,"R13","West Coast",20,8,128,"Fitzroy",13,13,91,"Subiaco",37,1990,"Regular",13,"Home","West Coast","Fitzroy",37
10058,1990-07-06,"R14","Richmond",22,21,153,"Brisbane Lions",10,11,71,"M.C.G.",82,1990,"Regular",14,"Home","Richmond","Brisbane Lions",82
10059,1990-07-07,"R14","Collingwood",15,12,102,"West Coast",11,10,76,"Victoria Park",26,1990,"Regular",14,"Home","Collingwood","West Coast",26
10060,1990-07-07,"R14","Fitzroy",9,7,61,"Essendon",20,24,144,"Princes Park",-83,1990,"Regular",14,"Away","Essendon","Fitzroy",83
10061,1990-07-07,"R14","St Kilda",11,12,78,"Footscray",12,13,85,"Moorabbin Oval",-7,1990,"Regular",14,"Away","Footscray","St Kilda",7
10062,1990-07-07,"R14","Hawthorn",18,10,118,"Geelong",7,8,50,"Waverley Park",68,1990,"Regular",14,"Home","Hawthorn","Geelong",68
10063,1990-07-07,"R14","Melbourne",10,13,73,"North Melbourne",31,14,200,"M.C.G.",-127,1990,"Regular",14,"Away","North Melbourne","Melbourne",127
10064,1990-07-08,"R14","Sydney",13,12,90,"Carlton",25,12,162,"S.C.G.",-72,1990,"Regular",14,"Away","Carlton","Sydney",72
10065,1990-07-13,"R15","West Coast",16,12,108,"St Kilda",14,6,90,"W.A.C.A.",18,1990,"Regular",15,"Home","West Coast","St Kilda",18
10066,1990-07-14,"R15","Collingwood",17,11,113,"Carlton",8,11,59,"Waverley Park",54,1990,"Regular",15,"Home","Collingwood","Carlton",54
10067,1990-07-14,"R15","Hawthorn",10,7,67,"Essendon",21,16,142,"Princes Park",-75,1990,"Regular",15,"Away","Essendon","Hawthorn",75
10068,1990-07-14,"R15","Footscray",17,10,112,"Sydney",13,18,96,"Western Oval",16,1990,"Regular",15,"Home","Footscray","Sydney",16
10069,1990-07-14,"R15","Geelong",17,11,113,"Melbourne",15,13,103,"Kardinia Park",10,1990,"Regular",15,"Home","Geelong","Melbourne",10
10070,1990-07-14,"R15","North Melbourne",22,12,144,"Richmond",15,10,100,"M.C.G.",44,1990,"Regular",15,"Home","North Melbourne","Richmond",44
10071,1990-07-15,"R15","Brisbane Lions",17,9,111,"Fitzroy",9,8,62,"Carrara",49,1990,"Regular",15,"Home","Brisbane Lions","Fitzroy",49
10072,1990-07-20,"R16","West Coast",16,13,109,"Footscray",9,12,66,"W.A.C.A.",43,1990,"Regular",16,"Home","West Coast","Footscray",43
10073,1990-07-21,"R16","Carlton",19,9,123,"St Kilda",15,18,108,"Princes Park",15,1990,"Regular",16,"Home","Carlton","St Kilda",15
10074,1990-07-21,"R16","Essendon",15,16,106,"Melbourne",17,12,114,"Windy Hill",-8,1990,"Regular",16,"Away","Melbourne","Essendon",8
10075,1990-07-21,"R16","Fitzroy",17,6,108,"Geelong",12,9,81,"Waverley Park",27,1990,"Regular",16,"Home","Fitzroy","Geelong",27
10076,1990-07-21,"R16","Richmond",10,8,68,"Hawthorn",25,9,159,"M.C.G.",-91,1990,"Regular",16,"Away","Hawthorn","Richmond",91
10077,1990-07-22,"R16","North Melbourne",13,12,90,"Brisbane Lions",7,12,54,"M.C.G.",36,1990,"Regular",16,"Home","North Melbourne","Brisbane Lions",36
10078,1990-07-22,"R16","Sydney",19,9,123,"Collingwood",21,21,147,"S.C.G.",-24,1990,"Regular",16,"Away","Collingwood","Sydney",24
10079,1990-07-28,"R17","Carlton",15,11,101,"West Coast",20,12,132,"Princes Park",-31,1990,"Regular",17,"Away","West Coast","Carlton",31
10080,1990-07-28,"R17","Essendon",18,17,125,"Richmond",6,10,46,"Waverley Park",79,1990,"Regular",17,"Home","Essendon","Richmond",79
10081,1990-07-28,"R17","Melbourne",15,19,109,"Fitzroy",12,18,90,"M.C.G.",19,1990,"Regular",17,"Home","Melbourne","Fitzroy",19
10082,1990-07-28,"R17","Geelong",17,8,110,"North Melbourne",20,11,131,"Kardinia Park",-21,1990,"Regular",17,"Away","North Melbourne","Geelong",21
10083,1990-07-28,"R17","St Kilda",22,16,148,"Sydney",10,13,73,"Moorabbin Oval",75,1990,"Regular",17,"Home","St Kilda","Sydney",75
10084,1990-07-29,"R17","Brisbane Lions",14,11,95,"Hawthorn",16,14,110,"Carrara",-15,1990,"Regular",17,"Away","Hawthorn","Brisbane Lions",15
10085,1990-07-29,"R17","Footscray",14,12,96,"Collingwood",12,21,93,"M.C.G.",3,1990,"Regular",17,"Home","Footscray","Collingwood",3
10086,1990-08-03,"R18","North Melbourne",14,14,98,"Hawthorn",15,18,108,"M.C.G.",-10,1990,"Regular",18,"Away","Hawthorn","North Melbourne",10
10087,1990-08-04,"R18","Melbourne",10,13,73,"Brisbane Lions",9,6,60,"Waverley Park",13,1990,"Regular",18,"Home","Melbourne","Brisbane Lions",13
10088,1990-08-04,"R18","Collingwood",16,21,117,"St Kilda",7,7,49,"Victoria Park",68,1990,"Regular",18,"Home","Collingwood","St Kilda",68
10089,1990-08-04,"R18","Geelong",14,8,92,"Essendon",13,16,94,"Kardinia Park",-2,1990,"Regular",18,"Away","Essendon","Geelong",2
10090,1990-08-04,"R18","Fitzroy",16,17,113,"Richmond",10,15,75,"Princes Park",38,1990,"Regular",18,"Home","Fitzroy","Richmond",38
10091,1990-08-05,"R18","Footscray",9,13,67,"Carlton",15,6,96,"Western Oval",-29,1990,"Regular",18,"Away","Carlton","Footscray",29
10092,1990-08-05,"R18","Sydney",10,8,68,"West Coast",12,11,83,"S.C.G.",-15,1990,"Regular",18,"Away","West Coast","Sydney",15
10093,1990-08-11,"R19","Fitzroy",12,16,88,"Footscray",17,21,123,"Princes Park",-35,1990,"Regular",19,"Away","Footscray","Fitzroy",35
10094,1990-08-11,"R19","Hawthorn",17,17,119,"St Kilda",13,5,83,"Waverley Park",36,1990,"Regular",19,"Home","Hawthorn","St Kilda",36
10095,1990-08-11,"R19","Melbourne",27,11,173,"Sydney",15,16,106,"M.C.G.",67,1990,"Regular",19,"Home","Melbourne","Sydney",67
10096,1990-08-11,"R19","Brisbane Lions",25,13,163,"Geelong",14,13,97,"Carrara",66,1990,"Regular",19,"Home","Brisbane Lions","Geelong",66
10097,1990-08-12,"R19","North Melbourne",13,11,89,"Carlton",7,13,55,"M.C.G.",34,1990,"Regular",19,"Home","North Melbourne","Carlton",34
10098,1990-08-12,"R19","Essendon",13,6,84,"Collingwood",11,12,78,"Waverley Park",6,1990,"Regular",19,"Home","Essendon","Collingwood",6
10099,1990-08-12,"R19","West Coast",22,21,153,"Richmond",16,9,105,"Subiaco",48,1990,"Regular",19,"Home","West Coast","Richmond",48
10100,1990-08-17,"R20","Sydney",11,20,86,"Brisbane Lions",7,13,55,"S.C.G.",31,1990,"Regular",20,"Home","Sydney","Brisbane Lions",31
10101,1990-08-18,"R20","Carlton",16,11,107,"Essendon",12,15,87,"Princes Park",20,1990,"Regular",20,"Home","Carlton","Essendon",20
10102,1990-08-18,"R20","Hawthorn",26,7,163,"Collingwood",12,8,80,"Waverley Park",83,1990,"Regular",20,"Home","Hawthorn","Collingwood",83
10103,1990-08-18,"R20","St Kilda",17,15,117,"Fitzroy",18,8,116,"Moorabbin Oval",1,1990,"Regular",20,"Home","St Kilda","Fitzroy",1
10104,1990-08-18,"R20","Footscray",12,16,88,"North Melbourne",17,13,115,"Western Oval",-27,1990,"Regular",20,"Away","North Melbourne","Footscray",27
10105,1990-08-18,"R20","Richmond",14,10,94,"Geelong",24,14,158,"M.C.G.",-64,1990,"Regular",20,"Away","Geelong","Richmond",64
10106,1990-08-19,"R20","West Coast",15,13,103,"Melbourne",21,13,139,"Subiaco",-36,1990,"Regular",20,"Away","Melbourne","West Coast",36
10107,1990-08-24,"R21","North Melbourne",27,17,179,"St Kilda",12,15,87,"M.C.G.",92,1990,"Regular",21,"Home","North Melbourne","St Kilda",92
10108,1990-08-25,"R21","Hawthorn",17,14,116,"Carlton",12,13,85,"Princes Park",31,1990,"Regular",21,"Home","Hawthorn","Carlton",31
10109,1990-08-25,"R21","Collingwood",17,16,118,"Fitzroy",4,8,32,"Victoria Park",86,1990,"Regular",21,"Home","Collingwood","Fitzroy",86
10110,1990-08-25,"R21","Essendon",15,14,104,"Footscray",11,14,80,"Windy Hill",24,1990,"Regular",21,"Home","Essendon","Footscray",24
10111,1990-08-25,"R21","Geelong",12,18,90,"Sydney",14,8,92,"Kardinia Park",-2,1990,"Regular",21,"Away","Sydney","Geelong",2
10112,1990-08-25,"R21","Richmond",7,8,50,"Melbourne",12,14,86,"Waverley Park",-36,1990,"Regular",21,"Away","Melbourne","Richmond",36
10113,1990-08-26,"R21","Brisbane Lions",8,11,59,"West Coast",14,16,100,"Carrara",-41,1990,"Regular",21,"Away","West Coast","Brisbane Lions",41
10114,1990-09-01,"R22","Footscray",16,21,117,"Brisbane Lions",15,6,96,"Western Oval",21,1990,"Regular",22,"Home","Footscray","Brisbane Lions",21
10115,1990-09-01,"R22","Fitzroy",18,17,125,"Carlton",16,17,113,"Princes Park",12,1990,"Regular",22,"Home","Fitzroy","Carlton",12
10116,1990-09-01,"R22","North Melbourne",8,19,67,"Collingwood",23,18,156,"Waverley Park",-89,1990,"Regular",22,"Away","Collingwood","North Melbourne",89
10117,1990-09-01,"R22","St Kilda",13,15,93,"Essendon",19,14,128,"Moorabbin Oval",-35,1990,"Regular",22,"Away","Essendon","St Kilda",35
10118,1990-09-01,"R22","Geelong",12,11,83,"West Coast",14,6,90,"Kardinia Park",-7,1990,"Regular",22,"Away","West Coast","Geelong",7
10119,1990-09-01,"R22","Melbourne",17,14,116,"Hawthorn",15,14,104,"M.C.G.",12,1990,"Regular",22,"Home","Melbourne","Hawthorn",12
10120,1990-09-02,"R22","Sydney",15,19,109,"Richmond",20,19,139,"S.C.G.",-30,1990,"Regular",22,"Away","Richmond","Sydney",30
10121,1990-09-08,"QF","Collingwood",13,12,90,"West Coast",13,12,90,"Waverley Park",0,1990,"Finals",23,"Home","Collingwood","West Coast",0
10122,1990-09-09,"EF","Melbourne",10,13,73,"Hawthorn",8,16,64,"M.C.G.",9,1990,"Finals",23,"Home","Melbourne","Hawthorn",9
10123,1990-09-15,"QF","Collingwood",19,12,126,"West Coast",9,13,67,"Waverley Park",59,1990,"Finals",23,"Home","Collingwood","West Coast",59
10124,1990-09-22,"SF","West Coast",19,16,130,"Melbourne",15,10,100,"Waverley Park",30,1990,"Finals",24,"Home","West Coast","Melbourne",30
10125,1990-09-23,"SF","Essendon",7,12,54,"Collingwood",17,15,117,"M.C.G.",-63,1990,"Finals",24,"Away","Collingwood","Essendon",63
10126,1990-09-29,"PF","Essendon",18,13,121,"West Coast",8,10,58,"Waverley Park",63,1990,"Finals",25,"Home","Essendon","West Coast",63
10127,1990-10-06,"GF","Essendon",5,11,41,"Collingwood",13,11,89,"M.C.G.",-48,1990,"Finals",26,"Away","Collingwood","Essendon",48
10128,1991-03-22,"R1","Adelaide",24,11,155,"Hawthorn",9,15,69,"Football Park",86,1991,"Regular",1,"Home","Adelaide","Hawthorn",86
10129,1991-03-23,"R1","St Kilda",16,11,107,"Richmond",12,10,82,"Waverley Park",25,1991,"Regular",1,"Home","St Kilda","Richmond",25
10130,1991-03-24,"R1","Footscray",11,10,76,"Collingwood",21,20,146,"Waverley Park",-70,1991,"Regular",1,"Away","Collingwood","Footscray",70
10131,1991-03-24,"R1","West Coast",14,15,99,"Melbourne",2,8,20,"Subiaco",79,1991,"Regular",1,"Home","West Coast","Melbourne",79
10132,1991-03-30,"R2","Collingwood",8,10,58,"West Coast",13,7,85,"Waverley Park",-27,1991,"Regular",2,"Away","West Coast","Collingwood",27
10133,1991-03-30,"R2","Fitzroy",6,13,49,"Melbourne",27,18,180,"Princes Park",-131,1991,"Regular",2,"Away","Melbourne","Fitzroy",131
10134,1991-03-30,"R2","Brisbane Lions",8,10,58,"North Melbourne",15,14,104,"Carrara",-46,1991,"Regular",2,"Away","North Melbourne","Brisbane Lions",46
10135,1991-03-31,"R2","Adelaide",12,9,81,"Carlton",15,14,104,"Football Park",-23,1991,"Regular",2,"Away","Carlton","Adelaide",23
10136,1991-04-01,"R2","Richmond",17,7,109,"Essendon",16,17,113,"M.C.G.",-4,1991,"Regular",2,"Away","Essendon","Richmond",4
10137,1991-04-01,"R2","Geelong",18,22,130,"St Kilda",16,8,104,"Kardinia Park",26,1991,"Regular",2,"Home","Geelong","St Kilda",26
10138,1991-04-01,"R2","Hawthorn",25,16,166,"Sydney",10,15,75,"Princes Park",91,1991,"Regular",2,"Home","Hawthorn","Sydney",91
10139,1991-04-06,"R3","Carlton",18,19,127,"Brisbane Lions",9,16,70,"Princes Park",57,1991,"Regular",3,"Home","Carlton","Brisbane Lions",57
10140,1991-04-06,"R3","Collingwood",16,21,117,"Fitzroy",8,10,58,"Victoria Park",59,1991,"Regular",3,"Home","Collingwood","Fitzroy",59
10141,1991-04-06,"R3","North Melbourne",13,16,94,"Essendon",25,17,167,"M.C.G.",-73,1991,"Regular",3,"Away","Essendon","North Melbourne",73
10142,1991-04-06,"R3","Hawthorn",20,16,136,"Richmond",11,13,79,"Waverley Park",57,1991,"Regular",3,"Home","Hawthorn","Richmond",57
10143,1991-04-07,"R3","Sydney",15,18,108,"Adelaide",19,18,132,"S.C.G.",-24,1991,"Regular",3,"Away","Adelaide","Sydney",24
10144,1991-04-07,"R3","Footscray",10,8,68,"Geelong",15,27,117,"Western Oval",-49,1991,"Regular",3,"Away","Geelong","Footscray",49
10145,1991-04-07,"R3","Melbourne",21,19,145,"St Kilda",24,10,154,"M.C.G.",-9,1991,"Regular",3,"Away","St Kilda","Melbourne",9
10146,1991-04-12,"R4","West Coast",18,19,127,"North Melbourne",8,7,55,"W.A.C.A.",72,1991,"Regular",4,"Home","West Coast","North Melbourne",72
10147,1991-04-13,"R4","Essendon",12,20,92,"Adelaide",6,11,47,"Windy Hill",45,1991,"Regular",4,"Home","Essendon","Adelaide",45
10148,1991-04-13,"R4","Melbourne",23,17,155,"Carlton",17,8,110,"Waverley Park",45,1991,"Regular",4,"Home","Melbourne","Carlton",45
10149,1991-04-13,"R4","St Kilda",13,16,94,"Collingwood",13,16,94,"Moorabbin Oval",0,1991,"Regular",4,"Home","St Kilda","Collingwood",0
10150,1991-04-13,"R4","Fitzroy",12,18,90,"Footscray",15,16,106,"Princes Park",-16,1991,"Regular",4,"Away","Footscray","Fitzroy",16
10151,1991-04-13,"R4","Richmond",19,13,127,"Sydney",24,20,164,"M.C.G.",-37,1991,"Regular",4,"Away","Sydney","Richmond",37
10152,1991-04-14,"R4","Brisbane Lions",12,16,88,"Geelong",27,28,190,"Gabba",-102,1991,"Regular",4,"Away","Geelong","Brisbane Lions",102
10153,1991-04-19,"R5","Sydney",19,16,130,"Essendon",24,17,161,"S.C.G.",-31,1991,"Regular",5,"Away","Essendon","Sydney",31
10154,1991-04-20,"R5","Collingwood",16,19,115,"Brisbane Lions",14,9,93,"Victoria Park",22,1991,"Regular",5,"Home","Collingwood","Brisbane Lions",22
10155,1991-04-20,"R5","Fitzroy",12,17,89,"Richmond",16,17,113,"Princes Park",-24,1991,"Regular",5,"Away","Richmond","Fitzroy",24
10156,1991-04-20,"R5","Footscray",17,16,118,"Hawthorn",16,11,107,"Waverley Park",11,1991,"Regular",5,"Home","Footscray","Hawthorn",11
10157,1991-04-20,"R5","Melbourne",28,14,182,"North Melbourne",17,10,112,"M.C.G.",70,1991,"Regular",5,"Home","Melbourne","North Melbourne",70
10158,1991-04-21,"R5","West Coast",19,16,130,"Adelaide",9,11,65,"Subiaco",65,1991,"Regular",5,"Home","West Coast","Adelaide",65
10159,1991-04-21,"R5","Geelong",13,17,95,"Carlton",8,10,58,"Kardinia Park",37,1991,"Regular",5,"Home","Geelong","Carlton",37
10160,1991-04-25,"R6","Collingwood",10,17,77,"Melbourne",17,11,113,"Waverley Park",-36,1991,"Regular",6,"Away","Melbourne","Collingwood",36
10161,1991-04-25,"R6","North Melbourne",27,26,188,"Sydney",21,8,134,"M.C.G.",54,1991,"Regular",6,"Home","North Melbourne","Sydney",54
10162,1991-04-27,"R6","Carlton",13,16,94,"St Kilda",7,18,60,"Princes Park",34,1991,"Regular",6,"Home","Carlton","St Kilda",34
10163,1991-04-27,"R6","Geelong",13,11,89,"West Coast",19,20,134,"Waverley Park",-45,1991,"Regular",6,"Away","West Coast","Geelong",45
10164,1991-04-27,"R6","Brisbane Lions",12,11,83,"Essendon",16,18,114,"Carrara",-31,1991,"Regular",6,"Away","Essendon","Brisbane Lions",31
10165,1991-04-28,"R6","Fitzroy",11,8,74,"Hawthorn",36,15,231,"North Hobart",-157,1991,"Regular",6,"Away","Hawthorn","Fitzroy",157
10166,1991-04-28,"R6","Adelaide",19,14,128,"Footscray",14,13,97,"Football Park",31,1991,"Regular",6,"Home","Adelaide","Footscray",31
10167,1991-05-03,"R7","North Melbourne",21,15,141,"Fitzroy",14,13,97,"M.C.G.",44,1991,"Regular",7,"Home","North Melbourne","Fitzroy",44
10168,1991-05-04,"R7","St Kilda",24,18,162,"Adelaide",4,7,31,"Moorabbin Oval",131,1991,"Regular",7,"Home","St Kilda","Adelaide",131
10169,1991-05-04,"R7","Melbourne",18,18,126,"Brisbane Lions",17,11,113,"M.C.G.",13,1991,"Regular",7,"Home","Melbourne","Brisbane Lions",13
10170,1991-05-04,"R7","Essendon",17,13,115,"Carlton",13,16,94,"Waverley Park",21,1991,"Regular",7,"Home","Essendon","Carlton",21
10171,1991-05-04,"R7","Hawthorn",8,14,62,"West Coast",21,18,144,"Princes Park",-82,1991,"Regular",7,"Away","West Coast","Hawthorn",82
10172,1991-05-05,"R7","Footscray",20,13,133,"Richmond",14,17,101,"Western Oval",32,1991,"Regular",7,"Home","Footscray","Richmond",32
10173,1991-05-05,"R7","Sydney",20,24,144,"Geelong",14,14,98,"S.C.G.",46,1991,"Regular",7,"Home","Sydney","Geelong",46
10174,1991-05-11,"R8","Hawthorn",18,14,122,"Carlton",11,12,78,"Waverley Park",44,1991,"Regular",8,"Home","Hawthorn","Carlton",44
10175,1991-05-11,"R8","Essendon",13,9,87,"West Coast",14,10,94,"Windy Hill",-7,1991,"Regular",8,"Away","West Coast","Essendon",7
10176,1991-05-11,"R8","Fitzroy",10,10,70,"Sydney",21,21,147,"Princes Park",-77,1991,"Regular",8,"Away","Sydney","Fitzroy",77
10177,1991-05-11,"R8","Melbourne",17,19,121,"Footscray",12,10,82,"M.C.G.",39,1991,"Regular",8,"Home","Melbourne","Footscray",39
10178,1991-05-11,"R8","Geelong",17,17,119,"North Melbourne",22,18,150,"Kardinia Park",-31,1991,"Regular",8,"Away","North Melbourne","Geelong",31
10179,1991-05-12,"R8","Brisbane Lions",12,7,79,"St Kilda",21,22,148,"Gabba",-69,1991,"Regular",8,"Away","St Kilda","Brisbane Lions",69
10180,1991-05-12,"R8","Richmond",24,15,159,"Collingwood",15,12,102,"M.C.G.",57,1991,"Regular",8,"Home","Richmond","Collingwood",57
10181,1991-05-17,"R9","North Melbourne",18,12,120,"Adelaide",18,10,118,"M.C.G.",2,1991,"Regular",9,"Home","North Melbourne","Adelaide",2
10182,1991-05-18,"R9","Footscray",15,11,101,"Brisbane Lions",14,12,96,"Western Oval",5,1991,"Regular",9,"Home","Footscray","Brisbane Lions",5
10183,1991-05-18,"R9","Carlton",13,15,93,"Richmond",12,9,81,"Princes Park",12,1991,"Regular",9,"Home","Carlton","Richmond",12
10184,1991-05-18,"R9","Collingwood",13,12,90,"Geelong",18,24,132,"Victoria Park",-42,1991,"Regular",9,"Away","Geelong","Collingwood",42
10185,1991-05-18,"R9","Hawthorn",15,13,103,"Essendon",13,9,87,"Waverley Park",16,1991,"Regular",9,"Home","Hawthorn","Essendon",16
10186,1991-05-19,"R9","Sydney",16,17,113,"St Kilda",18,11,119,"S.C.G.",-6,1991,"Regular",9,"Away","St Kilda","Sydney",6
10187,1991-05-19,"R9","West Coast",17,23,125,"Fitzroy",3,8,26,"Subiaco",99,1991,"Regular",9,"Home","West Coast","Fitzroy",99
10188,1991-05-24,"R10","Adelaide",15,16,106,"Melbourne",10,12,72,"Football Park",34,1991,"Regular",10,"Home","Adelaide","Melbourne",34
10189,1991-05-25,"R10","Collingwood",16,12,108,"Hawthorn",23,13,151,"Waverley Park",-43,1991,"Regular",10,"Away","Hawthorn","Collingwood",43
10190,1991-05-25,"R10","St Kilda",11,15,81,"Essendon",16,13,109,"Moorabbin Oval",-28,1991,"Regular",10,"Away","Essendon","St Kilda",28
10191,1991-05-25,"R10","Fitzroy",19,13,127,"Geelong",14,22,106,"Princes Park",21,1991,"Regular",10,"Home","Fitzroy","Geelong",21
10192,1991-05-25,"R10","North Melbourne",21,15,141,"Footscray",18,19,127,"M.C.G.",14,1991,"Regular",10,"Home","North Melbourne","Footscray",14
10193,1991-05-26,"R10","Brisbane Lions",10,15,75,"Richmond",12,10,82,"Carrara",-7,1991,"Regular",10,"Away","Richmond","Brisbane Lions",7
10194,1991-05-26,"R10","West Coast",15,16,106,"Sydney",10,12,72,"Subiaco",34,1991,"Regular",10,"Home","West Coast","Sydney",34
10195,1991-06-01,"R11","Geelong",27,15,177,"Adelaide",14,9,93,"Kardinia Park",84,1991,"Regular",11,"Home","Geelong","Adelaide",84
10196,1991-06-01,"R11","North Melbourne",18,22,130,"Collingwood",17,12,114,"M.C.G.",16,1991,"Regular",11,"Home","North Melbourne","Collingwood",16
10197,1991-06-01,"R11","Essendon",12,14,86,"Melbourne",12,8,80,"Windy Hill",6,1991,"Regular",11,"Home","Essendon","Melbourne",6
10198,1991-06-01,"R11","Hawthorn",10,17,77,"St Kilda",15,13,103,"Princes Park",-26,1991,"Regular",11,"Away","St Kilda","Hawthorn",26
10199,1991-06-01,"R11","Richmond",12,8,80,"West Coast",17,15,117,"Waverley Park",-37,1991,"Regular",11,"Away","West Coast","Richmond",37
10200,1991-06-02,"R11","Sydney",18,13,121,"Brisbane Lions",26,12,168,"S.C.G.",-47,1991,"Regular",11,"Away","Brisbane Lions","Sydney",47
10201,1991-06-02,"R11","Footscray",8,9,57,"Carlton",1,10,16,"Western Oval",41,1991,"Regular",11,"Home","Footscray","Carlton",41
10202,1991-06-08,"R12","Carlton",12,10,82,"Collingwood",10,2,62,"Waverley Park",20,1991,"Regular",12,"Home","Carlton","Collingwood",20
10203,1991-06-08,"R12","Footscray",4,11,35,"Sydney",5,5,35,"Western Oval",0,1991,"Regular",12,"Home","Footscray","Sydney",0
10204,1991-06-09,"R12","Brisbane Lions",14,9,93,"West Coast",21,19,145,"Carrara",-52,1991,"Regular",12,"Away","West Coast","Brisbane Lions",52
10205,1991-06-09,"R12","Adelaide",7,8,50,"Fitzroy",7,5,47,"Football Park",3,1991,"Regular",12,"Home","Adelaide","Fitzroy",3
10206,1991-06-10,"R12","Hawthorn",13,18,96,"Geelong",20,16,136,"Princes Park",-40,1991,"Regular",12,"Away","Geelong","Hawthorn",40
10207,1991-06-10,"R12","Melbourne",13,12,90,"Richmond",14,12,96,"M.C.G.",-6,1991,"Regular",12,"Away","Richmond","Melbourne",6
10208,1991-06-10,"R12","St Kilda",15,11,101,"North Melbourne",8,18,66,"Moorabbin Oval",35,1991,"Regular",12,"Home","St Kilda","North Melbourne",35
10209,1991-06-14,"R13","West Coast",25,15,165,"Footscray",7,5,47,"W.A.C.A.",118,1991,"Regular",13,"Home","West Coast","Footscray",118
10210,1991-06-15,"R13","Richmond",6,11,47,"Adelaide",12,13,85,"M.C.G.",-38,1991,"Regular",13,"Away","Adelaide","Richmond",38
10211,1991-06-15,"R13","Hawthorn",22,17,149,"Brisbane Lions",9,8,62,"Princes Park",87,1991,"Regular",13,"Home","Hawthorn","Brisbane Lions",87
10212,1991-06-15,"R13","Essendon",10,14,74,"Collingwood",11,10,76,"Waverley Park",-2,1991,"Regular",13,"Away","Collingwood","Essendon",2
10213,1991-06-16,"R13","Fitzroy",15,8,98,"St Kilda",17,9,111,"North Hobart",-13,1991,"Regular",13,"Away","St Kilda","Fitzroy",13
10214,1991-06-16,"R13","Melbourne",16,8,104,"Geelong",20,14,134,"M.C.G.",-30,1991,"Regular",13,"Away","Geelong","Melbourne",30
10215,1991-06-16,"R13","Sydney",18,16,124,"Carlton",17,8,110,"S.C.G.",14,1991,"Regular",13,"Home","Sydney","Carlton",14
10216,1991-06-21,"R14","Richmond",19,14,128,"North Melbourne",26,16,172,"M.C.G.",-44,1991,"Regular",14,"Away","North Melbourne","Richmond",44
10217,1991-06-22,"R14","Carlton",12,11,83,"West Coast",11,14,80,"Princes Park",3,1991,"Regular",14,"Home","Carlton","West Coast",3
10218,1991-06-22,"R14","Collingwood",20,23,143,"Sydney",6,8,44,"Victoria Park",99,1991,"Regular",14,"Home","Collingwood","Sydney",99
10219,1991-06-22,"R14","Essendon",17,20,122,"Fitzroy",12,11,83,"Windy Hill",39,1991,"Regular",14,"Home","Essendon","Fitzroy",39
10220,1991-06-22,"R14","St Kilda",16,6,102,"Footscray",8,21,69,"Moorabbin Oval",33,1991,"Regular",14,"Home","St Kilda","Footscray",33
10221,1991-06-22,"R14","Melbourne",11,11,77,"Hawthorn",19,13,127,"Waverley Park",-50,1991,"Regular",14,"Away","Hawthorn","Melbourne",50
10222,1991-06-23,"R14","Adelaide",23,18,156,"Brisbane Lions",13,12,90,"Football Park",66,1991,"Regular",14,"Home","Adelaide","Brisbane Lions",66
10223,1991-06-28,"R15","North Melbourne",18,7,115,"Hawthorn",27,17,179,"M.C.G.",-64,1991,"Regular",15,"Away","Hawthorn","North Melbourne",64
10224,1991-06-29,"R15","Collingwood",23,22,160,"Adelaide",5,7,37,"Victoria Park",123,1991,"Regular",15,"Home","Collingwood","Adelaide",123
10225,1991-06-29,"R15","Fitzroy",6,5,41,"Carlton",8,12,60,"Princes Park",-19,1991,"Regular",15,"Away","Carlton","Fitzroy",19
10226,1991-06-29,"R15","Footscray",11,23,89,"Essendon",6,7,43,"Western Oval",46,1991,"Regular",15,"Home","Footscray","Essendon",46
10227,1991-06-29,"R15","Geelong",19,17,131,"Richmond",14,14,98,"Waverley Park",33,1991,"Regular",15,"Home","Geelong","Richmond",33
10228,1991-06-30,"R15","Sydney",14,10,94,"Melbourne",26,21,177,"S.C.G.",-83,1991,"Regular",15,"Away","Melbourne","Sydney",83
10229,1991-06-30,"R15","West Coast",21,11,137,"St Kilda",14,9,93,"Subiaco",44,1991,"Regular",15,"Home","West Coast","St Kilda",44
10230,1991-07-06,"R16","Hawthorn",23,20,158,"Adelaide",14,11,95,"Waverley Park",63,1991,"Regular",16,"Home","Hawthorn","Adelaide",63
10231,1991-07-06,"R16","Carlton",14,5,89,"North Melbourne",13,17,95,"Princes Park",-6,1991,"Regular",16,"Away","North Melbourne","Carlton",6
10232,1991-07-06,"R16","Collingwood",20,13,133,"Footscray",13,2,80,"Victoria Park",53,1991,"Regular",16,"Home","Collingwood","Footscray",53
10233,1991-07-06,"R16","Melbourne",11,10,76,"West Coast",14,16,100,"M.C.G.",-24,1991,"Regular",16,"Away","West Coast","Melbourne",24
10234,1991-07-07,"R16","Brisbane Lions",26,14,170,"Fitzroy",15,15,105,"Gabba",65,1991,"Regular",16,"Home","Brisbane Lions","Fitzroy",65
10235,1991-07-07,"R16","Geelong",13,21,99,"Essendon",10,15,75,"Kardinia Park",24,1991,"Regular",16,"Home","Geelong","Essendon",24
10236,1991-07-07,"R16","Richmond",13,18,96,"St Kilda",18,16,124,"M.C.G.",-28,1991,"Regular",16,"Away","St Kilda","Richmond",28
10237,1991-07-12,"R17","West Coast",20,15,135,"Collingwood",8,6,54,"W.A.C.A.",81,1991,"Regular",17,"Home","West Coast","Collingwood",81
10238,1991-07-13,"R17","Carlton",6,12,48,"Adelaide",7,13,55,"Princes Park",-7,1991,"Regular",17,"Away","Adelaide","Carlton",7
10239,1991-07-13,"R17","North Melbourne",15,13,103,"Brisbane Lions",14,6,90,"Waverley Park",13,1991,"Regular",17,"Home","North Melbourne","Brisbane Lions",13
10240,1991-07-13,"R17","Essendon",6,7,43,"Richmond",7,18,60,"Windy Hill",-17,1991,"Regular",17,"Away","Richmond","Essendon",17
10241,1991-07-13,"R17","Melbourne",12,20,92,"Fitzroy",7,13,55,"M.C.G.",37,1991,"Regular",17,"Home","Melbourne","Fitzroy",37
10242,1991-07-13,"R17","St Kilda",9,13,67,"Geelong",18,8,116,"Moorabbin Oval",-49,1991,"Regular",17,"Away","Geelong","St Kilda",49
10243,1991-07-14,"R17","Sydney",14,19,103,"Hawthorn",15,24,114,"S.C.G.",-11,1991,"Regular",17,"Away","Hawthorn","Sydney",11
10244,1991-07-20,"R18","Fitzroy",15,21,111,"Collingwood",18,16,124,"Princes Park",-13,1991,"Regular",18,"Away","Collingwood","Fitzroy",13
10245,1991-07-20,"R18","Essendon",19,9,123,"North Melbourne",5,19,49,"Windy Hill",74,1991,"Regular",18,"Home","Essendon","North Melbourne",74
10246,1991-07-20,"R18","Richmond",13,10,88,"Hawthorn",13,16,94,"Waverley Park",-6,1991,"Regular",18,"Away","Hawthorn","Richmond",6
10247,1991-07-20,"R18","St Kilda",16,14,110,"Melbourne",17,9,111,"Moorabbin Oval",-1,1991,"Regular",18,"Away","Melbourne","St Kilda",1
10248,1991-07-21,"R18","Brisbane Lions",14,16,100,"Carlton",12,21,93,"Carrara",7,1991,"Regular",18,"Home","Brisbane Lions","Carlton",7
10249,1991-07-21,"R18","Geelong",20,16,136,"Footscray",10,8,68,"Kardinia Park",68,1991,"Regular",18,"Home","Geelong","Footscray",68
10250,1991-07-21,"R18","Adelaide",16,22,118,"Sydney",19,8,122,"Football Park",-4,1991,"Regular",18,"Away","Sydney","Adelaide",4
10251,1991-07-26,"R19","North Melbourne",12,13,85,"West Coast",11,16,82,"M.C.G.",3,1991,"Regular",19,"Home","North Melbourne","West Coast",3
10252,1991-07-27,"R19","Geelong",24,15,159,"Brisbane Lions",8,10,58,"Kardinia Park",101,1991,"Regular",19,"Home","Geelong","Brisbane Lions",101
10253,1991-07-27,"R19","Carlton",10,8,68,"Melbourne",11,14,80,"Princes Park",-12,1991,"Regular",19,"Away","Melbourne","Carlton",12
10254,1991-07-27,"R19","Collingwood",13,7,85,"St Kilda",7,11,53,"Waverley Park",32,1991,"Regular",19,"Home","Collingwood","St Kilda",32
10255,1991-07-27,"R19","Footscray",16,12,108,"Fitzroy",7,9,51,"Western Oval",57,1991,"Regular",19,"Home","Footscray","Fitzroy",57
10256,1991-07-28,"R19","Sydney",14,15,99,"Richmond",12,20,92,"S.C.G.",7,1991,"Regular",19,"Home","Sydney","Richmond",7
10257,1991-07-28,"R19","Adelaide",16,12,108,"Essendon",12,9,81,"Football Park",27,1991,"Regular",19,"Home","Adelaide","Essendon",27
10258,1991-08-03,"R20","Carlton",16,9,105,"Geelong",14,19,103,"Princes Park",2,1991,"Regular",20,"Home","Carlton","Geelong",2
10259,1991-08-03,"R20","Essendon",22,19,151,"Sydney",12,12,84,"Windy Hill",67,1991,"Regular",20,"Home","Essendon","Sydney",67
10260,1991-08-03,"R20","Hawthorn",12,11,83,"Footscray",10,9,69,"Waverley Park",14,1991,"Regular",20,"Home","Hawthorn","Footscray",14
10261,1991-08-03,"R20","North Melbourne",13,10,88,"Melbourne",20,20,140,"M.C.G.",-52,1991,"Regular",20,"Away","Melbourne","North Melbourne",52
10262,1991-08-03,"R20","Brisbane Lions",10,11,71,"Collingwood",26,16,172,"Carrara",-101,1991,"Regular",20,"Away","Collingwood","Brisbane Lions",101
10263,1991-08-04,"R20","Adelaide",11,14,80,"West Coast",14,11,95,"Football Park",-15,1991,"Regular",20,"Away","West Coast","Adelaide",15
10264,1991-08-04,"R20","Richmond",13,19,97,"Fitzroy",23,18,156,"M.C.G.",-59,1991,"Regular",20,"Away","Fitzroy","Richmond",59
10265,1991-08-09,"R21","West Coast",11,16,82,"Geelong",12,9,81,"W.A.C.A.",1,1991,"Regular",21,"Home","West Coast","Geelong",1
10266,1991-08-10,"R21","Footscray",8,16,64,"Adelaide",6,4,40,"Western Oval",24,1991,"Regular",21,"Home","Footscray","Adelaide",24
10267,1991-08-10,"R21","Essendon",23,19,157,"Brisbane Lions",17,10,112,"Windy Hill",45,1991,"Regular",21,"Home","Essendon","Brisbane Lions",45
10268,1991-08-10,"R21","St Kilda",23,17,155,"Carlton",15,11,101,"Waverley Park",54,1991,"Regular",21,"Home","St Kilda","Carlton",54
10269,1991-08-10,"R21","Melbourne",8,7,55,"Collingwood",19,13,127,"M.C.G.",-72,1991,"Regular",21,"Away","Collingwood","Melbourne",72
10270,1991-08-10,"R21","Hawthorn",28,27,195,"Fitzroy",10,9,69,"Princes Park",126,1991,"Regular",21,"Home","Hawthorn","Fitzroy",126
10271,1991-08-11,"R21","Sydney",13,22,100,"North Melbourne",20,16,136,"S.C.G.",-36,1991,"Regular",21,"Away","North Melbourne","Sydney",36
10272,1991-08-16,"R22","Adelaide",12,9,81,"St Kilda",20,12,132,"Football Park",-51,1991,"Regular",22,"Away","St Kilda","Adelaide",51
10273,1991-08-17,"R22","Carlton",12,12,84,"Essendon",13,10,88,"Waverley Park",-4,1991,"Regular",22,"Away","Essendon","Carlton",4
10274,1991-08-17,"R22","Fitzroy",22,16,148,"North Melbourne",21,21,147,"Princes Park",1,1991,"Regular",22,"Home","Fitzroy","North Melbourne",1
10275,1991-08-17,"R22","Richmond",14,11,95,"Footscray",11,12,78,"M.C.G.",17,1991,"Regular",22,"Home","Richmond","Footscray",17
10276,1991-08-17,"R22","Geelong",17,13,115,"Sydney",13,10,88,"Kardinia Park",27,1991,"Regular",22,"Home","Geelong","Sydney",27
10277,1991-08-18,"R22","Brisbane Lions",13,13,91,"Melbourne",15,13,103,"Gabba",-12,1991,"Regular",22,"Away","Melbourne","Brisbane Lions",12
10278,1991-08-18,"R22","West Coast",15,9,99,"Hawthorn",11,9,75,"Subiaco",24,1991,"Regular",22,"Home","West Coast","Hawthorn",24
10279,1991-08-23,"R23","Sydney",21,14,140,"Fitzroy",13,16,94,"S.C.G.",46,1991,"Regular",23,"Home","Sydney","Fitzroy",46
10280,1991-08-24,"R23","St Kilda",27,12,174,"Brisbane Lions",7,12,54,"Moorabbin Oval",120,1991,"Regular",23,"Home","St Kilda","Brisbane Lions",120
10281,1991-08-24,"R23","Carlton",8,10,58,"Hawthorn",23,18,156,"Princes Park",-98,1991,"Regular",23,"Away","Hawthorn","Carlton",98
10282,1991-08-24,"R23","Collingwood",18,18,126,"Richmond",14,9,93,"Victoria Park",33,1991,"Regular",23,"Home","Collingwood","Richmond",33
10283,1991-08-24,"R23","North Melbourne",8,10,58,"Geelong",13,12,90,"Waverley Park",-32,1991,"Regular",23,"Away","Geelong","North Melbourne",32
10284,1991-08-25,"R23","West Coast",16,19,115,"Essendon",7,10,52,"Subiaco",63,1991,"Regular",23,"Home","West Coast","Essendon",63
10285,1991-08-25,"R23","Footscray",6,9,45,"Melbourne",8,8,56,"Western Oval",-11,1991,"Regular",23,"Away","Melbourne","Footscray",11
10286,1991-08-31,"R24","Richmond",20,18,138,"Carlton",18,15,123,"M.C.G.",15,1991,"Regular",24,"Home","Richmond","Carlton",15
10287,1991-08-31,"R24","Geelong",16,11,107,"Collingwood",8,18,66,"Kardinia Park",41,1991,"Regular",24,"Home","Geelong","Collingwood",41
10288,1991-08-31,"R24","Essendon",9,9,63,"Hawthorn",21,17,143,"Waverley Park",-80,1991,"Regular",24,"Away","Hawthorn","Essendon",80
10289,1991-08-31,"R24","Fitzroy",14,15,99,"West Coast",12,17,89,"Princes Park",10,1991,"Regular",24,"Home","Fitzroy","West Coast",10
10290,1991-08-31,"R24","St Kilda",24,14,158,"Sydney",17,17,119,"Moorabbin Oval",39,1991,"Regular",24,"Home","St Kilda","Sydney",39
10291,1991-08-31,"R24","Brisbane Lions",8,14,62,"Footscray",14,14,98,"Carrara",-36,1991,"Regular",24,"Away","Footscray","Brisbane Lions",36
10292,1991-09-01,"R24","Adelaide",28,12,180,"North Melbourne",16,11,107,"Football Park",73,1991,"Regular",24,"Home","Adelaide","North Melbourne",73
10293,1991-09-07,"EF","Melbourne",17,11,113,"Essendon",11,9,75,"Waverley Park",38,1991,"Finals",25,"Home","Melbourne","Essendon",38
10294,1991-09-08,"EF","Geelong",15,14,104,"St Kilda",14,13,97,"Waverley Park",7,1991,"Finals",25,"Home","Geelong","St Kilda",7
10295,1991-09-08,"QF","West Coast",15,11,101,"Hawthorn",18,16,124,"Subiaco",-23,1991,"Finals",25,"Away","Hawthorn","West Coast",23
10296,1991-09-14,"SF","Hawthorn",13,17,95,"Geelong",13,15,93,"Waverley Park",2,1991,"Finals",26,"Home","Hawthorn","Geelong",2
10297,1991-09-15,"SF","West Coast",17,15,117,"Melbourne",12,7,79,"Waverley Park",38,1991,"Finals",26,"Home","West Coast","Melbourne",38
10298,1991-09-21,"PF","West Coast",11,13,79,"Geelong",8,16,64,"Waverley Park",15,1991,"Finals",27,"Home","West Coast","Geelong",15
10299,1991-09-28,"GF","West Coast",13,8,86,"Hawthorn",20,19,139,"Waverley Park",-53,1991,"Finals",28,"Away","Hawthorn","West Coast",53
10300,1992-03-21,"R1","Hawthorn",21,15,141,"Geelong",18,13,121,"Waverley Park",20,1992,"Regular",1,"Home","Hawthorn","Geelong",20
10301,1992-03-21,"R1","Brisbane Lions",10,8,68,"Carlton",13,14,92,"Carrara",-24,1992,"Regular",1,"Away","Carlton","Brisbane Lions",24
10302,1992-03-22,"R1","Adelaide",12,15,87,"Footscray",17,12,114,"Football Park",-27,1992,"Regular",1,"Away","Footscray","Adelaide",27
10303,1992-03-22,"R1","St Kilda",18,20,128,"Essendon",17,9,111,"Waverley Park",17,1992,"Regular",1,"Home","St Kilda","Essendon",17
10304,1992-03-28,"R2","Collingwood",23,16,154,"Brisbane Lions",13,10,88,"Victoria Park",66,1992,"Regular",2,"Home","Collingwood","Brisbane Lions",66
10305,1992-03-28,"R2","Carlton",17,13,115,"Hawthorn",12,17,89,"Princes Park",26,1992,"Regular",2,"Home","Carlton","Hawthorn",26
10306,1992-03-28,"R2","Melbourne",17,11,113,"Geelong",15,15,105,"M.C.G.",8,1992,"Regular",2,"Home","Melbourne","Geelong",8
10307,1992-03-28,"R2","Richmond",9,11,65,"North Melbourne",19,17,131,"Waverley Park",-66,1992,"Regular",2,"Away","North Melbourne","Richmond",66
10308,1992-03-29,"R2","Essendon",15,8,98,"Fitzroy",22,18,150,"M.C.G.",-52,1992,"Regular",2,"Away","Fitzroy","Essendon",52
10309,1992-03-29,"R2","Footscray",16,12,108,"St Kilda",9,22,76,"Western Oval",32,1992,"Regular",2,"Home","Footscray","St Kilda",32
10310,1992-03-29,"R2","Sydney",14,14,98,"West Coast",14,11,95,"S.C.G.",3,1992,"Regular",2,"Home","Sydney","West Coast",3
10311,1992-04-04,"R3","Melbourne",13,17,95,"Adelaide",15,14,104,"Princes Park",-9,1992,"Regular",3,"Away","Adelaide","Melbourne",9
10312,1992-04-04,"R3","Collingwood",17,14,116,"Sydney",13,19,97,"Victoria Park",19,1992,"Regular",3,"Home","Collingwood","Sydney",19
10313,1992-04-04,"R3","North Melbourne",10,15,75,"Hawthorn",14,17,101,"M.C.G.",-26,1992,"Regular",3,"Away","Hawthorn","North Melbourne",26
10314,1992-04-05,"R3","Brisbane Lions",11,16,82,"Fitzroy",8,10,58,"Carrara",24,1992,"Regular",3,"Home","Brisbane Lions","Fitzroy",24
10315,1992-04-05,"R3","Footscray",9,15,69,"Essendon",13,13,91,"Western Oval",-22,1992,"Regular",3,"Away","Essendon","Footscray",22
10316,1992-04-05,"R3","Geelong",29,24,198,"Richmond",11,6,72,"Kardinia Park",126,1992,"Regular",3,"Home","Geelong","Richmond",126
10317,1992-04-05,"R3","West Coast",16,17,113,"St Kilda",12,8,80,"Subiaco",33,1992,"Regular",3,"Home","West Coast","St Kilda",33
10318,1992-04-10,"R4","North Melbourne",16,14,110,"Carlton",19,11,125,"M.C.G.",-15,1992,"Regular",4,"Away","Carlton","North Melbourne",15
10319,1992-04-11,"R4","Fitzroy",19,16,130,"Adelaide",14,13,97,"Princes Park",33,1992,"Regular",4,"Home","Fitzroy","Adelaide",33
10320,1992-04-11,"R4","Essendon",17,13,115,"Collingwood",19,10,124,"Waverley Park",-9,1992,"Regular",4,"Away","Collingwood","Essendon",9
10321,1992-04-11,"R4","St Kilda",16,12,108,"Hawthorn",14,14,98,"Moorabbin Oval",10,1992,"Regular",4,"Home","St Kilda","Hawthorn",10
10322,1992-04-11,"R4","Richmond",17,17,119,"Melbourne",9,15,69,"M.C.G.",50,1992,"Regular",4,"Home","Richmond","Melbourne",50
10323,1992-04-12,"R4","Sydney",17,17,119,"Footscray",25,15,165,"S.C.G.",-46,1992,"Regular",4,"Away","Footscray","Sydney",46
10324,1992-04-12,"R4","West Coast",15,17,107,"Geelong",20,11,131,"Subiaco",-24,1992,"Regular",4,"Away","Geelong","West Coast",24
10325,1992-04-18,"R5","Carlton",10,13,73,"Sydney",14,10,94,"Princes Park",-21,1992,"Regular",5,"Away","Sydney","Carlton",21
10326,1992-04-18,"R5","Hawthorn",16,18,114,"Essendon",22,9,141,"Waverley Park",-27,1992,"Regular",5,"Away","Essendon","Hawthorn",27
10327,1992-04-18,"R5","North Melbourne",14,17,101,"Footscray",20,20,140,"M.C.G.",-39,1992,"Regular",5,"Away","Footscray","North Melbourne",39
10328,1992-04-18,"R5","Brisbane Lions",14,8,92,"West Coast",13,14,92,"Carrara",0,1992,"Regular",5,"Home","Brisbane Lions","West Coast",0
10329,1992-04-19,"R5","Adelaide",23,13,151,"Richmond",17,15,117,"Football Park",34,1992,"Regular",5,"Home","Adelaide","Richmond",34
10330,1992-04-20,"R5","Melbourne",14,14,98,"Collingwood",19,17,131,"M.C.G.",-33,1992,"Regular",5,"Away","Collingwood","Melbourne",33
10331,1992-04-20,"R5","Fitzroy",16,12,108,"St Kilda",17,26,128,"Princes Park",-20,1992,"Regular",5,"Away","St Kilda","Fitzroy",20
10332,1992-04-24,"R6","Sydney",11,10,76,"North Melbourne",18,17,125,"S.C.G.",-49,1992,"Regular",6,"Away","North Melbourne","Sydney",49
10333,1992-04-25,"R6","Carlton",18,13,121,"St Kilda",17,11,113,"Princes Park",8,1992,"Regular",6,"Home","Carlton","St Kilda",8
10334,1992-04-25,"R6","Collingwood",17,9,111,"Hawthorn",20,15,135,"Waverley Park",-24,1992,"Regular",6,"Away","Hawthorn","Collingwood",24
10335,1992-04-25,"R6","Essendon",18,16,124,"Melbourne",19,9,123,"M.C.G.",1,1992,"Regular",6,"Home","Essendon","Melbourne",1
10336,1992-04-26,"R6","Adelaide",19,20,134,"Brisbane Lions",11,8,74,"Football Park",60,1992,"Regular",6,"Home","Adelaide","Brisbane Lions",60
10337,1992-04-26,"R6","Geelong",25,25,175,"Fitzroy",11,11,77,"Kardinia Park",98,1992,"Regular",6,"Home","Geelong","Fitzroy",98
10338,1992-04-26,"R6","Richmond",14,12,96,"West Coast",14,13,97,"M.C.G.",-1,1992,"Regular",6,"Away","West Coast","Richmond",1
10339,1992-05-02,"R7","St Kilda",21,13,139,"Adelaide",9,11,65,"Moorabbin Oval",74,1992,"Regular",7,"Home","St Kilda","Adelaide",74
10340,1992-05-02,"R7","Collingwood",16,20,116,"North Melbourne",9,12,66,"Victoria Park",50,1992,"Regular",7,"Home","Collingwood","North Melbourne",50
10341,1992-05-02,"R7","Hawthorn",25,22,172,"Richmond",14,9,93,"Waverley Park",79,1992,"Regular",7,"Home","Hawthorn","Richmond",79
10342,1992-05-02,"R7","Melbourne",13,18,96,"Sydney",13,18,96,"M.C.G.",0,1992,"Regular",7,"Home","Melbourne","Sydney",0
10343,1992-05-03,"R7","Fitzroy",15,12,102,"West Coast",11,16,82,"North Hobart",20,1992,"Regular",7,"Home","Fitzroy","West Coast",20
10344,1992-05-03,"R7","Footscray",18,20,128,"Carlton",11,6,72,"M.C.G.",56,1992,"Regular",7,"Home","Footscray","Carlton",56
10345,1992-05-03,"R7","Brisbane Lions",11,9,75,"Geelong",37,17,239,"Carrara",-164,1992,"Regular",7,"Away","Geelong","Brisbane Lions",164
10346,1992-05-07,"R8","Collingwood",9,18,72,"Carlton",16,9,105,"M.C.G.",-33,1992,"Regular",8,"Away","Carlton","Collingwood",33
10347,1992-05-08,"R8","Sydney",19,21,135,"Brisbane Lions",8,13,61,"S.C.G.",74,1992,"Regular",8,"Home","Sydney","Brisbane Lions",74
10348,1992-05-09,"R8","Geelong",32,18,210,"Adelaide",12,15,87,"Kardinia Park",123,1992,"Regular",8,"Home","Geelong","Adelaide",123
10349,1992-05-09,"R8","North Melbourne",19,18,132,"Essendon",11,14,80,"Princes Park",52,1992,"Regular",8,"Home","North Melbourne","Essendon",52
10350,1992-05-09,"R8","Richmond",15,12,102,"Fitzroy",24,17,161,"M.C.G.",-59,1992,"Regular",8,"Away","Fitzroy","Richmond",59
10351,1992-05-09,"R8","St Kilda",18,17,125,"Melbourne",10,5,65,"Waverley Park",60,1992,"Regular",8,"Home","St Kilda","Melbourne",60
10352,1992-05-10,"R8","West Coast",19,19,133,"Footscray",11,8,74,"Subiaco",59,1992,"Regular",8,"Home","West Coast","Footscray",59
10353,1992-05-15,"R9","North Melbourne",9,12,66,"Fitzroy",15,15,105,"M.C.G.",-39,1992,"Regular",9,"Away","Fitzroy","North Melbourne",39
10354,1992-05-16,"R9","Carlton",11,16,82,"West Coast",15,16,106,"Princes Park",-24,1992,"Regular",9,"Away","West Coast","Carlton",24
10355,1992-05-16,"R9","Essendon",17,22,124,"Geelong",28,13,181,"M.C.G.",-57,1992,"Regular",9,"Away","Geelong","Essendon",57
10356,1992-05-16,"R9","Hawthorn",18,12,120,"Melbourne",7,6,48,"Waverley Park",72,1992,"Regular",9,"Home","Hawthorn","Melbourne",72
10357,1992-05-17,"R9","Brisbane Lions",6,6,42,"Footscray",11,18,84,"Carrara",-42,1992,"Regular",9,"Away","Footscray","Brisbane Lions",42
10358,1992-05-17,"R9","Richmond",19,20,134,"Sydney",14,18,102,"M.C.G.",32,1992,"Regular",9,"Home","Richmond","Sydney",32
10359,1992-05-17,"R9","Adelaide",9,10,64,"Collingwood",9,15,69,"Football Park",-5,1992,"Regular",9,"Away","Collingwood","Adelaide",5
10360,1992-05-22,"R10","West Coast",17,16,118,"Adelaide",11,12,78,"W.A.C.A.",40,1992,"Regular",10,"Home","West Coast","Adelaide",40
10361,1992-05-23,"R10","St Kilda",25,18,168,"Brisbane Lions",9,6,60,"Moorabbin Oval",108,1992,"Regular",10,"Home","St Kilda","Brisbane Lions",108
10362,1992-05-23,"R10","Carlton",18,8,116,"Essendon",7,22,64,"Princes Park",52,1992,"Regular",10,"Home","Carlton","Essendon",52
10363,1992-05-23,"R10","Geelong",9,12,66,"Collingwood",12,9,81,"Waverley Park",-15,1992,"Regular",10,"Away","Collingwood","Geelong",15
10364,1992-05-23,"R10","Footscray",16,11,107,"Richmond",13,12,90,"Western Oval",17,1992,"Regular",10,"Home","Footscray","Richmond",17
10365,1992-05-23,"R10","Melbourne",21,14,140,"North Melbourne",16,8,104,"M.C.G.",36,1992,"Regular",10,"Home","Melbourne","North Melbourne",36
10366,1992-05-24,"R10","Sydney",12,13,85,"Hawthorn",21,20,146,"S.C.G.",-61,1992,"Regular",10,"Away","Hawthorn","Sydney",61
10367,1992-05-30,"R11","Richmond",22,10,142,"Brisbane Lions",11,17,83,"M.C.G.",59,1992,"Regular",11,"Home","Richmond","Brisbane Lions",59
10368,1992-05-30,"R11","Melbourne",10,5,65,"Carlton",14,15,99,"Waverley Park",-34,1992,"Regular",11,"Away","Carlton","Melbourne",34
10369,1992-05-30,"R11","Fitzroy",13,14,92,"Collingwood",13,11,89,"Princes Park",3,1992,"Regular",11,"Home","Fitzroy","Collingwood",3
10370,1992-05-30,"R11","Geelong",19,15,129,"St Kilda",18,18,126,"Kardinia Park",3,1992,"Regular",11,"Home","Geelong","St Kilda",3
10371,1992-05-31,"R11","Adelaide",21,16,142,"North Melbourne",16,11,107,"Football Park",35,1992,"Regular",11,"Home","Adelaide","North Melbourne",35
10372,1992-05-31,"R11","Essendon",16,20,116,"Sydney",10,13,73,"M.C.G.",43,1992,"Regular",11,"Home","Essendon","Sydney",43
10373,1992-05-31,"R11","Footscray",16,13,109,"Hawthorn",11,9,75,"Western Oval",34,1992,"Regular",11,"Home","Footscray","Hawthorn",34
10374,1992-06-05,"R12","North Melbourne",10,6,66,"West Coast",14,26,110,"M.C.G.",-44,1992,"Regular",12,"Away","West Coast","North Melbourne",44
10375,1992-06-06,"R12","Essendon",19,16,130,"Richmond",11,13,79,"M.C.G.",51,1992,"Regular",12,"Home","Essendon","Richmond",51
10376,1992-06-06,"R12","Fitzroy",11,18,84,"Footscray",22,14,146,"Princes Park",-62,1992,"Regular",12,"Away","Footscray","Fitzroy",62
10377,1992-06-07,"R12","Brisbane Lions",16,7,103,"Melbourne",11,11,77,"Carrara",26,1992,"Regular",12,"Home","Brisbane Lions","Melbourne",26
10378,1992-06-07,"R12","Carlton",13,12,90,"Geelong",16,22,118,"M.C.G.",-28,1992,"Regular",12,"Away","Geelong","Carlton",28
10379,1992-06-08,"R12","Hawthorn",15,12,102,"Adelaide",15,13,103,"Waverley Park",-1,1992,"Regular",12,"Away","Adelaide","Hawthorn",1
10380,1992-06-08,"R12","Collingwood",11,10,76,"St Kilda",10,17,77,"M.C.G.",-1,1992,"Regular",12,"Away","St Kilda","Collingwood",1
10381,1992-06-13,"R13","Carlton",17,13,115,"Adelaide",13,14,92,"Princes Park",23,1992,"Regular",13,"Home","Carlton","Adelaide",23
10382,1992-06-13,"R13","Hawthorn",22,13,145,"Fitzroy",13,11,89,"Waverley Park",56,1992,"Regular",13,"Home","Hawthorn","Fitzroy",56
10383,1992-06-13,"R13","North Melbourne",17,13,115,"Geelong",29,18,192,"M.C.G.",-77,1992,"Regular",13,"Away","Geelong","North Melbourne",77
10384,1992-06-13,"R13","St Kilda",24,13,157,"Sydney",15,14,104,"Moorabbin Oval",53,1992,"Regular",13,"Home","St Kilda","Sydney",53
10385,1992-06-14,"R13","Brisbane Lions",12,13,85,"Essendon",18,11,119,"Carrara",-34,1992,"Regular",13,"Away","Essendon","Brisbane Lions",34
10386,1992-06-14,"R13","Footscray",25,11,161,"Melbourne",8,6,54,"Western Oval",107,1992,"Regular",13,"Home","Footscray","Melbourne",107
10387,1992-06-14,"R13","West Coast",8,14,62,"Collingwood",8,15,63,"Subiaco",-1,1992,"Regular",13,"Away","Collingwood","West Coast",1
10388,1992-06-19,"R14","North Melbourne",20,17,137,"Brisbane Lions",16,6,102,"M.C.G.",35,1992,"Regular",14,"Home","North Melbourne","Brisbane Lions",35
10389,1992-06-20,"R14","Fitzroy",20,13,133,"Carlton",17,12,114,"Princes Park",19,1992,"Regular",14,"Home","Fitzroy","Carlton",19
10390,1992-06-20,"R14","Hawthorn",8,12,60,"West Coast",11,8,74,"Waverley Park",-14,1992,"Regular",14,"Away","West Coast","Hawthorn",14
10391,1992-06-20,"R14","Richmond",15,18,108,"St Kilda",24,13,157,"M.C.G.",-49,1992,"Regular",14,"Away","St Kilda","Richmond",49
10392,1992-06-21,"R14","Collingwood",11,16,82,"Footscray",11,10,76,"M.C.G.",6,1992,"Regular",14,"Home","Collingwood","Footscray",6
10393,1992-06-21,"R14","Sydney",11,17,83,"Geelong",24,14,158,"S.C.G.",-75,1992,"Regular",14,"Away","Geelong","Sydney",75
10394,1992-06-21,"R14","Adelaide",14,8,92,"Essendon",21,10,136,"Football Park",-44,1992,"Regular",14,"Away","Essendon","Adelaide",44
10395,1992-06-26,"R15","Adelaide",22,17,149,"Sydney",13,4,82,"Football Park",67,1992,"Regular",15,"Home","Adelaide","Sydney",67
10396,1992-06-27,"R15","Richmond",19,9,123,"Carlton",17,18,120,"Waverley Park",3,1992,"Regular",15,"Home","Richmond","Carlton",3
10397,1992-06-27,"R15","Essendon",9,8,62,"West Coast",20,17,137,"M.C.G.",-75,1992,"Regular",15,"Away","West Coast","Essendon",75
10398,1992-06-27,"R15","St Kilda",18,9,117,"North Melbourne",16,13,109,"Moorabbin Oval",8,1992,"Regular",15,"Home","St Kilda","North Melbourne",8
10399,1992-06-28,"R15","Brisbane Lions",15,14,104,"Hawthorn",16,12,108,"Carrara",-4,1992,"Regular",15,"Away","Hawthorn","Brisbane Lions",4
10400,1992-06-28,"R15","Melbourne",16,13,109,"Fitzroy",13,9,87,"M.C.G.",22,1992,"Regular",15,"Home","Melbourne","Fitzroy",22
10401,1992-06-28,"R15","Geelong",14,18,102,"Footscray",14,9,93,"Kardinia Park",9,1992,"Regular",15,"Home","Geelong","Footscray",9
10402,1992-07-03,"R16","West Coast",15,19,109,"Melbourne",13,9,87,"W.A.C.A.",22,1992,"Regular",16,"Home","West Coast","Melbourne",22
10403,1992-07-04,"R16","Footscray",22,11,143,"Adelaide",8,8,56,"Waverley Park",87,1992,"Regular",16,"Home","Footscray","Adelaide",87
10404,1992-07-04,"R16","Carlton",27,17,179,"Brisbane Lions",12,8,80,"Princes Park",99,1992,"Regular",16,"Home","Carlton","Brisbane Lions",99
10405,1992-07-04,"R16","Collingwood",24,17,161,"Richmond",14,14,98,"Victoria Park",63,1992,"Regular",16,"Home","Collingwood","Richmond",63
10406,1992-07-04,"R16","Essendon",16,15,111,"St Kilda",11,17,83,"M.C.G.",28,1992,"Regular",16,"Home","Essendon","St Kilda",28
10407,1992-07-04,"R16","Geelong",14,11,95,"Hawthorn",16,18,114,"Kardinia Park",-19,1992,"Regular",16,"Away","Hawthorn","Geelong",19
10408,1992-07-05,"R16","Sydney",11,17,83,"Fitzroy",21,10,136,"S.C.G.",-53,1992,"Regular",16,"Away","Fitzroy","Sydney",53
10409,1992-07-11,"R17","Hawthorn",7,12,54,"Carlton",9,12,66,"Waverley Park",-12,1992,"Regular",17,"Away","Carlton","Hawthorn",12
10410,1992-07-11,"R17","St Kilda",11,18,84,"Footscray",15,7,97,"Moorabbin Oval",-13,1992,"Regular",17,"Away","Footscray","St Kilda",13
10411,1992-07-11,"R17","Geelong",21,10,136,"Melbourne",8,15,63,"Kardinia Park",73,1992,"Regular",17,"Home","Geelong","Melbourne",73
10412,1992-07-11,"R17","North Melbourne",18,11,119,"Richmond",17,16,118,"Princes Park",1,1992,"Regular",17,"Home","North Melbourne","Richmond",1
10413,1992-07-11,"R17","Brisbane Lions",9,10,64,"Collingwood",14,19,103,"Carrara",-39,1992,"Regular",17,"Away","Collingwood","Brisbane Lions",39
10414,1992-07-12,"R17","Fitzroy",10,17,77,"Essendon",11,14,80,"North Hobart",-3,1992,"Regular",17,"Away","Essendon","Fitzroy",3
10415,1992-07-12,"R17","West Coast",16,11,107,"Sydney",8,6,54,"Subiaco",53,1992,"Regular",17,"Home","West Coast","Sydney",53
10416,1992-07-17,"R18","Sydney",14,12,96,"Collingwood",17,12,114,"S.C.G.",-18,1992,"Regular",18,"Away","Collingwood","Sydney",18
10417,1992-07-18,"R18","Fitzroy",10,13,73,"Brisbane Lions",16,18,114,"Princes Park",-41,1992,"Regular",18,"Away","Brisbane Lions","Fitzroy",41
10418,1992-07-18,"R18","Essendon",13,15,93,"Footscray",10,17,77,"M.C.G.",16,1992,"Regular",18,"Home","Essendon","Footscray",16
10419,1992-07-18,"R18","Hawthorn",20,13,133,"North Melbourne",14,12,96,"Waverley Park",37,1992,"Regular",18,"Home","Hawthorn","North Melbourne",37
10420,1992-07-19,"R18","Adelaide",9,13,67,"Melbourne",18,8,116,"Football Park",-49,1992,"Regular",18,"Away","Melbourne","Adelaide",49
10421,1992-07-19,"R18","Richmond",12,11,83,"Geelong",24,21,165,"M.C.G.",-82,1992,"Regular",18,"Away","Geelong","Richmond",82
10422,1992-07-19,"R18","St Kilda",15,5,95,"West Coast",3,11,29,"Waverley Park",66,1992,"Regular",18,"Home","St Kilda","West Coast",66
10423,1992-07-24,"R19","Collingwood",10,23,83,"Essendon",8,13,61,"M.C.G.",22,1992,"Regular",19,"Home","Collingwood","Essendon",22
10424,1992-07-25,"R19","Carlton",15,18,108,"North Melbourne",15,11,101,"Princes Park",7,1992,"Regular",19,"Home","Carlton","North Melbourne",7
10425,1992-07-25,"R19","Footscray",15,13,103,"Sydney",8,9,57,"Western Oval",46,1992,"Regular",19,"Home","Footscray","Sydney",46
10426,1992-07-25,"R19","Geelong",12,5,77,"West Coast",15,6,96,"Kardinia Park",-19,1992,"Regular",19,"Away","West Coast","Geelong",19
10427,1992-07-25,"R19","Hawthorn",7,13,55,"St Kilda",19,16,130,"Waverley Park",-75,1992,"Regular",19,"Away","St Kilda","Hawthorn",75
10428,1992-07-25,"R19","Melbourne",23,12,150,"Richmond",10,15,75,"M.C.G.",75,1992,"Regular",19,"Home","Melbourne","Richmond",75
10429,1992-07-25,"R19","Adelaide",21,6,132,"Fitzroy",7,5,47,"Football Park",85,1992,"Regular",19,"Home","Adelaide","Fitzroy",85
10430,1992-07-31,"R20","West Coast",29,12,186,"Brisbane Lions",8,7,55,"W.A.C.A.",131,1992,"Regular",20,"Home","West Coast","Brisbane Lions",131
10431,1992-08-01,"R20","Collingwood",14,16,100,"Melbourne",16,13,109,"Victoria Park",-9,1992,"Regular",20,"Away","Melbourne","Collingwood",9
10432,1992-08-01,"R20","Essendon",8,8,56,"Hawthorn",32,24,216,"M.C.G.",-160,1992,"Regular",20,"Away","Hawthorn","Essendon",160
10433,1992-08-01,"R20","St Kilda",14,18,102,"Fitzroy",10,24,84,"Moorabbin Oval",18,1992,"Regular",20,"Home","St Kilda","Fitzroy",18
10434,1992-08-01,"R20","Footscray",24,8,152,"North Melbourne",16,9,105,"Waverley Park",47,1992,"Regular",20,"Home","Footscray","North Melbourne",47
10435,1992-08-02,"R20","Sydney",20,10,130,"Carlton",21,13,139,"S.C.G.",-9,1992,"Regular",20,"Away","Carlton","Sydney",9
10436,1992-08-02,"R20","Richmond",7,11,53,"Adelaide",24,19,163,"M.C.G.",-110,1992,"Regular",20,"Away","Adelaide","Richmond",110
10437,1992-08-07,"R21","North Melbourne",15,21,111,"Sydney",11,14,80,"M.C.G.",31,1992,"Regular",21,"Home","North Melbourne","Sydney",31
10438,1992-08-08,"R21","Hawthorn",11,16,82,"Collingwood",8,15,63,"Waverley Park",19,1992,"Regular",21,"Home","Hawthorn","Collingwood",19
10439,1992-08-08,"R21","Melbourne",13,16,94,"Essendon",19,12,126,"M.C.G.",-32,1992,"Regular",21,"Away","Essendon","Melbourne",32
10440,1992-08-08,"R21","Fitzroy",10,8,68,"Geelong",17,18,120,"Princes Park",-52,1992,"Regular",21,"Away","Geelong","Fitzroy",52
10441,1992-08-09,"R21","West Coast",15,14,104,"Richmond",12,12,84,"Subiaco",20,1992,"Regular",21,"Home","West Coast","Richmond",20
10442,1992-08-09,"R21","Brisbane Lions",11,11,77,"Adelaide",17,8,110,"Carrara",-33,1992,"Regular",21,"Away","Adelaide","Brisbane Lions",33
10443,1992-08-09,"R21","St Kilda",12,15,87,"Carlton",18,14,122,"Waverley Park",-35,1992,"Regular",21,"Away","Carlton","St Kilda",35
10444,1992-08-14,"R22","West Coast",14,22,106,"Fitzroy",10,16,76,"W.A.C.A.",30,1992,"Regular",22,"Home","West Coast","Fitzroy",30
10445,1992-08-15,"R22","Geelong",23,13,151,"Brisbane Lions",9,4,58,"Kardinia Park",93,1992,"Regular",22,"Home","Geelong","Brisbane Lions",93
10446,1992-08-15,"R22","Carlton",19,22,136,"Footscray",7,12,54,"Princes Park",82,1992,"Regular",22,"Home","Carlton","Footscray",82
10447,1992-08-15,"R22","Richmond",13,8,86,"Hawthorn",25,20,170,"M.C.G.",-84,1992,"Regular",22,"Away","Hawthorn","Richmond",84
10448,1992-08-16,"R22","North Melbourne",14,8,92,"Collingwood",14,14,98,"M.C.G.",-6,1992,"Regular",22,"Away","Collingwood","North Melbourne",6
10449,1992-08-16,"R22","Sydney",13,10,88,"Melbourne",21,13,139,"S.C.G.",-51,1992,"Regular",22,"Away","Melbourne","Sydney",51
10450,1992-08-16,"R22","Adelaide",13,15,93,"St Kilda",10,17,77,"Football Park",16,1992,"Regular",22,"Home","Adelaide","St Kilda",16
10451,1992-08-22,"R23","Carlton",12,14,86,"Collingwood",15,12,102,"Waverley Park",-16,1992,"Regular",23,"Away","Collingwood","Carlton",16
10452,1992-08-22,"R23","Essendon",20,19,139,"North Melbourne",10,11,71,"M.C.G.",68,1992,"Regular",23,"Home","Essendon","North Melbourne",68
10453,1992-08-22,"R23","Fitzroy",20,13,133,"Richmond",14,14,98,"Princes Park",35,1992,"Regular",23,"Home","Fitzroy","Richmond",35
10454,1992-08-22,"R23","Brisbane Lions",19,15,129,"Sydney",9,16,70,"Carrara",59,1992,"Regular",23,"Home","Brisbane Lions","Sydney",59
10455,1992-08-23,"R23","Adelaide",24,25,169,"Geelong",11,12,78,"Football Park",91,1992,"Regular",23,"Home","Adelaide","Geelong",91
10456,1992-08-23,"R23","Footscray",7,11,53,"West Coast",3,5,23,"Western Oval",30,1992,"Regular",23,"Home","Footscray","West Coast",30
10457,1992-08-23,"R23","Melbourne",6,7,43,"St Kilda",8,10,58,"M.C.G.",-15,1992,"Regular",23,"Away","St Kilda","Melbourne",15
10458,1992-08-28,"R24","Sydney",13,17,95,"Richmond",18,17,125,"S.C.G.",-30,1992,"Regular",24,"Away","Richmond","Sydney",30
10459,1992-08-29,"R24","Collingwood",13,9,87,"Adelaide",11,16,82,"Victoria Park",5,1992,"Regular",24,"Home","Collingwood","Adelaide",5
10460,1992-08-29,"R24","Footscray",19,17,131,"Brisbane Lions",11,8,74,"Western Oval",57,1992,"Regular",24,"Home","Footscray","Brisbane Lions",57
10461,1992-08-29,"R24","Geelong",16,14,110,"Essendon",9,10,64,"Waverley Park",46,1992,"Regular",24,"Home","Geelong","Essendon",46
10462,1992-08-29,"R24","Fitzroy",14,12,96,"North Melbourne",19,16,130,"Princes Park",-34,1992,"Regular",24,"Away","North Melbourne","Fitzroy",34
10463,1992-08-29,"R24","Melbourne",20,10,130,"Hawthorn",22,17,149,"M.C.G.",-19,1992,"Regular",24,"Away","Hawthorn","Melbourne",19
10464,1992-08-30,"R24","West Coast",18,12,120,"Carlton",12,15,87,"Subiaco",33,1992,"Regular",24,"Home","West Coast","Carlton",33
10465,1992-09-05,"EF","Collingwood",12,11,83,"St Kilda",13,13,91,"Waverley Park",-8,1992,"Finals",25,"Away","St Kilda","Collingwood",8
10466,1992-09-06,"QF","Geelong",26,16,172,"Footscray",17,9,111,"M.C.G.",61,1992,"Finals",25,"Home","Geelong","Footscray",61
10467,1992-09-06,"EF","West Coast",14,16,100,"Hawthorn",12,15,87,"Subiaco",13,1992,"Finals",25,"Home","West Coast","Hawthorn",13
10468,1992-09-12,"SF","Footscray",19,5,119,"St Kilda",14,6,90,"Waverley Park",29,1992,"Finals",26,"Home","Footscray","St Kilda",29
10469,1992-09-13,"SF","Geelong",14,11,95,"West Coast",20,13,133,"M.C.G.",-38,1992,"Finals",26,"Away","West Coast","Geelong",38
10470,1992-09-19,"PF","Geelong",22,17,149,"Footscray",12,13,85,"M.C.G.",64,1992,"Finals",27,"Home","Geelong","Footscray",64
10471,1992-09-26,"GF","Geelong",12,13,85,"West Coast",16,17,113,"M.C.G.",-28,1992,"Finals",28,"Away","West Coast","Geelong",28
10472,1993-03-26,"R1","Footscray",13,17,95,"Collingwood",17,13,115,"M.C.G.",-20,1993,"Regular",1,"Away","Collingwood","Footscray",20
10473,1993-03-27,"R1","North Melbourne",24,22,166,"Brisbane Lions",22,11,143,"M.C.G.",23,1993,"Regular",1,"Home","North Melbourne","Brisbane Lions",23
10474,1993-03-27,"R1","Carlton",17,10,112,"Fitzroy",17,16,118,"Princes Park",-6,1993,"Regular",1,"Away","Fitzroy","Carlton",6
10475,1993-03-27,"R1","Hawthorn",13,15,93,"Melbourne",11,4,70,"Waverley Park",23,1993,"Regular",1,"Home","Hawthorn","Melbourne",23
10476,1993-03-27,"R1","Geelong",20,16,136,"St Kilda",16,16,112,"Kardinia Park",24,1993,"Regular",1,"Home","Geelong","St Kilda",24
10477,1993-03-28,"R1","Richmond",12,12,84,"Adelaide",28,10,178,"M.C.G.",-94,1993,"Regular",1,"Away","Adelaide","Richmond",94
10478,1993-03-28,"R1","West Coast",17,21,123,"Essendon",17,8,110,"Subiaco",13,1993,"Regular",1,"Home","West Coast","Essendon",13
10479,1993-04-02,"R2","Richmond",18,18,126,"Brisbane Lions",11,14,80,"M.C.G.",46,1993,"Regular",2,"Home","Richmond","Brisbane Lions",46
10480,1993-04-03,"R2","Essendon",20,12,132,"Carlton",19,18,132,"M.C.G.",0,1993,"Regular",2,"Home","Essendon","Carlton",0
10481,1993-04-03,"R2","Melbourne",13,17,95,"Footscray",15,13,103,"Princes Park",-8,1993,"Regular",2,"Away","Footscray","Melbourne",8
10482,1993-04-03,"R2","St Kilda",19,18,132,"North Melbourne",19,11,125,"Waverley Park",7,1993,"Regular",2,"Home","St Kilda","North Melbourne",7
10483,1993-04-03,"R2","Collingwood",17,11,113,"Geelong",15,13,103,"Victoria Park",10,1993,"Regular",2,"Home","Collingwood","Geelong",10
10484,1993-04-04,"R2","Sydney",12,20,92,"Hawthorn",22,17,149,"S.C.G.",-57,1993,"Regular",2,"Away","Hawthorn","Sydney",57
10485,1993-04-04,"R2","Adelaide",15,11,101,"West Coast",12,14,86,"Football Park",15,1993,"Regular",2,"Home","Adelaide","West Coast",15
10486,1993-04-10,"R3","Fitzroy",14,14,98,"Footscray",14,17,101,"Princes Park",-3,1993,"Regular",3,"Away","Footscray","Fitzroy",3
10487,1993-04-10,"R3","St Kilda",20,12,132,"Sydney",13,16,94,"Waverley Park",38,1993,"Regular",3,"Home","St Kilda","Sydney",38
10488,1993-04-11,"R3","Brisbane Lions",17,13,115,"Melbourne",17,11,113,"Gabba",2,1993,"Regular",3,"Home","Brisbane Lions","Melbourne",2
10489,1993-04-11,"R3","West Coast",15,19,109,"Richmond",9,11,65,"Subiaco",44,1993,"Regular",3,"Home","West Coast","Richmond",44
10490,1993-04-12,"R3","Carlton",16,16,112,"Hawthorn",16,14,110,"Princes Park",2,1993,"Regular",3,"Home","Carlton","Hawthorn",2
10491,1993-04-12,"R3","Geelong",13,6,84,"North Melbourne",15,18,108,"Kardinia Park",-24,1993,"Regular",3,"Away","North Melbourne","Geelong",24
10492,1993-04-12,"R3","Essendon",16,13,109,"Collingwood",21,13,139,"M.C.G.",-30,1993,"Regular",3,"Away","Collingwood","Essendon",30
10493,1993-04-16,"R4","Adelaide",15,13,103,"Fitzroy",15,12,102,"Football Park",1,1993,"Regular",4,"Home","Adelaide","Fitzroy",1
10494,1993-04-17,"R4","Hawthorn",11,13,79,"Geelong",18,17,125,"Waverley Park",-46,1993,"Regular",4,"Away","Geelong","Hawthorn",46
10495,1993-04-17,"R4","North Melbourne",19,14,128,"Melbourne",14,15,99,"M.C.G.",29,1993,"Regular",4,"Home","North Melbourne","Melbourne",29
10496,1993-04-17,"R4","Collingwood",15,14,104,"St Kilda",18,18,126,"Victoria Park",-22,1993,"Regular",4,"Away","St Kilda","Collingwood",22
10497,1993-04-18,"R4","Sydney",14,11,95,"Essendon",28,13,181,"S.C.G.",-86,1993,"Regular",4,"Away","Essendon","Sydney",86
10498,1993-04-18,"R4","West Coast",14,14,98,"Brisbane Lions",6,10,46,"Subiaco",52,1993,"Regular",4,"Home","West Coast","Brisbane Lions",52
10499,1993-04-23,"R5","Richmond",17,20,122,"North Melbourne",25,9,159,"M.C.G.",-37,1993,"Regular",5,"Away","North Melbourne","Richmond",37
10500,1993-04-24,"R5","Footscray",20,7,127,"Essendon",11,15,81,"Western Oval",46,1993,"Regular",5,"Home","Footscray","Essendon",46
10501,1993-04-24,"R5","Fitzroy",24,23,167,"Sydney",11,8,74,"Princes Park",93,1993,"Regular",5,"Home","Fitzroy","Sydney",93
10502,1993-04-25,"R5","St Kilda",11,12,78,"Carlton",17,21,123,"Waverley Park",-45,1993,"Regular",5,"Away","Carlton","St Kilda",45
10503,1993-04-25,"R5","Melbourne",10,17,77,"Adelaide",9,14,68,"M.C.G.",9,1993,"Regular",5,"Home","Melbourne","Adelaide",9
10504,1993-04-25,"R5","Brisbane Lions",19,12,126,"Geelong",18,19,127,"Gabba",-1,1993,"Regular",5,"Away","Geelong","Brisbane Lions",1
10505,1993-04-30,"R6","Melbourne",22,21,153,"Richmond",8,12,60,"M.C.G.",93,1993,"Regular",6,"Home","Melbourne","Richmond",93
10506,1993-04-30,"R6","Adelaide",12,16,88,"Hawthorn",16,9,105,"Football Park",-17,1993,"Regular",6,"Away","Hawthorn","Adelaide",17
10507,1993-05-01,"R6","Essendon",23,18,156,"Geelong",19,18,132,"M.C.G.",24,1993,"Regular",6,"Home","Essendon","Geelong",24
10508,1993-05-01,"R6","North Melbourne",35,19,229,"Sydney",16,9,105,"Princes Park",124,1993,"Regular",6,"Home","North Melbourne","Sydney",124
10509,1993-05-02,"R6","Brisbane Lions",17,8,110,"Fitzroy",12,11,83,"Gabba",27,1993,"Regular",6,"Home","Brisbane Lions","Fitzroy",27
10510,1993-05-02,"R6","Carlton",15,11,101,"Collingwood",21,11,137,"M.C.G.",-36,1993,"Regular",6,"Away","Collingwood","Carlton",36
10511,1993-05-02,"R6","West Coast",19,11,125,"Footscray",13,6,84,"Subiaco",41,1993,"Regular",6,"Home","West Coast","Footscray",41
10512,1993-05-08,"R7","Hawthorn",16,17,113,"Brisbane Lions",10,10,70,"Waverley Park",43,1993,"Regular",7,"Home","Hawthorn","Brisbane Lions",43
10513,1993-05-08,"R7","Fitzroy",12,7,79,"Melbourne",11,12,78,"Princes Park",1,1993,"Regular",7,"Home","Fitzroy","Melbourne",1
10514,1993-05-08,"R7","Footscray",17,8,110,"North Melbourne",22,9,141,"Western Oval",-31,1993,"Regular",7,"Away","North Melbourne","Footscray",31
10515,1993-05-08,"R7","Richmond",19,22,136,"St Kilda",16,8,104,"M.C.G.",32,1993,"Regular",7,"Home","Richmond","St Kilda",32
10516,1993-05-08,"R7","Collingwood",14,17,101,"Adelaide",11,10,76,"Victoria Park",25,1993,"Regular",7,"Home","Collingwood","Adelaide",25
10517,1993-05-09,"R7","Geelong",15,15,105,"West Coast",16,17,113,"Kardinia Park",-8,1993,"Regular",7,"Away","West Coast","Geelong",8
10518,1993-05-09,"R7","Sydney",13,17,95,"Carlton",21,13,139,"S.C.G.",-44,1993,"Regular",7,"Away","Carlton","Sydney",44
10519,1993-05-14,"R8","West Coast",7,16,58,"Fitzroy",11,10,76,"W.A.C.A.",-18,1993,"Regular",8,"Away","Fitzroy","West Coast",18
10520,1993-05-15,"R8","Carlton",11,12,78,"Footscray",15,16,106,"Princes Park",-28,1993,"Regular",8,"Away","Footscray","Carlton",28
10521,1993-05-15,"R8","St Kilda",9,13,67,"Essendon",19,11,125,"Waverley Park",-58,1993,"Regular",8,"Away","Essendon","St Kilda",58
10522,1993-05-15,"R8","Collingwood",14,10,94,"Hawthorn",10,16,76,"Victoria Park",18,1993,"Regular",8,"Home","Collingwood","Hawthorn",18
10523,1993-05-16,"R8","Geelong",19,14,128,"Richmond",9,24,78,"Kardinia Park",50,1993,"Regular",8,"Home","Geelong","Richmond",50
10524,1993-05-16,"R8","Brisbane Lions",33,21,219,"Sydney",8,9,57,"Gabba",162,1993,"Regular",8,"Home","Brisbane Lions","Sydney",162
10525,1993-05-16,"R8","Adelaide",19,9,123,"North Melbourne",18,13,121,"Football Park",2,1993,"Regular",8,"Home","Adelaide","North Melbourne",2
10526,1993-05-21,"R9","North Melbourne",20,14,134,"Carlton",14,12,96,"M.C.G.",38,1993,"Regular",9,"Home","North Melbourne","Carlton",38
10527,1993-05-22,"R9","Fitzroy",14,8,92,"Collingwood",10,13,73,"Princes Park",19,1993,"Regular",9,"Home","Fitzroy","Collingwood",19
10528,1993-05-22,"R9","Footscray",22,11,143,"St Kilda",11,13,79,"Western Oval",64,1993,"Regular",9,"Home","Footscray","St Kilda",64
10529,1993-05-22,"R9","Hawthorn",20,11,131,"Richmond",19,7,121,"Waverley Park",10,1993,"Regular",9,"Home","Hawthorn","Richmond",10
10530,1993-05-22,"R9","Essendon",16,15,111,"Adelaide",10,5,65,"M.C.G.",46,1993,"Regular",9,"Home","Essendon","Adelaide",46
10531,1993-05-23,"R9","Melbourne",14,17,101,"West Coast",13,10,88,"M.C.G.",13,1993,"Regular",9,"Home","Melbourne","West Coast",13
10532,1993-05-23,"R9","Sydney",15,14,104,"Geelong",19,15,129,"S.C.G.",-25,1993,"Regular",9,"Away","Geelong","Sydney",25
10533,1993-05-28,"R10","Essendon",19,15,129,"Fitzroy",19,11,125,"M.C.G.",4,1993,"Regular",10,"Home","Essendon","Fitzroy",4
10534,1993-05-29,"R10","Carlton",17,26,128,"Melbourne",11,8,74,"Princes Park",54,1993,"Regular",10,"Home","Carlton","Melbourne",54
10535,1993-05-29,"R10","Footscray",9,8,62,"Hawthorn",20,12,132,"Western Oval",-70,1993,"Regular",10,"Away","Hawthorn","Footscray",70
10536,1993-05-29,"R10","Richmond",17,20,122,"Sydney",14,9,93,"M.C.G.",29,1993,"Regular",10,"Home","Richmond","Sydney",29
10537,1993-05-29,"R10","Collingwood",5,13,43,"North Melbourne",19,12,126,"Victoria Park",-83,1993,"Regular",10,"Away","North Melbourne","Collingwood",83
10538,1993-05-29,"R10","St Kilda",9,10,64,"West Coast",9,12,66,"Waverley Park",-2,1993,"Regular",10,"Away","West Coast","St Kilda",2
10539,1993-05-30,"R10","Brisbane Lions",12,13,85,"Adelaide",18,14,122,"Gabba",-37,1993,"Regular",10,"Away","Adelaide","Brisbane Lions",37
10540,1993-06-12,"R11","Fitzroy",7,14,56,"Richmond",12,10,82,"Princes Park",-26,1993,"Regular",11,"Away","Richmond","Fitzroy",26
10541,1993-06-12,"R11","St Kilda",20,10,130,"Brisbane Lions",11,9,75,"Waverley Park",55,1993,"Regular",11,"Home","St Kilda","Brisbane Lions",55
10542,1993-06-12,"R11","Geelong",13,11,89,"Carlton",17,16,118,"M.C.G.",-29,1993,"Regular",11,"Away","Carlton","Geelong",29
10543,1993-06-13,"R11","Sydney",10,3,63,"West Coast",17,18,120,"S.C.G.",-57,1993,"Regular",11,"Away","West Coast","Sydney",57
10544,1993-06-13,"R11","Adelaide",15,17,107,"Footscray",8,14,62,"Football Park",45,1993,"Regular",11,"Home","Adelaide","Footscray",45
10545,1993-06-14,"R11","Melbourne",24,16,160,"Collingwood",16,13,109,"M.C.G.",51,1993,"Regular",11,"Home","Melbourne","Collingwood",51
10546,1993-06-14,"R11","Hawthorn",12,14,86,"Essendon",17,14,116,"Waverley Park",-30,1993,"Regular",11,"Away","Essendon","Hawthorn",30
10547,1993-06-18,"R12","West Coast",15,11,101,"North Melbourne",16,11,107,"W.A.C.A.",-6,1993,"Regular",12,"Away","North Melbourne","West Coast",6
10548,1993-06-19,"R12","Melbourne",15,15,105,"Essendon",10,11,71,"M.C.G.",34,1993,"Regular",12,"Home","Melbourne","Essendon",34
10549,1993-06-19,"R12","Footscray",13,16,94,"Sydney",10,9,69,"Western Oval",25,1993,"Regular",12,"Home","Footscray","Sydney",25
10550,1993-06-19,"R12","Hawthorn",23,14,152,"St Kilda",11,8,74,"Waverley Park",78,1993,"Regular",12,"Home","Hawthorn","St Kilda",78
10551,1993-06-19,"R12","Carlton",24,12,156,"Adelaide",11,11,77,"Princes Park",79,1993,"Regular",12,"Home","Carlton","Adelaide",79
10552,1993-06-20,"R12","Geelong",16,17,113,"Fitzroy",15,16,106,"Kardinia Park",7,1993,"Regular",12,"Home","Geelong","Fitzroy",7
10553,1993-06-20,"R12","Brisbane Lions",14,13,97,"Collingwood",20,18,138,"Gabba",-41,1993,"Regular",12,"Away","Collingwood","Brisbane Lions",41
10554,1993-06-25,"R13","North Melbourne",11,14,80,"Hawthorn",12,11,83,"M.C.G.",-3,1993,"Regular",13,"Away","Hawthorn","North Melbourne",3
10555,1993-06-26,"R13","Footscray",17,19,121,"Brisbane Lions",14,9,93,"Western Oval",28,1993,"Regular",13,"Home","Footscray","Brisbane Lions",28
10556,1993-06-26,"R13","Essendon",21,15,141,"Richmond",8,15,63,"Princes Park",78,1993,"Regular",13,"Home","Essendon","Richmond",78
10557,1993-06-26,"R13","Fitzroy",12,7,79,"St Kilda",17,10,112,"Waverley Park",-33,1993,"Regular",13,"Away","St Kilda","Fitzroy",33
10558,1993-06-26,"R13","Collingwood",11,5,71,"West Coast",14,10,94,"Victoria Park",-23,1993,"Regular",13,"Away","West Coast","Collingwood",23
10559,1993-06-27,"R13","Sydney",23,11,149,"Melbourne",16,13,109,"S.C.G.",40,1993,"Regular",13,"Home","Sydney","Melbourne",40
10560,1993-06-27,"R13","Adelaide",16,19,115,"Geelong",14,11,95,"Football Park",20,1993,"Regular",13,"Home","Adelaide","Geelong",20
10561,1993-07-02,"R14","Sydney",12,10,82,"Adelaide",18,18,126,"S.C.G.",-44,1993,"Regular",14,"Away","Adelaide","Sydney",44
10562,1993-07-03,"R14","Essendon",23,17,155,"Brisbane Lions",4,15,39,"M.C.G.",116,1993,"Regular",14,"Home","Essendon","Brisbane Lions",116
10563,1993-07-03,"R14","Fitzroy",18,11,119,"North Melbourne",17,16,118,"Princes Park",1,1993,"Regular",14,"Home","Fitzroy","North Melbourne",1
10564,1993-07-03,"R14","St Kilda",6,10,46,"Melbourne",14,8,92,"Waverley Park",-46,1993,"Regular",14,"Away","Melbourne","St Kilda",46
10565,1993-07-03,"R14","Geelong",15,20,110,"Footscray",8,6,54,"Kardinia Park",56,1993,"Regular",14,"Home","Geelong","Footscray",56
10566,1993-07-04,"R14","Richmond",17,15,117,"Collingwood",22,15,147,"M.C.G.",-30,1993,"Regular",14,"Away","Collingwood","Richmond",30
10567,1993-07-04,"R14","West Coast",13,13,91,"Carlton",14,8,92,"Subiaco",-1,1993,"Regular",14,"Away","Carlton","West Coast",1
10568,1993-07-09,"R15","North Melbourne",19,15,129,"Essendon",13,13,91,"M.C.G.",38,1993,"Regular",15,"Home","North Melbourne","Essendon",38
10569,1993-07-10,"R15","Carlton",19,17,131,"Brisbane Lions",14,13,97,"Princes Park",34,1993,"Regular",15,"Home","Carlton","Brisbane Lions",34
10570,1993-07-10,"R15","Collingwood",25,19,169,"Sydney",11,11,77,"Victoria Park",92,1993,"Regular",15,"Home","Collingwood","Sydney",92
10571,1993-07-10,"R15","Hawthorn",15,20,110,"Fitzroy",9,10,64,"Waverley Park",46,1993,"Regular",15,"Home","Hawthorn","Fitzroy",46
10572,1993-07-10,"R15","Melbourne",22,9,141,"Geelong",20,7,127,"M.C.G.",14,1993,"Regular",15,"Home","Melbourne","Geelong",14
10573,1993-07-11,"R15","Richmond",8,14,62,"Footscray",10,18,78,"M.C.G.",-16,1993,"Regular",15,"Away","Footscray","Richmond",16
10574,1993-07-11,"R15","Adelaide",23,18,156,"St Kilda",8,15,63,"Football Park",93,1993,"Regular",15,"Home","Adelaide","St Kilda",93
10575,1993-07-16,"R16","Adelaide",26,15,171,"Richmond",4,8,32,"Football Park",139,1993,"Regular",16,"Home","Adelaide","Richmond",139
10576,1993-07-17,"R16","Fitzroy",14,11,95,"Carlton",27,19,181,"Princes Park",-86,1993,"Regular",16,"Away","Carlton","Fitzroy",86
10577,1993-07-17,"R16","Collingwood",21,19,145,"Footscray",11,15,81,"Victoria Park",64,1993,"Regular",16,"Home","Collingwood","Footscray",64
10578,1993-07-17,"R16","St Kilda",27,15,177,"Geelong",15,16,106,"Waverley Park",71,1993,"Regular",16,"Home","St Kilda","Geelong",71
10579,1993-07-17,"R16","Melbourne",12,18,90,"Hawthorn",16,10,106,"M.C.G.",-16,1993,"Regular",16,"Away","Hawthorn","Melbourne",16
10580,1993-07-18,"R16","Brisbane Lions",15,14,104,"North Melbourne",22,14,146,"Gabba",-42,1993,"Regular",16,"Away","North Melbourne","Brisbane Lions",42
10581,1993-07-18,"R16","Essendon",12,17,89,"West Coast",13,9,87,"M.C.G.",2,1993,"Regular",16,"Home","Essendon","West Coast",2
10582,1993-07-23,"R17","North Melbourne",14,13,97,"St Kilda",16,16,112,"M.C.G.",-15,1993,"Regular",17,"Away","St Kilda","North Melbourne",15
10583,1993-07-24,"R17","Geelong",13,9,87,"Collingwood",11,13,79,"Waverley Park",8,1993,"Regular",17,"Home","Geelong","Collingwood",8
10584,1993-07-24,"R17","Footscray",14,13,97,"Melbourne",16,14,110,"Western Oval",-13,1993,"Regular",17,"Away","Melbourne","Footscray",13
10585,1993-07-24,"R17","Carlton",12,11,83,"Essendon",15,14,104,"M.C.G.",-21,1993,"Regular",17,"Away","Essendon","Carlton",21
10586,1993-07-25,"R17","Brisbane Lions",18,10,118,"Richmond",14,15,99,"Gabba",19,1993,"Regular",17,"Home","Brisbane Lions","Richmond",19
10587,1993-07-25,"R17","Hawthorn",24,15,159,"Sydney",9,13,67,"Waverley Park",92,1993,"Regular",17,"Home","Hawthorn","Sydney",92
10588,1993-07-25,"R17","West Coast",15,17,107,"Adelaide",10,10,70,"Subiaco",37,1993,"Regular",17,"Home","West Coast","Adelaide",37
10589,1993-07-30,"R18","Collingwood",7,13,55,"Essendon",18,15,123,"M.C.G.",-68,1993,"Regular",18,"Away","Essendon","Collingwood",68
10590,1993-07-31,"R18","Footscray",22,14,146,"Fitzroy",13,6,84,"Western Oval",62,1993,"Regular",18,"Home","Footscray","Fitzroy",62
10591,1993-07-31,"R18","North Melbourne",10,12,72,"Geelong",25,16,166,"M.C.G.",-94,1993,"Regular",18,"Away","Geelong","North Melbourne",94
10592,1993-07-31,"R18","Hawthorn",13,13,91,"Carlton",17,20,122,"Waverley Park",-31,1993,"Regular",18,"Away","Carlton","Hawthorn",31
10593,1993-07-31,"R18","Richmond",11,15,81,"West Coast",15,10,100,"Princes Park",-19,1993,"Regular",18,"Away","West Coast","Richmond",19
10594,1993-08-01,"R18","Melbourne",20,18,138,"Brisbane Lions",6,13,49,"M.C.G.",89,1993,"Regular",18,"Home","Melbourne","Brisbane Lions",89
10595,1993-08-01,"R18","Sydney",17,16,118,"St Kilda",24,11,155,"S.C.G.",-37,1993,"Regular",18,"Away","St Kilda","Sydney",37
10596,1993-08-06,"R19","Essendon",18,9,117,"Sydney",13,18,96,"M.C.G.",21,1993,"Regular",19,"Home","Essendon","Sydney",21
10597,1993-08-07,"R19","St Kilda",9,14,68,"Collingwood",10,20,80,"Waverley Park",-12,1993,"Regular",19,"Away","Collingwood","St Kilda",12
10598,1993-08-07,"R19","Fitzroy",15,9,99,"Adelaide",13,16,94,"Princes Park",5,1993,"Regular",19,"Home","Fitzroy","Adelaide",5
10599,1993-08-07,"R19","Richmond",12,11,83,"Carlton",16,10,106,"M.C.G.",-23,1993,"Regular",19,"Away","Carlton","Richmond",23
10600,1993-08-07,"R19","Geelong",22,18,150,"Hawthorn",10,8,68,"Kardinia Park",82,1993,"Regular",19,"Home","Geelong","Hawthorn",82
10601,1993-08-08,"R19","Brisbane Lions",10,11,71,"West Coast",19,17,131,"Gabba",-60,1993,"Regular",19,"Away","West Coast","Brisbane Lions",60
10602,1993-08-13,"R20","Sydney",15,9,99,"Fitzroy",17,12,114,"S.C.G.",-15,1993,"Regular",20,"Away","Fitzroy","Sydney",15
10603,1993-08-14,"R20","Carlton",10,17,77,"St Kilda",11,18,84,"Princes Park",-7,1993,"Regular",20,"Away","St Kilda","Carlton",7
10604,1993-08-14,"R20","Essendon",14,14,98,"Footscray",12,13,85,"M.C.G.",13,1993,"Regular",20,"Home","Essendon","Footscray",13
10605,1993-08-15,"R20","West Coast",10,7,67,"Hawthorn",6,9,45,"Subiaco",22,1993,"Regular",20,"Home","West Coast","Hawthorn",22
10606,1993-08-15,"R20","North Melbourne",19,14,128,"Richmond",11,18,84,"M.C.G.",44,1993,"Regular",20,"Home","North Melbourne","Richmond",44
10607,1993-08-15,"R20","Adelaide",13,27,105,"Melbourne",6,10,46,"Football Park",59,1993,"Regular",20,"Home","Adelaide","Melbourne",59
10608,1993-08-21,"R21","Fitzroy",22,15,147,"Brisbane Lions",5,13,43,"Princes Park",104,1993,"Regular",21,"Home","Fitzroy","Brisbane Lions",104
10609,1993-08-21,"R21","Geelong",19,12,126,"Essendon",14,10,94,"Kardinia Park",32,1993,"Regular",21,"Home","Geelong","Essendon",32
10610,1993-08-21,"R21","Hawthorn",17,13,115,"Adelaide",13,10,88,"Waverley Park",27,1993,"Regular",21,"Home","Hawthorn","Adelaide",27
10611,1993-08-21,"R21","Collingwood",8,15,63,"Carlton",17,15,117,"M.C.G.",-54,1993,"Regular",21,"Away","Carlton","Collingwood",54
10612,1993-08-21,"R21","Footscray",14,10,94,"West Coast",7,10,52,"Western Oval",42,1993,"Regular",21,"Home","Footscray","West Coast",42
10613,1993-08-22,"R21","Richmond",8,6,54,"Melbourne",26,19,175,"M.C.G.",-121,1993,"Regular",21,"Away","Melbourne","Richmond",121
10614,1993-08-22,"R21","Sydney",14,14,98,"North Melbourne",25,10,160,"S.C.G.",-62,1993,"Regular",21,"Away","North Melbourne","Sydney",62
10615,1993-08-27,"R22","West Coast",14,12,96,"Geelong",17,14,116,"W.A.C.A.",-20,1993,"Regular",22,"Away","Geelong","West Coast",20
10616,1993-08-28,"R22","Carlton",16,15,111,"Sydney",16,14,110,"Princes Park",1,1993,"Regular",22,"Home","Carlton","Sydney",1
10617,1993-08-28,"R22","St Kilda",18,17,125,"Richmond",12,10,82,"Waverley Park",43,1993,"Regular",22,"Home","St Kilda","Richmond",43
10618,1993-08-28,"R22","North Melbourne",18,15,123,"Footscray",20,15,135,"M.C.G.",-12,1993,"Regular",22,"Away","Footscray","North Melbourne",12
10619,1993-08-29,"R22","Brisbane Lions",15,16,106,"Hawthorn",24,19,163,"Gabba",-57,1993,"Regular",22,"Away","Hawthorn","Brisbane Lions",57
10620,1993-08-29,"R22","Melbourne",11,9,75,"Fitzroy",14,14,98,"M.C.G.",-23,1993,"Regular",22,"Away","Fitzroy","Melbourne",23
10621,1993-08-29,"R22","Adelaide",19,21,135,"Collingwood",17,9,111,"Football Park",24,1993,"Regular",22,"Home","Adelaide","Collingwood",24
10622,1993-09-04,"EF","North Melbourne",11,3,69,"West Coast",17,18,120,"Waverley Park",-51,1993,"Finals",23,"Away","West Coast","North Melbourne",51
10623,1993-09-04,"QF","Essendon",14,14,98,"Carlton",15,10,100,"M.C.G.",-2,1993,"Finals",23,"Away","Carlton","Essendon",2
10624,1993-09-05,"EF","Hawthorn",13,17,95,"Adelaide",16,14,110,"M.C.G.",-15,1993,"Finals",23,"Away","Adelaide","Hawthorn",15
10625,1993-09-11,"SF","Carlton",13,8,86,"Adelaide",8,20,68,"Waverley Park",18,1993,"Finals",24,"Home","Carlton","Adelaide",18
10626,1993-09-12,"SF","Essendon",16,12,108,"West Coast",11,10,76,"M.C.G.",32,1993,"Finals",24,"Home","Essendon","West Coast",32
10627,1993-09-18,"PF","Essendon",17,9,111,"Adelaide",14,16,100,"M.C.G.",11,1993,"Finals",25,"Home","Essendon","Adelaide",11
10628,1993-09-25,"GF","Essendon",20,13,133,"Carlton",13,11,89,"M.C.G.",44,1993,"Finals",26,"Home","Essendon","Carlton",44
10629,1994-03-26,"R1","Collingwood",17,12,114,"Fitzroy",16,7,103,"Victoria Park",11,1994,"Regular",1,"Home","Collingwood","Fitzroy",11
10630,1994-03-26,"R1","Footscray",17,11,113,"Richmond",17,9,111,"Western Oval",2,1994,"Regular",1,"Home","Footscray","Richmond",2
10631,1994-03-26,"R1","St Kilda",15,7,97,"Hawthorn",23,15,153,"Waverley Park",-56,1994,"Regular",1,"Away","Hawthorn","St Kilda",56
10632,1994-03-26,"R1","Essendon",12,10,82,"West Coast",11,13,79,"M.C.G.",3,1994,"Regular",1,"Home","Essendon","West Coast",3
10633,1994-03-27,"R1","Melbourne",26,18,174,"Geelong",16,13,109,"M.C.G.",65,1994,"Regular",1,"Home","Melbourne","Geelong",65
10634,1994-03-27,"R1","Brisbane Lions",13,21,99,"Sydney",12,17,89,"Gabba",10,1994,"Regular",1,"Home","Brisbane Lions","Sydney",10
10635,1994-03-27,"R1","Adelaide",22,18,150,"Carlton",13,6,84,"Football Park",66,1994,"Regular",1,"Home","Adelaide","Carlton",66
10636,1994-04-02,"R2","Fitzroy",17,10,112,"Essendon",14,15,99,"Princes Park",13,1994,"Regular",2,"Home","Fitzroy","Essendon",13
10637,1994-04-02,"R2","North Melbourne",21,16,142,"St Kilda",10,13,73,"M.C.G.",69,1994,"Regular",2,"Home","North Melbourne","St Kilda",69
10638,1994-04-02,"R2","Hawthorn",8,16,64,"Melbourne",17,16,118,"Waverley Park",-54,1994,"Regular",2,"Away","Melbourne","Hawthorn",54
10639,1994-04-03,"R2","Richmond",20,14,134,"Brisbane Lions",11,6,72,"M.C.G.",62,1994,"Regular",2,"Home","Richmond","Brisbane Lions",62
10640,1994-04-03,"R2","West Coast",14,13,97,"Adelaide",11,12,78,"Subiaco",19,1994,"Regular",2,"Home","West Coast","Adelaide",19
10641,1994-04-04,"R2","Geelong",22,20,152,"Footscray",8,16,64,"Kardinia Park",88,1994,"Regular",2,"Home","Geelong","Footscray",88
10642,1994-04-04,"R2","Carlton",9,12,66,"Collingwood",14,16,100,"M.C.G.",-34,1994,"Regular",2,"Away","Collingwood","Carlton",34
10643,1994-04-08,"R3","North Melbourne",25,23,173,"Hawthorn",6,10,46,"M.C.G.",127,1994,"Regular",3,"Home","North Melbourne","Hawthorn",127
10644,1994-04-09,"R3","Fitzroy",17,9,111,"Brisbane Lions",12,6,78,"Western Oval",33,1994,"Regular",3,"Home","Fitzroy","Brisbane Lions",33
10645,1994-04-09,"R3","St Kilda",16,12,108,"Essendon",14,10,94,"Waverley Park",14,1994,"Regular",3,"Home","St Kilda","Essendon",14
10646,1994-04-09,"R3","Richmond",5,9,39,"West Coast",20,15,135,"M.C.G.",-96,1994,"Regular",3,"Away","West Coast","Richmond",96
10647,1994-04-10,"R3","Carlton",14,15,99,"Geelong",10,10,70,"Princes Park",29,1994,"Regular",3,"Home","Carlton","Geelong",29
10648,1994-04-10,"R3","Collingwood",14,11,95,"Footscray",12,22,94,"M.C.G.",1,1994,"Regular",3,"Home","Collingwood","Footscray",1
10649,1994-04-10,"R3","Sydney",21,9,135,"Adelaide",24,10,154,"S.C.G.",-19,1994,"Regular",3,"Away","Adelaide","Sydney",19
10650,1994-04-15,"R4","Sydney",11,20,86,"Richmond",10,12,72,"S.C.G.",14,1994,"Regular",4,"Home","Sydney","Richmond",14
10651,1994-04-16,"R4","Hawthorn",11,7,73,"Carlton",24,16,160,"Waverley Park",-87,1994,"Regular",4,"Away","Carlton","Hawthorn",87
10652,1994-04-16,"R4","Footscray",14,15,99,"North Melbourne",17,10,112,"Western Oval",-13,1994,"Regular",4,"Away","North Melbourne","Footscray",13
10653,1994-04-16,"R4","Essendon",9,12,66,"Melbourne",12,12,84,"M.C.G.",-18,1994,"Regular",4,"Away","Melbourne","Essendon",18
10654,1994-04-16,"R4","West Coast",18,21,129,"Fitzroy",8,5,53,"W.A.C.A.",76,1994,"Regular",4,"Home","West Coast","Fitzroy",76
10655,1994-04-17,"R4","Brisbane Lions",22,19,151,"St Kilda",15,8,98,"Gabba",53,1994,"Regular",4,"Home","Brisbane Lions","St Kilda",53
10656,1994-04-17,"R4","Adelaide",15,14,104,"Geelong",11,11,77,"Football Park",27,1994,"Regular",4,"Home","Adelaide","Geelong",27
10657,1994-04-22,"R5","Melbourne",17,15,117,"Brisbane Lions",4,6,30,"M.C.G.",87,1994,"Regular",5,"Home","Melbourne","Brisbane Lions",87
10658,1994-04-23,"R5","Fitzroy",20,17,137,"Sydney",20,9,129,"Western Oval",8,1994,"Regular",5,"Home","Fitzroy","Sydney",8
10659,1994-04-23,"R5","Geelong",17,18,120,"North Melbourne",15,15,105,"Kardinia Park",15,1994,"Regular",5,"Home","Geelong","North Melbourne",15
10660,1994-04-23,"R5","Essendon",14,14,98,"Collingwood",14,10,94,"M.C.G.",4,1994,"Regular",5,"Home","Essendon","Collingwood",4
10661,1994-04-24,"R5","Adelaide",13,15,93,"Footscray",17,8,110,"Football Park",-17,1994,"Regular",5,"Away","Footscray","Adelaide",17
10662,1994-04-24,"R5","West Coast",8,10,58,"Hawthorn",19,15,129,"Subiaco",-71,1994,"Regular",5,"Away","Hawthorn","West Coast",71
10663,1994-04-25,"R5","St Kilda",10,10,70,"Richmond",15,22,112,"Waverley Park",-42,1994,"Regular",5,"Away","Richmond","St Kilda",42
10664,1994-04-30,"R6","Carlton",20,14,134,"Sydney",11,8,74,"Princes Park",60,1994,"Regular",6,"Home","Carlton","Sydney",60
10665,1994-04-30,"R6","Brisbane Lions",17,8,110,"Adelaide",18,13,121,"Gabba",-11,1994,"Regular",6,"Away","Adelaide","Brisbane Lions",11
10666,1994-04-30,"R6","Collingwood",8,7,55,"Melbourne",9,6,60,"Waverley Park",-5,1994,"Regular",6,"Away","Melbourne","Collingwood",5
10667,1994-04-30,"R6","North Melbourne",13,8,86,"West Coast",18,15,123,"M.C.G.",-37,1994,"Regular",6,"Away","West Coast","North Melbourne",37
10668,1994-05-07,"R7","Hawthorn",12,16,88,"Essendon",11,9,75,"Waverley Park",13,1994,"Regular",7,"Home","Hawthorn","Essendon",13
10669,1994-05-07,"R7","Richmond",20,13,133,"Fitzroy",13,14,92,"Princes Park",41,1994,"Regular",7,"Home","Richmond","Fitzroy",41
10670,1994-05-07,"R7","Melbourne",8,10,58,"North Melbourne",13,12,90,"M.C.G.",-32,1994,"Regular",7,"Away","North Melbourne","Melbourne",32
10671,1994-05-08,"R7","Sydney",17,7,109,"St Kilda",16,14,110,"S.C.G.",-1,1994,"Regular",7,"Away","St Kilda","Sydney",1
10672,1994-05-08,"R7","Footscray",12,14,86,"Brisbane Lions",7,7,49,"Western Oval",37,1994,"Regular",7,"Home","Footscray","Brisbane Lions",37
10673,1994-05-08,"R7","Geelong",18,16,124,"Collingwood",13,18,96,"M.C.G.",28,1994,"Regular",7,"Home","Geelong","Collingwood",28
10674,1994-05-08,"R7","West Coast",16,19,115,"Carlton",6,13,49,"Subiaco",66,1994,"Regular",7,"Home","West Coast","Carlton",66
10675,1994-05-13,"R8","Richmond",16,11,107,"Carlton",20,15,135,"M.C.G.",-28,1994,"Regular",8,"Away","Carlton","Richmond",28
10676,1994-05-14,"R8","Hawthorn",25,16,166,"Brisbane Lions",10,7,67,"Waverley Park",99,1994,"Regular",8,"Home","Hawthorn","Brisbane Lions",99
10677,1994-05-14,"R8","Fitzroy",13,12,90,"North Melbourne",17,17,119,"Western Oval",-29,1994,"Regular",8,"Away","North Melbourne","Fitzroy",29
10678,1994-05-14,"R8","Collingwood",19,13,127,"St Kilda",11,12,78,"M.C.G.",49,1994,"Regular",8,"Home","Collingwood","St Kilda",49
10679,1994-05-15,"R8","Melbourne",13,13,91,"Footscray",14,10,94,"M.C.G.",-3,1994,"Regular",8,"Away","Footscray","Melbourne",3
10680,1994-05-15,"R8","Essendon",20,11,131,"Adelaide",13,10,88,"Princes Park",43,1994,"Regular",8,"Home","Essendon","Adelaide",43
10681,1994-05-15,"R8","Sydney",9,17,71,"Geelong",25,15,165,"S.C.G.",-94,1994,"Regular",8,"Away","Geelong","Sydney",94
10682,1994-05-20,"R9","North Melbourne",17,19,121,"Collingwood",13,10,88,"M.C.G.",33,1994,"Regular",9,"Home","North Melbourne","Collingwood",33
10683,1994-05-21,"R9","Geelong",21,16,142,"Richmond",11,12,78,"Kardinia Park",64,1994,"Regular",9,"Home","Geelong","Richmond",64
10684,1994-05-21,"R9","Melbourne",14,13,97,"Sydney",16,10,106,"M.C.G.",-9,1994,"Regular",9,"Away","Sydney","Melbourne",9
10685,1994-05-21,"R9","Carlton",7,20,62,"Essendon",9,9,63,"Waverley Park",-1,1994,"Regular",9,"Away","Essendon","Carlton",1
10686,1994-05-21,"R9","Footscray",7,10,52,"West Coast",12,11,83,"Western Oval",-31,1994,"Regular",9,"Away","West Coast","Footscray",31
10687,1994-05-22,"R9","St Kilda",11,9,75,"Fitzroy",8,14,62,"Waverley Park",13,1994,"Regular",9,"Home","St Kilda","Fitzroy",13
10688,1994-05-22,"R9","Adelaide",7,6,48,"Hawthorn",22,13,145,"Football Park",-97,1994,"Regular",9,"Away","Hawthorn","Adelaide",97
10689,1994-05-27,"R10","West Coast",14,17,101,"Sydney",10,15,75,"W.A.C.A.",26,1994,"Regular",10,"Home","West Coast","Sydney",26
10690,1994-05-28,"R10","Carlton",16,13,109,"Footscray",13,19,97,"Princes Park",12,1994,"Regular",10,"Home","Carlton","Footscray",12
10691,1994-05-28,"R10","Collingwood",16,14,110,"Hawthorn",10,14,74,"Victoria Park",36,1994,"Regular",10,"Home","Collingwood","Hawthorn",36
10692,1994-05-28,"R10","St Kilda",4,8,32,"Melbourne",15,16,106,"Waverley Park",-74,1994,"Regular",10,"Away","Melbourne","St Kilda",74
10693,1994-05-28,"R10","Essendon",16,16,112,"Geelong",15,11,101,"M.C.G.",11,1994,"Regular",10,"Home","Essendon","Geelong",11
10694,1994-05-29,"R10","Brisbane Lions",17,18,120,"North Melbourne",12,21,93,"Gabba",27,1994,"Regular",10,"Home","Brisbane Lions","North Melbourne",27
10695,1994-05-29,"R10","Adelaide",15,13,103,"Fitzroy",9,10,64,"Football Park",39,1994,"Regular",10,"Home","Adelaide","Fitzroy",39
10696,1994-06-04,"R11","Geelong",15,11,101,"Brisbane Lions",19,12,126,"Kardinia Park",-25,1994,"Regular",11,"Away","Brisbane Lions","Geelong",25
10697,1994-06-04,"R11","Fitzroy",12,8,80,"Carlton",20,15,135,"Waverley Park",-55,1994,"Regular",11,"Away","Carlton","Fitzroy",55
10698,1994-06-04,"R11","Essendon",24,10,154,"Richmond",17,6,108,"Princes Park",46,1994,"Regular",11,"Home","Essendon","Richmond",46
10699,1994-06-04,"R11","Collingwood",13,12,90,"Adelaide",8,19,67,"Victoria Park",23,1994,"Regular",11,"Home","Collingwood","Adelaide",23
10700,1994-06-05,"R11","Hawthorn",20,5,125,"Footscray",8,13,61,"Waverley Park",64,1994,"Regular",11,"Home","Hawthorn","Footscray",64
10701,1994-06-05,"R11","Melbourne",11,8,74,"West Coast",18,10,118,"M.C.G.",-44,1994,"Regular",11,"Away","West Coast","Melbourne",44
10702,1994-06-05,"R11","Sydney",16,10,106,"North Melbourne",19,12,126,"S.C.G.",-20,1994,"Regular",11,"Away","North Melbourne","Sydney",20
10703,1994-06-11,"R12","Geelong",17,11,113,"St Kilda",16,14,110,"Kardinia Park",3,1994,"Regular",12,"Home","Geelong","St Kilda",3
10704,1994-06-11,"R12","North Melbourne",21,23,149,"Adelaide",10,9,69,"Princes Park",80,1994,"Regular",12,"Home","North Melbourne","Adelaide",80
10705,1994-06-11,"R12","Melbourne",13,16,94,"Carlton",18,13,121,"M.C.G.",-27,1994,"Regular",12,"Away","Carlton","Melbourne",27
10706,1994-06-12,"R12","Sydney",13,5,83,"Hawthorn",21,15,141,"S.C.G.",-58,1994,"Regular",12,"Away","Hawthorn","Sydney",58
10707,1994-06-12,"R12","West Coast",11,12,78,"Brisbane Lions",10,9,69,"Subiaco",9,1994,"Regular",12,"Home","West Coast","Brisbane Lions",9
10708,1994-06-13,"R12","Footscray",13,14,92,"Essendon",9,10,64,"Waverley Park",28,1994,"Regular",12,"Home","Footscray","Essendon",28
10709,1994-06-13,"R12","Richmond",14,18,102,"Collingwood",4,12,36,"M.C.G.",66,1994,"Regular",12,"Home","Richmond","Collingwood",66
10710,1994-06-18,"R13","Carlton",22,13,145,"St Kilda",10,5,65,"Princes Park",80,1994,"Regular",13,"Home","Carlton","St Kilda",80
10711,1994-06-18,"R13","Hawthorn",7,11,53,"Fitzroy",10,6,66,"Waverley Park",-13,1994,"Regular",13,"Away","Fitzroy","Hawthorn",13
10712,1994-06-18,"R13","Richmond",9,18,72,"North Melbourne",10,7,67,"M.C.G.",5,1994,"Regular",13,"Home","Richmond","North Melbourne",5
10713,1994-06-19,"R13","Footscray",20,14,134,"Sydney",9,6,60,"Western Oval",74,1994,"Regular",13,"Home","Footscray","Sydney",74
10714,1994-06-19,"R13","Collingwood",18,13,121,"West Coast",12,12,84,"M.C.G.",37,1994,"Regular",13,"Home","Collingwood","West Coast",37
10715,1994-06-19,"R13","Brisbane Lions",17,12,114,"Essendon",11,15,81,"Gabba",33,1994,"Regular",13,"Home","Brisbane Lions","Essendon",33
10716,1994-06-19,"R13","Adelaide",11,17,83,"Melbourne",12,6,78,"Football Park",5,1994,"Regular",13,"Home","Adelaide","Melbourne",5
10717,1994-06-24,"R14","North Melbourne",13,10,88,"Carlton",15,16,106,"M.C.G.",-18,1994,"Regular",14,"Away","Carlton","North Melbourne",18
10718,1994-06-25,"R14","Footscray",21,18,144,"Fitzroy",6,4,40,"Western Oval",104,1994,"Regular",14,"Home","Footscray","Fitzroy",104
10719,1994-06-25,"R14","Melbourne",9,8,62,"Richmond",11,12,78,"M.C.G.",-16,1994,"Regular",14,"Away","Richmond","Melbourne",16
10720,1994-06-25,"R14","St Kilda",12,7,79,"Adelaide",11,13,79,"Waverley Park",0,1994,"Regular",14,"Home","St Kilda","Adelaide",0
10721,1994-06-25,"R14","Geelong",10,15,75,"West Coast",14,9,93,"Kardinia Park",-18,1994,"Regular",14,"Away","West Coast","Geelong",18
10722,1994-06-26,"R14","Essendon",19,15,129,"Sydney",14,11,95,"M.C.G.",34,1994,"Regular",14,"Home","Essendon","Sydney",34
10723,1994-06-26,"R14","Brisbane Lions",17,19,121,"Collingwood",11,11,77,"Gabba",44,1994,"Regular",14,"Home","Brisbane Lions","Collingwood",44
10724,1994-07-01,"R15","West Coast",19,14,128,"St Kilda",7,7,49,"W.A.C.A.",79,1994,"Regular",15,"Home","West Coast","St Kilda",79
10725,1994-07-02,"R15","North Melbourne",11,19,85,"Essendon",14,8,92,"M.C.G.",-7,1994,"Regular",15,"Away","Essendon","North Melbourne",7
10726,1994-07-02,"R15","Fitzroy",9,11,65,"Melbourne",16,15,111,"Western Oval",-46,1994,"Regular",15,"Away","Melbourne","Fitzroy",46
10727,1994-07-02,"R15","Hawthorn",16,19,115,"Geelong",11,13,79,"Waverley Park",36,1994,"Regular",15,"Home","Hawthorn","Geelong",36
10728,1994-07-02,"R15","Carlton",22,12,144,"Brisbane Lions",6,10,46,"Princes Park",98,1994,"Regular",15,"Home","Carlton","Brisbane Lions",98
10729,1994-07-03,"R15","Sydney",10,13,73,"Collingwood",13,15,93,"S.C.G.",-20,1994,"Regular",15,"Away","Collingwood","Sydney",20
10730,1994-07-03,"R15","Adelaide",12,11,83,"Richmond",13,12,90,"Football Park",-7,1994,"Regular",15,"Away","Richmond","Adelaide",7
10731,1994-07-09,"R16","Fitzroy",11,14,80,"Collingwood",19,15,129,"Western Oval",-49,1994,"Regular",16,"Away","Collingwood","Fitzroy",49
10732,1994-07-09,"R16","Geelong",22,13,145,"Melbourne",17,13,115,"Kardinia Park",30,1994,"Regular",16,"Home","Geelong","Melbourne",30
10733,1994-07-09,"R16","Hawthorn",21,16,142,"St Kilda",11,12,78,"Waverley Park",64,1994,"Regular",16,"Home","Hawthorn","St Kilda",64
10734,1994-07-09,"R16","Richmond",14,13,97,"Footscray",12,22,94,"M.C.G.",3,1994,"Regular",16,"Home","Richmond","Footscray",3
10735,1994-07-10,"R16","Sydney",15,20,110,"Brisbane Lions",21,9,135,"S.C.G.",-25,1994,"Regular",16,"Away","Brisbane Lions","Sydney",25
10736,1994-07-10,"R16","Carlton",20,16,136,"Adelaide",10,16,76,"Princes Park",60,1994,"Regular",16,"Home","Carlton","Adelaide",60
10737,1994-07-10,"R16","West Coast",11,14,80,"Essendon",5,14,44,"Subiaco",36,1994,"Regular",16,"Home","West Coast","Essendon",36
10738,1994-07-16,"R17","Footscray",17,11,113,"Geelong",13,7,85,"Western Oval",28,1994,"Regular",17,"Home","Footscray","Geelong",28
10739,1994-07-16,"R17","Melbourne",17,10,112,"Hawthorn",11,8,74,"Princes Park",38,1994,"Regular",17,"Home","Melbourne","Hawthorn",38
10740,1994-07-16,"R17","St Kilda",8,7,55,"North Melbourne",17,14,116,"Waverley Park",-61,1994,"Regular",17,"Away","North Melbourne","St Kilda",61
10741,1994-07-16,"R17","Collingwood",7,12,54,"Carlton",14,13,97,"M.C.G.",-43,1994,"Regular",17,"Away","Carlton","Collingwood",43
10742,1994-07-17,"R17","Essendon",24,9,153,"Fitzroy",12,17,89,"M.C.G.",64,1994,"Regular",17,"Home","Essendon","Fitzroy",64
10743,1994-07-17,"R17","Brisbane Lions",12,12,84,"Richmond",15,8,98,"Gabba",-14,1994,"Regular",17,"Away","Richmond","Brisbane Lions",14
10744,1994-07-17,"R17","Adelaide",12,10,82,"West Coast",11,12,78,"Football Park",4,1994,"Regular",17,"Home","Adelaide","West Coast",4
10745,1994-07-22,"R18","Adelaide",10,15,75,"Sydney",13,9,87,"Football Park",-12,1994,"Regular",18,"Away","Sydney","Adelaide",12
10746,1994-07-23,"R18","Footscray",13,9,87,"Collingwood",7,13,55,"Western Oval",32,1994,"Regular",18,"Home","Footscray","Collingwood",32
10747,1994-07-23,"R18","Essendon",15,10,100,"St Kilda",18,2,110,"M.C.G.",-10,1994,"Regular",18,"Away","St Kilda","Essendon",10
10748,1994-07-23,"R18","Hawthorn",9,5,59,"North Melbourne",15,9,99,"Waverley Park",-40,1994,"Regular",18,"Away","North Melbourne","Hawthorn",40
10749,1994-07-24,"R18","Brisbane Lions",8,17,65,"Fitzroy",7,16,58,"Gabba",7,1994,"Regular",18,"Home","Brisbane Lions","Fitzroy",7
10750,1994-07-24,"R18","Geelong",13,12,90,"Carlton",8,6,54,"Waverley Park",36,1994,"Regular",18,"Home","Geelong","Carlton",36
10751,1994-07-24,"R18","West Coast",14,17,101,"Richmond",7,11,53,"Subiaco",48,1994,"Regular",18,"Home","West Coast","Richmond",48
10752,1994-07-29,"R19","North Melbourne",15,12,102,"Footscray",12,10,82,"M.C.G.",20,1994,"Regular",19,"Home","North Melbourne","Footscray",20
10753,1994-07-30,"R19","St Kilda",5,15,45,"Brisbane Lions",8,7,55,"Waverley Park",-10,1994,"Regular",19,"Away","Brisbane Lions","St Kilda",10
10754,1994-07-30,"R19","Melbourne",21,9,135,"Essendon",8,10,58,"M.C.G.",77,1994,"Regular",19,"Home","Melbourne","Essendon",77
10755,1994-07-30,"R19","Carlton",15,14,104,"Hawthorn",9,18,72,"Princes Park",32,1994,"Regular",19,"Home","Carlton","Hawthorn",32
10756,1994-07-31,"R19","Richmond",14,11,95,"Sydney",9,8,62,"M.C.G.",33,1994,"Regular",19,"Home","Richmond","Sydney",33
10757,1994-07-31,"R19","Geelong",13,13,91,"Adelaide",5,8,38,"Kardinia Park",53,1994,"Regular",19,"Home","Geelong","Adelaide",53
10758,1994-07-31,"R19","Fitzroy",3,8,26,"West Coast",13,14,92,"Western Oval",-66,1994,"Regular",19,"Away","West Coast","Fitzroy",66
10759,1994-08-05,"R20","Collingwood",19,20,134,"Essendon",17,4,106,"M.C.G.",28,1994,"Regular",20,"Home","Collingwood","Essendon",28
10760,1994-08-06,"R20","Richmond",12,21,93,"St Kilda",9,7,61,"M.C.G.",32,1994,"Regular",20,"Home","Richmond","St Kilda",32
10761,1994-08-06,"R20","North Melbourne",11,11,77,"Geelong",10,18,78,"Princes Park",-1,1994,"Regular",20,"Away","Geelong","North Melbourne",1
10762,1994-08-06,"R20","Hawthorn",15,10,100,"West Coast",7,12,54,"Waverley Park",46,1994,"Regular",20,"Home","Hawthorn","West Coast",46
10763,1994-08-07,"R20","Brisbane Lions",12,12,84,"Melbourne",14,15,99,"Gabba",-15,1994,"Regular",20,"Away","Melbourne","Brisbane Lions",15
10764,1994-08-07,"R20","Footscray",17,16,118,"Adelaide",4,10,34,"Western Oval",84,1994,"Regular",20,"Home","Footscray","Adelaide",84
10765,1994-08-07,"R20","Sydney",9,12,66,"Fitzroy",13,16,94,"S.C.G.",-28,1994,"Regular",20,"Away","Fitzroy","Sydney",28
10766,1994-08-12,"R21","West Coast",10,13,73,"North Melbourne",9,10,64,"W.A.C.A.",9,1994,"Regular",21,"Home","West Coast","North Melbourne",9
10767,1994-08-13,"R21","Fitzroy",8,11,59,"Geelong",13,22,100,"Princes Park",-41,1994,"Regular",21,"Away","Geelong","Fitzroy",41
10768,1994-08-13,"R21","St Kilda",10,12,72,"Footscray",17,15,117,"Waverley Park",-45,1994,"Regular",21,"Away","Footscray","St Kilda",45
10769,1994-08-13,"R21","Melbourne",9,10,64,"Collingwood",13,14,92,"M.C.G.",-28,1994,"Regular",21,"Away","Collingwood","Melbourne",28
10770,1994-08-14,"R21","Sydney",9,16,70,"Carlton",8,14,62,"S.C.G.",8,1994,"Regular",21,"Home","Sydney","Carlton",8
10771,1994-08-14,"R21","Richmond",11,23,89,"Hawthorn",18,9,117,"M.C.G.",-28,1994,"Regular",21,"Away","Hawthorn","Richmond",28
10772,1994-08-14,"R21","Adelaide",13,11,89,"Brisbane Lions",12,14,86,"Football Park",3,1994,"Regular",21,"Home","Adelaide","Brisbane Lions",3
10773,1994-08-19,"R22","North Melbourne",12,11,83,"Melbourne",15,13,103,"M.C.G.",-20,1994,"Regular",22,"Away","Melbourne","North Melbourne",20
10774,1994-08-20,"R22","Fitzroy",10,9,69,"Richmond",19,15,129,"Western Oval",-60,1994,"Regular",22,"Away","Richmond","Fitzroy",60
10775,1994-08-20,"R22","St Kilda",17,12,114,"Sydney",11,15,81,"Waverley Park",33,1994,"Regular",22,"Home","St Kilda","Sydney",33
10776,1994-08-20,"R22","Collingwood",15,17,107,"Geelong",16,8,104,"M.C.G.",3,1994,"Regular",22,"Home","Collingwood","Geelong",3
10777,1994-08-21,"R22","Essendon",20,16,136,"Hawthorn",12,12,84,"M.C.G.",52,1994,"Regular",22,"Home","Essendon","Hawthorn",52
10778,1994-08-21,"R22","Carlton",19,12,126,"West Coast",8,14,62,"Princes Park",64,1994,"Regular",22,"Home","Carlton","West Coast",64
10779,1994-08-21,"R22","Brisbane Lions",13,10,88,"Footscray",14,14,98,"Gabba",-10,1994,"Regular",22,"Away","Footscray","Brisbane Lions",10
10780,1994-08-26,"R23","North Melbourne",25,10,160,"Fitzroy",10,14,74,"M.C.G.",86,1994,"Regular",23,"Home","North Melbourne","Fitzroy",86
10781,1994-08-27,"R23","Carlton",25,11,161,"Richmond",6,12,48,"Princes Park",113,1994,"Regular",23,"Home","Carlton","Richmond",113
10782,1994-08-27,"R23","St Kilda",14,6,90,"Collingwood",13,10,88,"Waverley Park",2,1994,"Regular",23,"Home","St Kilda","Collingwood",2
10783,1994-08-27,"R23","Geelong",16,15,111,"Sydney",15,9,99,"Kardinia Park",12,1994,"Regular",23,"Home","Geelong","Sydney",12
10784,1994-08-27,"R23","Footscray",16,15,111,"Melbourne",11,5,71,"Western Oval",40,1994,"Regular",23,"Home","Footscray","Melbourne",40
10785,1994-08-28,"R23","Brisbane Lions",13,13,91,"Hawthorn",15,12,102,"Gabba",-11,1994,"Regular",23,"Away","Hawthorn","Brisbane Lions",11
10786,1994-08-28,"R23","Adelaide",17,13,115,"Essendon",8,10,58,"Football Park",57,1994,"Regular",23,"Home","Adelaide","Essendon",57
10787,1994-09-02,"R24","Collingwood",8,14,62,"North Melbourne",19,12,126,"M.C.G.",-64,1994,"Regular",24,"Away","North Melbourne","Collingwood",64
10788,1994-09-03,"R24","Essendon",12,8,80,"Carlton",9,8,62,"M.C.G.",18,1994,"Regular",24,"Home","Essendon","Carlton",18
10789,1994-09-03,"R24","Fitzroy",15,12,102,"St Kilda",21,14,140,"Western Oval",-38,1994,"Regular",24,"Away","St Kilda","Fitzroy",38
10790,1994-09-03,"R24","Hawthorn",9,12,66,"Adelaide",6,11,47,"Waverley Park",19,1994,"Regular",24,"Home","Hawthorn","Adelaide",19
10791,1994-09-03,"R24","Richmond",13,17,95,"Geelong",27,9,171,"Princes Park",-76,1994,"Regular",24,"Away","Geelong","Richmond",76
10792,1994-09-04,"R24","Sydney",18,13,121,"Melbourne",27,5,167,"S.C.G.",-46,1994,"Regular",24,"Away","Melbourne","Sydney",46
10793,1994-09-04,"R24","West Coast",17,15,117,"Footscray",6,10,46,"Subiaco",71,1994,"Regular",24,"Home","West Coast","Footscray",71
10794,1994-09-10,"QF","North Melbourne",15,24,114,"Hawthorn",13,13,91,"Waverley Park",23,1994,"Finals",25,"Home","North Melbourne","Hawthorn",23
10795,1994-09-10,"QF","Geelong",15,16,106,"Footscray",15,11,101,"M.C.G.",5,1994,"Finals",25,"Home","Geelong","Footscray",5
10796,1994-09-11,"QF","Carlton",14,12,96,"Melbourne",18,15,123,"M.C.G.",-27,1994,"Finals",25,"Away","Melbourne","Carlton",27
10797,1994-09-11,"QF","West Coast",11,16,82,"Collingwood",12,8,80,"W.A.C.A.",2,1994,"Finals",25,"Home","West Coast","Collingwood",2
10798,1994-09-17,"SF","Carlton",10,12,72,"Geelong",15,15,105,"Waverley Park",-33,1994,"Finals",26,"Away","Geelong","Carlton",33
10799,1994-09-18,"SF","Footscray",9,11,65,"Melbourne",21,18,144,"M.C.G.",-79,1994,"Finals",26,"Away","Melbourne","Footscray",79
10800,1994-09-24,"PF","North Melbourne",14,19,103,"Geelong",16,13,109,"M.C.G.",-6,1994,"Finals",27,"Away","Geelong","North Melbourne",6
10801,1994-09-24,"PF","West Coast",16,21,117,"Melbourne",8,4,52,"W.A.C.A.",65,1994,"Finals",27,"Home","West Coast","Melbourne",65
10802,1994-10-01,"GF","West Coast",20,23,143,"Geelong",8,15,63,"M.C.G.",80,1994,"Finals",28,"Home","West Coast","Geelong",80
10803,1995-03-31,"R1","North Melbourne",11,13,79,"Adelaide",10,16,76,"M.C.G.",3,1995,"Regular",1,"Home","North Melbourne","Adelaide",3
10804,1995-04-01,"R1","Hawthorn",20,7,127,"Brisbane Lions",11,4,70,"Waverley Park",57,1995,"Regular",1,"Home","Hawthorn","Brisbane Lions",57
10805,1995-04-01,"R1","Fitzroy",6,2,38,"Essendon",16,16,112,"Western Oval",-74,1995,"Regular",1,"Away","Essendon","Fitzroy",74
10806,1995-04-01,"R1","Richmond",12,18,90,"Fremantle",12,13,85,"M.C.G.",5,1995,"Regular",1,"Home","Richmond","Fremantle",5
10807,1995-04-01,"R1","Geelong",12,15,87,"Melbourne",11,7,73,"Kardinia Park",14,1995,"Regular",1,"Home","Geelong","Melbourne",14
10808,1995-04-02,"R1","Carlton",14,11,95,"Collingwood",9,12,66,"M.C.G.",29,1995,"Regular",1,"Home","Carlton","Collingwood",29
10809,1995-04-02,"R1","Footscray",15,12,102,"Sydney",12,13,85,"Western Oval",17,1995,"Regular",1,"Home","Footscray","Sydney",17
10810,1995-04-02,"R1","West Coast",18,13,121,"St Kilda",11,9,75,"W.A.C.A.",46,1995,"Regular",1,"Home","West Coast","St Kilda",46
10811,1995-04-07,"R2","Fremantle",11,16,82,"Essendon",12,19,91,"W.A.C.A.",-9,1995,"Regular",2,"Away","Essendon","Fremantle",9
10812,1995-04-08,"R2","Carlton",18,17,125,"Fitzroy",8,8,56,"Princes Park",69,1995,"Regular",2,"Home","Carlton","Fitzroy",69
10813,1995-04-08,"R2","Hawthorn",10,11,71,"Footscray",14,11,95,"Waverley Park",-24,1995,"Regular",2,"Away","Footscray","Hawthorn",24
10814,1995-04-08,"R2","Melbourne",12,15,87,"North Melbourne",16,10,106,"M.C.G.",-19,1995,"Regular",2,"Away","North Melbourne","Melbourne",19
10815,1995-04-09,"R2","Brisbane Lions",18,18,126,"Adelaide",14,15,99,"Gabba",27,1995,"Regular",2,"Home","Brisbane Lions","Adelaide",27
10816,1995-04-09,"R2","Collingwood",11,10,76,"West Coast",11,14,80,"M.C.G.",-4,1995,"Regular",2,"Away","West Coast","Collingwood",4
10817,1995-04-09,"R2","St Kilda",9,15,69,"Richmond",14,11,95,"Waverley Park",-26,1995,"Regular",2,"Away","Richmond","St Kilda",26
10818,1995-04-09,"R2","Sydney",10,15,75,"Geelong",11,14,80,"S.C.G.",-5,1995,"Regular",2,"Away","Geelong","Sydney",5
10819,1995-04-15,"R3","Footscray",8,12,60,"Carlton",23,20,158,"M.C.G.",-98,1995,"Regular",3,"Away","Carlton","Footscray",98
10820,1995-04-15,"R3","Geelong",18,14,122,"Collingwood",14,11,95,"Kardinia Park",27,1995,"Regular",3,"Home","Geelong","Collingwood",27
10821,1995-04-15,"R3","Fitzroy",11,12,78,"Fremantle",18,13,121,"Western Oval",-43,1995,"Regular",3,"Away","Fremantle","Fitzroy",43
10822,1995-04-15,"R3","West Coast",12,19,91,"North Melbourne",5,13,43,"W.A.C.A.",48,1995,"Regular",3,"Home","West Coast","North Melbourne",48
10823,1995-04-16,"R3","Hawthorn",5,4,34,"Richmond",4,16,40,"Waverley Park",-6,1995,"Regular",3,"Away","Richmond","Hawthorn",6
10824,1995-04-16,"R3","Brisbane Lions",15,14,104,"Sydney",14,15,99,"Gabba",5,1995,"Regular",3,"Home","Brisbane Lions","Sydney",5
10825,1995-04-16,"R3","Adelaide",13,14,92,"St Kilda",3,8,26,"Football Park",66,1995,"Regular",3,"Home","Adelaide","St Kilda",66
10826,1995-04-17,"R3","Essendon",14,14,98,"Melbourne",12,10,82,"M.C.G.",16,1995,"Regular",3,"Home","Essendon","Melbourne",16
10827,1995-04-21,"R4","Fremantle",12,22,94,"Geelong",10,15,75,"W.A.C.A.",19,1995,"Regular",4,"Home","Fremantle","Geelong",19
10828,1995-04-22,"R4","St Kilda",10,10,70,"Hawthorn",16,10,106,"Waverley Park",-36,1995,"Regular",4,"Away","Hawthorn","St Kilda",36
10829,1995-04-22,"R4","Sydney",17,14,116,"Fitzroy",12,12,84,"S.C.G.",32,1995,"Regular",4,"Home","Sydney","Fitzroy",32
10830,1995-04-23,"R4","Brisbane Lions",12,10,82,"Carlton",18,11,119,"Gabba",-37,1995,"Regular",4,"Away","Carlton","Brisbane Lions",37
10831,1995-04-23,"R4","Melbourne",12,8,80,"Footscray",16,7,103,"Princes Park",-23,1995,"Regular",4,"Away","Footscray","Melbourne",23
10832,1995-04-23,"R4","Adelaide",7,14,56,"West Coast",6,10,46,"Football Park",10,1995,"Regular",4,"Home","Adelaide","West Coast",10
10833,1995-04-24,"R4","Richmond",21,8,134,"North Melbourne",13,7,85,"M.C.G.",49,1995,"Regular",4,"Home","Richmond","North Melbourne",49
10834,1995-04-25,"R4","Collingwood",17,9,111,"Essendon",16,15,111,"M.C.G.",0,1995,"Regular",4,"Home","Collingwood","Essendon",0
10835,1995-04-29,"R5","Richmond",17,14,116,"Brisbane Lions",14,12,96,"M.C.G.",20,1995,"Regular",5,"Home","Richmond","Brisbane Lions",20
10836,1995-04-29,"R5","Geelong",28,13,181,"Fitzroy",13,14,92,"Kardinia Park",89,1995,"Regular",5,"Home","Geelong","Fitzroy",89
10837,1995-04-29,"R5","Footscray",14,14,98,"Fremantle",14,12,96,"Western Oval",2,1995,"Regular",5,"Home","Footscray","Fremantle",2
10838,1995-04-29,"R5","West Coast",13,12,90,"Melbourne",11,8,74,"W.A.C.A.",16,1995,"Regular",5,"Home","West Coast","Melbourne",16
10839,1995-04-30,"R5","North Melbourne",7,8,50,"Carlton",12,12,84,"M.C.G.",-34,1995,"Regular",5,"Away","Carlton","North Melbourne",34
10840,1995-04-30,"R5","Hawthorn",14,12,96,"Collingwood",4,13,37,"Waverley Park",59,1995,"Regular",5,"Home","Hawthorn","Collingwood",59
10841,1995-04-30,"R5","Essendon",24,10,154,"St Kilda",5,8,38,"Princes Park",116,1995,"Regular",5,"Home","Essendon","St Kilda",116
10842,1995-04-30,"R5","Sydney",20,24,144,"Adelaide",12,15,87,"S.C.G.",57,1995,"Regular",5,"Home","Sydney","Adelaide",57
10843,1995-05-05,"R6","Adelaide",11,11,77,"Melbourne",10,9,69,"Football Park",8,1995,"Regular",6,"Home","Adelaide","Melbourne",8
10844,1995-05-06,"R6","Carlton",13,12,90,"West Coast",10,7,67,"Princes Park",23,1995,"Regular",6,"Home","Carlton","West Coast",23
10845,1995-05-06,"R6","Collingwood",12,10,82,"Richmond",13,16,94,"M.C.G.",-12,1995,"Regular",6,"Away","Richmond","Collingwood",12
10846,1995-05-06,"R6","St Kilda",10,13,73,"Fitzroy",12,12,84,"Waverley Park",-11,1995,"Regular",6,"Away","Fitzroy","St Kilda",11
10847,1995-05-06,"R6","Footscray",8,14,62,"Geelong",22,18,150,"Western Oval",-88,1995,"Regular",6,"Away","Geelong","Footscray",88
10848,1995-05-07,"R6","Essendon",19,14,128,"Brisbane Lions",14,16,100,"Princes Park",28,1995,"Regular",6,"Home","Essendon","Brisbane Lions",28
10849,1995-05-07,"R6","North Melbourne",22,12,144,"Hawthorn",14,13,97,"M.C.G.",47,1995,"Regular",6,"Home","North Melbourne","Hawthorn",47
10850,1995-05-07,"R6","Fremantle",25,13,163,"Sydney",16,9,105,"W.A.C.A.",58,1995,"Regular",6,"Home","Fremantle","Sydney",58
10851,1995-05-12,"R7","Richmond",10,12,72,"Adelaide",9,4,58,"M.C.G.",14,1995,"Regular",7,"Home","Richmond","Adelaide",14
10852,1995-05-13,"R7","Carlton",10,15,75,"Essendon",9,13,67,"M.C.G.",8,1995,"Regular",7,"Home","Carlton","Essendon",8
10853,1995-05-13,"R7","Collingwood",13,19,97,"Sydney",11,10,76,"Victoria Park",21,1995,"Regular",7,"Home","Collingwood","Sydney",21
10854,1995-05-13,"R7","Fitzroy",13,10,88,"North Melbourne",17,16,118,"Western Oval",-30,1995,"Regular",7,"Away","North Melbourne","Fitzroy",30
10855,1995-05-13,"R7","St Kilda",15,15,105,"Footscray",12,15,87,"Waverley Park",18,1995,"Regular",7,"Home","St Kilda","Footscray",18
10856,1995-05-13,"R7","Geelong",9,19,73,"Hawthorn",11,12,78,"Kardinia Park",-5,1995,"Regular",7,"Away","Hawthorn","Geelong",5
10857,1995-05-14,"R7","Melbourne",12,10,82,"Brisbane Lions",10,15,75,"M.C.G.",7,1995,"Regular",7,"Home","Melbourne","Brisbane Lions",7
10858,1995-05-14,"R7","West Coast",23,13,151,"Fremantle",9,12,66,"Subiaco",85,1995,"Regular",7,"Home","West Coast","Fremantle",85
10859,1995-05-19,"R8","Sydney",21,6,132,"Carlton",8,12,60,"S.C.G.",72,1995,"Regular",8,"Home","Sydney","Carlton",72
10860,1995-05-20,"R8","Collingwood",20,11,131,"Fremantle",14,9,93,"Victoria Park",38,1995,"Regular",8,"Home","Collingwood","Fremantle",38
10861,1995-05-20,"R8","Footscray",13,6,84,"North Melbourne",15,15,105,"Western Oval",-21,1995,"Regular",8,"Away","North Melbourne","Footscray",21
10862,1995-05-20,"R8","Richmond",14,7,91,"Geelong",24,19,163,"M.C.G.",-72,1995,"Regular",8,"Away","Geelong","Richmond",72
10863,1995-05-20,"R8","Hawthorn",7,8,50,"Melbourne",17,10,112,"Waverley Park",-62,1995,"Regular",8,"Away","Melbourne","Hawthorn",62
10864,1995-05-20,"R8","Adelaide",9,12,66,"Fitzroy",15,9,99,"Football Park",-33,1995,"Regular",8,"Away","Fitzroy","Adelaide",33
10865,1995-05-21,"R8","Brisbane Lions",17,13,115,"St Kilda",14,10,94,"Gabba",21,1995,"Regular",8,"Home","Brisbane Lions","St Kilda",21
10866,1995-05-21,"R8","West Coast",13,12,90,"Essendon",16,12,108,"Subiaco",-18,1995,"Regular",8,"Away","Essendon","West Coast",18
10867,1995-05-26,"R9","North Melbourne",12,7,79,"Geelong",20,20,140,"M.C.G.",-61,1995,"Regular",9,"Away","Geelong","North Melbourne",61
10868,1995-05-27,"R9","St Kilda",11,14,80,"Carlton",3,6,24,"Waverley Park",56,1995,"Regular",9,"Home","St Kilda","Carlton",56
10869,1995-05-27,"R9","Essendon",15,11,101,"Footscray",9,13,67,"M.C.G.",34,1995,"Regular",9,"Home","Essendon","Footscray",34
10870,1995-05-27,"R9","Fitzroy",8,6,54,"West Coast",12,10,82,"Bruce Stadium",-28,1995,"Regular",9,"Away","West Coast","Fitzroy",28
10871,1995-05-27,"R9","Adelaide",9,6,60,"Hawthorn",7,16,58,"Football Park",2,1995,"Regular",9,"Home","Adelaide","Hawthorn",2
10872,1995-05-28,"R9","Sydney",14,6,90,"Richmond",17,14,116,"S.C.G.",-26,1995,"Regular",9,"Away","Richmond","Sydney",26
10873,1995-05-28,"R9","Melbourne",12,13,85,"Collingwood",7,16,58,"M.C.G.",27,1995,"Regular",9,"Home","Melbourne","Collingwood",27
10874,1995-05-28,"R9","Fremantle",17,18,120,"Brisbane Lions",8,6,54,"Subiaco",66,1995,"Regular",9,"Home","Fremantle","Brisbane Lions",66
10875,1995-06-02,"R10","North Melbourne",19,12,126,"Essendon",15,9,99,"M.C.G.",27,1995,"Regular",10,"Home","North Melbourne","Essendon",27
10876,1995-06-03,"R10","Geelong",16,20,116,"Adelaide",14,7,91,"Kardinia Park",25,1995,"Regular",10,"Home","Geelong","Adelaide",25
10877,1995-06-03,"R10","Collingwood",13,15,93,"Fitzroy",10,19,79,"Victoria Park",14,1995,"Regular",10,"Home","Collingwood","Fitzroy",14
10878,1995-06-03,"R10","St Kilda",9,6,60,"Fremantle",20,11,131,"Waverley Park",-71,1995,"Regular",10,"Away","Fremantle","St Kilda",71
10879,1995-06-03,"R10","Melbourne",15,12,102,"Sydney",11,11,77,"M.C.G.",25,1995,"Regular",10,"Home","Melbourne","Sydney",25
10880,1995-06-04,"R10","Carlton",26,16,172,"Hawthorn",10,10,70,"Princes Park",102,1995,"Regular",10,"Home","Carlton","Hawthorn",102
10881,1995-06-04,"R10","Footscray",9,10,64,"Richmond",13,18,96,"M.C.G.",-32,1995,"Regular",10,"Away","Richmond","Footscray",32
10882,1995-06-04,"R10","West Coast",17,10,112,"Brisbane Lions",10,7,67,"Subiaco",45,1995,"Regular",10,"Home","West Coast","Brisbane Lions",45
10883,1995-06-09,"R11","Collingwood",25,11,161,"St Kilda",13,9,87,"M.C.G.",74,1995,"Regular",11,"Home","Collingwood","St Kilda",74
10884,1995-06-10,"R11","Essendon",17,10,112,"Geelong",19,9,123,"M.C.G.",-11,1995,"Regular",11,"Away","Geelong","Essendon",11
10885,1995-06-10,"R11","Richmond",18,15,123,"West Coast",9,9,63,"Princes Park",60,1995,"Regular",11,"Home","Richmond","West Coast",60
10886,1995-06-10,"R11","Adelaide",12,18,90,"Footscray",6,10,46,"Football Park",44,1995,"Regular",11,"Home","Adelaide","Footscray",44
10887,1995-06-11,"R11","Brisbane Lions",17,30,132,"Fitzroy",10,14,74,"Gabba",58,1995,"Regular",11,"Home","Brisbane Lions","Fitzroy",58
10888,1995-06-11,"R11","Fremantle",11,6,72,"North Melbourne",22,11,143,"Subiaco",-71,1995,"Regular",11,"Away","North Melbourne","Fremantle",71
10889,1995-06-12,"R11","Melbourne",12,8,80,"Carlton",16,16,112,"M.C.G.",-32,1995,"Regular",11,"Away","Carlton","Melbourne",32
10890,1995-06-12,"R11","Hawthorn",17,11,113,"Sydney",9,17,71,"Waverley Park",42,1995,"Regular",11,"Home","Hawthorn","Sydney",42
10891,1995-06-23,"R12","Essendon",10,18,78,"Hawthorn",8,12,60,"M.C.G.",18,1995,"Regular",12,"Home","Essendon","Hawthorn",18
10892,1995-06-24,"R12","Carlton",16,16,112,"Geelong",15,19,109,"Princes Park",3,1995,"Regular",12,"Home","Carlton","Geelong",3
10893,1995-06-24,"R12","Footscray",10,11,71,"Collingwood",10,11,71,"Waverley Park",0,1995,"Regular",12,"Home","Footscray","Collingwood",0
10894,1995-06-24,"R12","Richmond",15,19,109,"Fitzroy",15,13,103,"M.C.G.",6,1995,"Regular",12,"Home","Richmond","Fitzroy",6
10895,1995-06-24,"R12","Adelaide",16,9,105,"Fremantle",12,12,84,"Football Park",21,1995,"Regular",12,"Home","Adelaide","Fremantle",21
10896,1995-06-25,"R12","Brisbane Lions",13,11,89,"North Melbourne",20,13,133,"Gabba",-44,1995,"Regular",12,"Away","North Melbourne","Brisbane Lions",44
10897,1995-06-25,"R12","St Kilda",11,7,73,"Melbourne",13,12,90,"Waverley Park",-17,1995,"Regular",12,"Away","Melbourne","St Kilda",17
10898,1995-06-25,"R12","West Coast",11,7,73,"Sydney",10,12,72,"Subiaco",1,1995,"Regular",12,"Home","West Coast","Sydney",1
10899,1995-06-30,"R13","Collingwood",24,8,152,"Adelaide",7,14,56,"M.C.G.",96,1995,"Regular",13,"Home","Collingwood","Adelaide",96
10900,1995-07-01,"R13","Footscray",9,15,69,"Brisbane Lions",8,5,53,"Western Oval",16,1995,"Regular",13,"Home","Footscray","Brisbane Lions",16
10901,1995-07-01,"R13","Geelong",17,14,116,"West Coast",9,10,64,"Kardinia Park",52,1995,"Regular",13,"Home","Geelong","West Coast",52
10902,1995-07-01,"R13","Melbourne",14,11,95,"Richmond",12,12,84,"M.C.G.",11,1995,"Regular",13,"Home","Melbourne","Richmond",11
10903,1995-07-01,"R13","St Kilda",12,12,84,"North Melbourne",18,13,121,"Waverley Park",-37,1995,"Regular",13,"Away","North Melbourne","St Kilda",37
10904,1995-07-02,"R13","Sydney",21,12,138,"Essendon",17,17,119,"S.C.G.",19,1995,"Regular",13,"Home","Sydney","Essendon",19
10905,1995-07-02,"R13","Fitzroy",7,10,52,"Hawthorn",21,25,151,"Princes Park",-99,1995,"Regular",13,"Away","Hawthorn","Fitzroy",99
10906,1995-07-02,"R13","Fremantle",7,7,49,"Carlton",15,16,106,"Subiaco",-57,1995,"Regular",13,"Away","Carlton","Fremantle",57
10907,1995-07-07,"R14","North Melbourne",18,17,125,"Collingwood",10,13,73,"M.C.G.",52,1995,"Regular",14,"Home","North Melbourne","Collingwood",52
10908,1995-07-08,"R14","Essendon",27,20,182,"Adelaide",8,12,60,"M.C.G.",122,1995,"Regular",14,"Home","Essendon","Adelaide",122
10909,1995-07-08,"R14","Geelong",15,21,111,"Brisbane Lions",15,8,98,"Kardinia Park",13,1995,"Regular",14,"Home","Geelong","Brisbane Lions",13
10910,1995-07-08,"R14","Hawthorn",8,8,56,"West Coast",14,13,97,"Waverley Park",-41,1995,"Regular",14,"Away","West Coast","Hawthorn",41
10911,1995-07-09,"R14","Sydney",14,10,94,"St Kilda",17,17,119,"S.C.G.",-25,1995,"Regular",14,"Away","St Kilda","Sydney",25
10912,1995-07-09,"R14","Carlton",17,13,115,"Richmond",12,13,85,"M.C.G.",30,1995,"Regular",14,"Home","Carlton","Richmond",30
10913,1995-07-09,"R14","Fitzroy",12,7,79,"Footscray",23,8,146,"Western Oval",-67,1995,"Regular",14,"Away","Footscray","Fitzroy",67
10914,1995-07-09,"R14","Fremantle",7,8,50,"Melbourne",15,12,102,"Subiaco",-52,1995,"Regular",14,"Away","Melbourne","Fremantle",52
10915,1995-07-14,"R15","Richmond",15,11,101,"Essendon",15,11,101,"M.C.G.",0,1995,"Regular",15,"Home","Richmond","Essendon",0
10916,1995-07-15,"R15","Carlton",20,13,133,"Adelaide",15,10,100,"Princes Park",33,1995,"Regular",15,"Home","Carlton","Adelaide",33
10917,1995-07-15,"R15","Fitzroy",7,8,50,"Melbourne",20,11,131,"Western Oval",-81,1995,"Regular",15,"Away","Melbourne","Fitzroy",81
10918,1995-07-15,"R15","Hawthorn",18,10,118,"Fremantle",11,8,74,"Waverley Park",44,1995,"Regular",15,"Home","Hawthorn","Fremantle",44
10919,1995-07-15,"R15","North Melbourne",12,12,84,"Sydney",16,17,113,"M.C.G.",-29,1995,"Regular",15,"Away","Sydney","North Melbourne",29
10920,1995-07-16,"R15","Brisbane Lions",11,14,80,"Collingwood",19,15,129,"Gabba",-49,1995,"Regular",15,"Away","Collingwood","Brisbane Lions",49
10921,1995-07-16,"R15","Geelong",13,7,85,"St Kilda",13,15,93,"M.C.G.",-8,1995,"Regular",15,"Away","St Kilda","Geelong",8
10922,1995-07-16,"R15","West Coast",8,13,61,"Footscray",12,15,87,"Subiaco",-26,1995,"Regular",15,"Away","Footscray","West Coast",26
10923,1995-07-21,"R16","Adelaide",9,11,65,"North Melbourne",7,12,54,"Football Park",11,1995,"Regular",16,"Home","Adelaide","North Melbourne",11
10924,1995-07-22,"R16","Essendon",22,18,150,"Fitzroy",12,7,79,"M.C.G.",71,1995,"Regular",16,"Home","Essendon","Fitzroy",71
10925,1995-07-22,"R16","Melbourne",12,10,82,"Geelong",15,21,111,"Princes Park",-29,1995,"Regular",16,"Away","Geelong","Melbourne",29
10926,1995-07-22,"R16","St Kilda",9,10,64,"West Coast",19,8,122,"Waverley Park",-58,1995,"Regular",16,"Away","West Coast","St Kilda",58
10927,1995-07-22,"R16","Sydney",12,7,79,"Footscray",21,8,134,"S.C.G.",-55,1995,"Regular",16,"Away","Footscray","Sydney",55
10928,1995-07-23,"R16","Brisbane Lions",14,20,104,"Hawthorn",14,13,97,"Gabba",7,1995,"Regular",16,"Home","Brisbane Lions","Hawthorn",7
10929,1995-07-23,"R16","Collingwood",10,8,68,"Carlton",12,18,90,"M.C.G.",-22,1995,"Regular",16,"Away","Carlton","Collingwood",22
10930,1995-07-23,"R16","Fremantle",9,13,67,"Richmond",10,14,74,"Subiaco",-7,1995,"Regular",16,"Away","Richmond","Fremantle",7
10931,1995-07-28,"R17","North Melbourne",12,8,80,"Melbourne",15,12,102,"M.C.G.",-22,1995,"Regular",17,"Away","Melbourne","North Melbourne",22
10932,1995-07-29,"R17","Essendon",21,9,135,"Fremantle",13,9,87,"M.C.G.",48,1995,"Regular",17,"Home","Essendon","Fremantle",48
10933,1995-07-29,"R17","Footscray",8,9,57,"Hawthorn",7,10,52,"Western Oval",5,1995,"Regular",17,"Home","Footscray","Hawthorn",5
10934,1995-07-29,"R17","Geelong",23,13,151,"Sydney",11,8,74,"Kardinia Park",77,1995,"Regular",17,"Home","Geelong","Sydney",77
10935,1995-07-29,"R17","Richmond",9,8,62,"St Kilda",15,17,107,"Princes Park",-45,1995,"Regular",17,"Away","St Kilda","Richmond",45
10936,1995-07-30,"R17","Fitzroy",9,10,64,"Carlton",24,17,161,"Waverley Park",-97,1995,"Regular",17,"Away","Carlton","Fitzroy",97
10937,1995-07-30,"R17","West Coast",18,21,129,"Collingwood",11,13,79,"Subiaco",50,1995,"Regular",17,"Home","West Coast","Collingwood",50
10938,1995-07-30,"R17","Adelaide",6,10,46,"Brisbane Lions",11,10,76,"Football Park",-30,1995,"Regular",17,"Away","Brisbane Lions","Adelaide",30
10939,1995-08-04,"R18","Richmond",13,21,99,"Hawthorn",8,7,55,"M.C.G.",44,1995,"Regular",18,"Home","Richmond","Hawthorn",44
10940,1995-08-05,"R18","St Kilda",10,8,68,"Adelaide",14,14,98,"Waverley Park",-30,1995,"Regular",18,"Away","Adelaide","St Kilda",30
10941,1995-08-05,"R18","Melbourne",11,7,73,"Essendon",15,16,106,"M.C.G.",-33,1995,"Regular",18,"Away","Essendon","Melbourne",33
10942,1995-08-05,"R18","North Melbourne",15,16,106,"West Coast",7,2,44,"Princes Park",62,1995,"Regular",18,"Home","North Melbourne","West Coast",62
10943,1995-08-06,"R18","Sydney",17,9,111,"Brisbane Lions",19,12,126,"S.C.G.",-15,1995,"Regular",18,"Away","Brisbane Lions","Sydney",15
10944,1995-08-06,"R18","Carlton",15,16,106,"Footscray",11,15,81,"Princes Park",25,1995,"Regular",18,"Home","Carlton","Footscray",25
10945,1995-08-06,"R18","Collingwood",15,9,99,"Geelong",14,11,95,"M.C.G.",4,1995,"Regular",18,"Home","Collingwood","Geelong",4
10946,1995-08-06,"R18","Fremantle",17,14,116,"Fitzroy",9,10,64,"Subiaco",52,1995,"Regular",18,"Home","Fremantle","Fitzroy",52
10947,1995-08-11,"R19","North Melbourne",16,14,110,"Richmond",15,10,100,"M.C.G.",10,1995,"Regular",19,"Home","North Melbourne","Richmond",10
10948,1995-08-12,"R19","Essendon",16,14,110,"Collingwood",15,12,102,"M.C.G.",8,1995,"Regular",19,"Home","Essendon","Collingwood",8
10949,1995-08-12,"R19","Footscray",11,12,78,"Melbourne",7,16,58,"Western Oval",20,1995,"Regular",19,"Home","Footscray","Melbourne",20
10950,1995-08-12,"R19","Geelong",16,10,106,"Fremantle",12,11,83,"Kardinia Park",23,1995,"Regular",19,"Home","Geelong","Fremantle",23
10951,1995-08-12,"R19","Hawthorn",14,13,97,"St Kilda",16,9,105,"Waverley Park",-8,1995,"Regular",19,"Away","St Kilda","Hawthorn",8
10952,1995-08-13,"R19","Carlton",11,19,85,"Brisbane Lions",10,11,71,"Princes Park",14,1995,"Regular",19,"Home","Carlton","Brisbane Lions",14
10953,1995-08-13,"R19","Fitzroy",6,8,44,"Sydney",27,8,170,"Western Oval",-126,1995,"Regular",19,"Away","Sydney","Fitzroy",126
10954,1995-08-13,"R19","West Coast",26,21,177,"Adelaide",5,12,42,"Subiaco",135,1995,"Regular",19,"Home","West Coast","Adelaide",135
10955,1995-08-18,"R20","Collingwood",15,14,104,"Hawthorn",15,11,101,"M.C.G.",3,1995,"Regular",20,"Home","Collingwood","Hawthorn",3
10956,1995-08-19,"R20","Carlton",18,14,122,"North Melbourne",15,13,103,"Princes Park",19,1995,"Regular",20,"Home","Carlton","North Melbourne",19
10957,1995-08-19,"R20","St Kilda",10,15,75,"Essendon",23,13,151,"Waverley Park",-76,1995,"Regular",20,"Away","Essendon","St Kilda",76
10958,1995-08-19,"R20","Fitzroy",8,17,65,"Geelong",15,16,106,"Western Oval",-41,1995,"Regular",20,"Away","Geelong","Fitzroy",41
10959,1995-08-19,"R20","Melbourne",10,15,75,"West Coast",16,8,104,"M.C.G.",-29,1995,"Regular",20,"Away","West Coast","Melbourne",29
10960,1995-08-19,"R20","Adelaide",13,15,93,"Sydney",22,7,139,"Football Park",-46,1995,"Regular",20,"Away","Sydney","Adelaide",46
10961,1995-08-20,"R20","Brisbane Lions",24,16,160,"Richmond",13,5,83,"Gabba",77,1995,"Regular",20,"Home","Brisbane Lions","Richmond",77
10962,1995-08-20,"R20","Fremantle",17,14,116,"Footscray",12,13,85,"Subiaco",31,1995,"Regular",20,"Home","Fremantle","Footscray",31
10963,1995-08-25,"R21","Melbourne",18,7,115,"Adelaide",23,8,146,"M.C.G.",-31,1995,"Regular",21,"Away","Adelaide","Melbourne",31
10964,1995-08-26,"R21","Richmond",14,25,109,"Collingwood",7,13,55,"M.C.G.",54,1995,"Regular",21,"Home","Richmond","Collingwood",54
10965,1995-08-26,"R21","Fitzroy",13,12,90,"St Kilda",16,21,117,"Princes Park",-27,1995,"Regular",21,"Away","St Kilda","Fitzroy",27
10966,1995-08-26,"R21","Geelong",15,20,110,"Footscray",19,11,125,"Kardinia Park",-15,1995,"Regular",21,"Away","Footscray","Geelong",15
10967,1995-08-26,"R21","Hawthorn",9,14,68,"North Melbourne",17,11,113,"Waverley Park",-45,1995,"Regular",21,"Away","North Melbourne","Hawthorn",45
10968,1995-08-26,"R21","Brisbane Lions",17,14,116,"Essendon",12,12,84,"Gabba",32,1995,"Regular",21,"Home","Brisbane Lions","Essendon",32
10969,1995-08-27,"R21","Sydney",19,13,127,"Fremantle",20,24,144,"S.C.G.",-17,1995,"Regular",21,"Away","Fremantle","Sydney",17
10970,1995-08-27,"R21","West Coast",16,8,104,"Carlton",15,15,105,"Subiaco",-1,1995,"Regular",21,"Away","Carlton","West Coast",1
10971,1995-09-01,"R22","Brisbane Lions",16,14,110,"Melbourne",13,11,89,"Gabba",21,1995,"Regular",22,"Home","Brisbane Lions","Melbourne",21
10972,1995-09-02,"R22","Essendon",9,13,67,"Carlton",16,12,108,"M.C.G.",-41,1995,"Regular",22,"Away","Carlton","Essendon",41
10973,1995-09-02,"R22","North Melbourne",30,24,204,"Fitzroy",15,11,101,"Princes Park",103,1995,"Regular",22,"Home","North Melbourne","Fitzroy",103
10974,1995-09-02,"R22","Footscray",11,12,78,"St Kilda",20,12,132,"Western Oval",-54,1995,"Regular",22,"Away","St Kilda","Footscray",54
10975,1995-09-02,"R22","Hawthorn",15,12,102,"Geelong",23,10,148,"Waverley Park",-46,1995,"Regular",22,"Away","Geelong","Hawthorn",46
10976,1995-09-02,"R22","Adelaide",12,14,86,"Richmond",19,9,123,"Football Park",-37,1995,"Regular",22,"Away","Richmond","Adelaide",37
10977,1995-09-03,"R22","Sydney",19,13,127,"Collingwood",15,14,104,"S.C.G.",23,1995,"Regular",22,"Home","Sydney","Collingwood",23
10978,1995-09-03,"R22","Fremantle",8,10,58,"West Coast",16,15,111,"Subiaco",-53,1995,"Regular",22,"Away","West Coast","Fremantle",53
10979,1995-09-08,"QF","Richmond",12,12,84,"North Melbourne",17,12,114,"M.C.G.",-30,1995,"Finals",23,"Away","North Melbourne","Richmond",30
10980,1995-09-09,"QF","Essendon",11,8,74,"West Coast",8,7,55,"Waverley Park",19,1995,"Finals",23,"Home","Essendon","West Coast",19
10981,1995-09-09,"QF","Geelong",24,11,155,"Footscray",10,13,73,"M.C.G.",82,1995,"Finals",23,"Home","Geelong","Footscray",82
10982,1995-09-10,"QF","Carlton",13,12,90,"Brisbane Lions",12,5,77,"M.C.G.",13,1995,"Finals",23,"Home","Carlton","Brisbane Lions",13
10983,1995-09-16,"SF","Richmond",12,14,86,"Essendon",11,7,73,"M.C.G.",13,1995,"Finals",24,"Home","Richmond","Essendon",13
10984,1995-09-17,"SF","North Melbourne",18,21,129,"West Coast",10,11,71,"M.C.G.",58,1995,"Finals",24,"Home","North Melbourne","West Coast",58
10985,1995-09-23,"PF","Geelong",20,9,129,"Richmond",6,4,40,"Waverley Park",89,1995,"Finals",25,"Home","Geelong","Richmond",89
10986,1995-09-23,"PF","Carlton",18,10,118,"North Melbourne",8,8,56,"M.C.G.",62,1995,"Finals",25,"Home","Carlton","North Melbourne",62
10987,1995-09-30,"GF","Carlton",21,15,141,"Geelong",11,14,80,"M.C.G.",61,1995,"Finals",26,"Home","Carlton","Geelong",61
10988,1996-03-29,"R1","Melbourne",8,8,56,"Geelong",27,21,183,"M.C.G.",-127,1996,"Regular",1,"Away","Geelong","Melbourne",127
10989,1996-03-30,"R1","Richmond",15,14,104,"Essendon",19,8,122,"M.C.G.",-18,1996,"Regular",1,"Away","Essendon","Richmond",18
10990,1996-03-30,"R1","Fitzroy",11,5,71,"Hawthorn",13,14,92,"Western Oval",-21,1996,"Regular",1,"Away","Hawthorn","Fitzroy",21
10991,1996-03-30,"R1","St Kilda",12,13,85,"North Melbourne",15,19,109,"Waverley Park",-24,1996,"Regular",1,"Away","North Melbourne","St Kilda",24
10992,1996-03-30,"R1","Brisbane Lions",21,15,141,"Footscray",7,12,54,"Gabba",87,1996,"Regular",1,"Home","Brisbane Lions","Footscray",87
10993,1996-03-31,"R1","Carlton",16,13,109,"Collingwood",12,15,87,"M.C.G.",22,1996,"Regular",1,"Home","Carlton","Collingwood",22
10994,1996-03-31,"R1","Fremantle",6,9,45,"West Coast",9,13,67,"Subiaco",-22,1996,"Regular",1,"Away","West Coast","Fremantle",22
10995,1996-03-31,"R1","Adelaide",20,10,130,"Sydney",6,4,40,"Football Park",90,1996,"Regular",1,"Home","Adelaide","Sydney",90
10996,1996-04-06,"R2","Fitzroy",15,11,101,"Adelaide",21,7,133,"Western Oval",-32,1996,"Regular",2,"Away","Adelaide","Fitzroy",32
10997,1996-04-06,"R2","North Melbourne",26,12,168,"Footscray",5,7,37,"M.C.G.",131,1996,"Regular",2,"Home","North Melbourne","Footscray",131
10998,1996-04-06,"R2","Geelong",26,8,164,"St Kilda",20,14,134,"Kardinia Park",30,1996,"Regular",2,"Home","Geelong","St Kilda",30
10999,1996-04-06,"R2","Hawthorn",6,15,51,"Richmond",14,14,98,"Waverley Park",-47,1996,"Regular",2,"Away","Richmond","Hawthorn",47
11000,1996-04-06,"R2","West Coast",11,11,77,"Brisbane Lions",16,7,103,"W.A.C.A.",-26,1996,"Regular",2,"Away","Brisbane Lions","West Coast",26
11001,1996-04-07,"R2","Essendon",10,12,72,"Carlton",15,11,101,"M.C.G.",-29,1996,"Regular",2,"Away","Carlton","Essendon",29
11002,1996-04-07,"R2","Sydney",9,17,71,"Fremantle",13,22,100,"S.C.G.",-29,1996,"Regular",2,"Away","Fremantle","Sydney",29
11003,1996-04-08,"R2","Collingwood",27,11,173,"Melbourne",11,13,79,"M.C.G.",94,1996,"Regular",2,"Home","Collingwood","Melbourne",94
11004,1996-04-12,"R3","Adelaide",21,16,142,"Geelong",12,6,78,"Football Park",64,1996,"Regular",3,"Home","Adelaide","Geelong",64
11005,1996-04-13,"R3","Footscray",17,19,121,"Fitzroy",10,10,70,"Western Oval",51,1996,"Regular",3,"Home","Footscray","Fitzroy",51
11006,1996-04-13,"R3","Hawthorn",12,8,80,"North Melbourne",22,21,153,"Waverley Park",-73,1996,"Regular",3,"Away","North Melbourne","Hawthorn",73
11007,1996-04-13,"R3","Brisbane Lions",13,12,90,"Richmond",15,18,108,"Gabba",-18,1996,"Regular",3,"Away","Richmond","Brisbane Lions",18
11008,1996-04-14,"R3","Sydney",15,17,107,"Collingwood",10,13,73,"S.C.G.",34,1996,"Regular",3,"Home","Sydney","Collingwood",34
11009,1996-04-14,"R3","Essendon",16,13,109,"West Coast",6,14,50,"Waverley Park",59,1996,"Regular",3,"Home","Essendon","West Coast",59
11010,1996-04-14,"R3","Melbourne",14,14,98,"St Kilda",13,10,88,"Princes Park",10,1996,"Regular",3,"Home","Melbourne","St Kilda",10
11011,1996-04-14,"R3","Fremantle",15,12,102,"Carlton",6,13,49,"Subiaco",53,1996,"Regular",3,"Home","Fremantle","Carlton",53
11012,1996-04-19,"R4","Brisbane Lions",18,17,125,"North Melbourne",14,11,95,"Gabba",30,1996,"Regular",4,"Home","Brisbane Lions","North Melbourne",30
11013,1996-04-20,"R4","Carlton",21,7,133,"Melbourne",12,14,86,"Princes Park",47,1996,"Regular",4,"Home","Carlton","Melbourne",47
11014,1996-04-20,"R4","Collingwood",14,14,98,"Fremantle",8,13,61,"Victoria Park",37,1996,"Regular",4,"Home","Collingwood","Fremantle",37
11015,1996-04-20,"R4","St Kilda",24,16,160,"Fitzroy",11,9,75,"Waverley Park",85,1996,"Regular",4,"Home","St Kilda","Fitzroy",85
11016,1996-04-20,"R4","Footscray",8,9,57,"Hawthorn",8,9,57,"Western Oval",0,1996,"Regular",4,"Home","Footscray","Hawthorn",0
11017,1996-04-20,"R4","Adelaide",23,23,161,"Essendon",9,11,65,"Football Park",96,1996,"Regular",4,"Home","Adelaide","Essendon",96
11018,1996-04-21,"R4","West Coast",12,16,88,"Geelong",16,10,106,"Subiaco",-18,1996,"Regular",4,"Away","Geelong","West Coast",18
11019,1996-04-21,"R4","Richmond",9,16,70,"Sydney",10,11,71,"Waverley Park",-1,1996,"Regular",4,"Away","Sydney","Richmond",1
11020,1996-04-25,"R5","Essendon",16,9,105,"Collingwood",17,15,117,"M.C.G.",-12,1996,"Regular",5,"Away","Collingwood","Essendon",12
11021,1996-04-26,"R5","Fremantle",13,18,96,"Melbourne",8,11,59,"W.A.C.A.",37,1996,"Regular",5,"Home","Fremantle","Melbourne",37
11022,1996-04-27,"R5","North Melbourne",23,14,152,"Adelaide",17,11,113,"M.C.G.",39,1996,"Regular",5,"Home","North Melbourne","Adelaide",39
11023,1996-04-27,"R5","Carlton",12,14,86,"West Coast",12,13,85,"Princes Park",1,1996,"Regular",5,"Home","Carlton","West Coast",1
11024,1996-04-27,"R5","Geelong",13,13,91,"Richmond",12,16,88,"Kardinia Park",3,1996,"Regular",5,"Home","Geelong","Richmond",3
11025,1996-04-27,"R5","Sydney",13,10,88,"Hawthorn",11,10,76,"S.C.G.",12,1996,"Regular",5,"Home","Sydney","Hawthorn",12
11026,1996-04-28,"R5","Brisbane Lions",24,14,158,"Fitzroy",6,13,49,"Gabba",109,1996,"Regular",5,"Home","Brisbane Lions","Fitzroy",109
11027,1996-04-28,"R5","St Kilda",16,20,116,"Footscray",13,12,90,"Waverley Park",26,1996,"Regular",5,"Home","St Kilda","Footscray",26
11028,1996-05-03,"R6","Sydney",14,6,90,"Essendon",12,18,90,"S.C.G.",0,1996,"Regular",6,"Home","Sydney","Essendon",0
11029,1996-05-03,"R6","Geelong",13,15,93,"North Melbourne",15,14,104,"M.C.G.",-11,1996,"Regular",6,"Away","North Melbourne","Geelong",11
11030,1996-05-04,"R6","Collingwood",23,14,152,"Adelaide",12,8,80,"Victoria Park",72,1996,"Regular",6,"Home","Collingwood","Adelaide",72
11031,1996-05-04,"R6","Fitzroy",9,8,62,"Richmond",23,16,154,"Western Oval",-92,1996,"Regular",6,"Away","Richmond","Fitzroy",92
11032,1996-05-04,"R6","Melbourne",7,8,50,"West Coast",24,12,156,"Princes Park",-106,1996,"Regular",6,"Away","West Coast","Melbourne",106
11033,1996-05-04,"R6","Hawthorn",9,11,65,"St Kilda",13,8,86,"Waverley Park",-21,1996,"Regular",6,"Away","St Kilda","Hawthorn",21
11034,1996-05-05,"R6","Fremantle",12,13,85,"Brisbane Lions",17,8,110,"Subiaco",-25,1996,"Regular",6,"Away","Brisbane Lions","Fremantle",25
11035,1996-05-05,"R6","Footscray",9,10,64,"Carlton",12,8,80,"M.C.G.",-16,1996,"Regular",6,"Away","Carlton","Footscray",16
11036,1996-05-08,"R7","Essendon",22,11,143,"Geelong",17,12,114,"M.C.G.",29,1996,"Regular",7,"Home","Essendon","Geelong",29
11037,1996-05-10,"R7","Collingwood",14,11,95,"St Kilda",18,10,118,"M.C.G.",-23,1996,"Regular",7,"Away","St Kilda","Collingwood",23
11038,1996-05-11,"R7","Carlton",18,17,125,"Fitzroy",8,14,62,"Princes Park",63,1996,"Regular",7,"Home","Carlton","Fitzroy",63
11039,1996-05-11,"R7","Melbourne",5,8,38,"Sydney",12,10,82,"M.C.G.",-44,1996,"Regular",7,"Away","Sydney","Melbourne",44
11040,1996-05-11,"R7","Brisbane Lions",15,14,104,"Hawthorn",5,11,41,"Gabba",63,1996,"Regular",7,"Home","Brisbane Lions","Hawthorn",63
11041,1996-05-12,"R7","Richmond",17,11,113,"Footscray",9,8,62,"M.C.G.",51,1996,"Regular",7,"Home","Richmond","Footscray",51
11042,1996-05-12,"R7","West Coast",19,11,125,"North Melbourne",7,16,58,"Subiaco",67,1996,"Regular",7,"Home","West Coast","North Melbourne",67
11043,1996-05-12,"R7","Adelaide",20,12,132,"Fremantle",5,6,36,"Football Park",96,1996,"Regular",7,"Home","Adelaide","Fremantle",96
11044,1996-05-17,"R8","Brisbane Lions",15,18,108,"Collingwood",14,14,98,"Gabba",10,1996,"Regular",8,"Home","Brisbane Lions","Collingwood",10
11045,1996-05-17,"R8","Carlton",12,14,86,"Geelong",15,8,98,"M.C.G.",-12,1996,"Regular",8,"Away","Geelong","Carlton",12
11046,1996-05-18,"R8","Fitzroy",16,11,107,"Fremantle",10,16,76,"Western Oval",31,1996,"Regular",8,"Home","Fitzroy","Fremantle",31
11047,1996-05-18,"R8","Hawthorn",19,8,122,"Melbourne",10,11,71,"Waverley Park",51,1996,"Regular",8,"Home","Hawthorn","Melbourne",51
11048,1996-05-18,"R8","North Melbourne",20,24,144,"Richmond",14,5,89,"M.C.G.",55,1996,"Regular",8,"Home","North Melbourne","Richmond",55
11049,1996-05-18,"R8","West Coast",14,16,100,"Sydney",9,10,64,"W.A.C.A.",36,1996,"Regular",8,"Home","West Coast","Sydney",36
11050,1996-05-19,"R8","Adelaide",13,19,97,"St Kilda",11,7,73,"Football Park",24,1996,"Regular",8,"Home","Adelaide","St Kilda",24
11051,1996-05-19,"R8","Footscray",13,6,84,"Essendon",23,13,151,"M.C.G.",-67,1996,"Regular",8,"Away","Essendon","Footscray",67
11052,1996-05-24,"R9","North Melbourne",25,20,170,"Fitzroy",9,11,65,"M.C.G.",105,1996,"Regular",9,"Home","North Melbourne","Fitzroy",105
11053,1996-05-25,"R9","Footscray",18,11,119,"Adelaide",11,13,79,"Western Oval",40,1996,"Regular",9,"Home","Footscray","Adelaide",40
11054,1996-05-25,"R9","Essendon",11,23,89,"Melbourne",12,5,77,"M.C.G.",12,1996,"Regular",9,"Home","Essendon","Melbourne",12
11055,1996-05-25,"R9","Hawthorn",8,8,56,"West Coast",14,6,90,"Waverley Park",-34,1996,"Regular",9,"Away","West Coast","Hawthorn",34
11056,1996-05-26,"R9","Sydney",21,6,132,"Brisbane Lions",10,14,74,"S.C.G.",58,1996,"Regular",9,"Home","Sydney","Brisbane Lions",58
11057,1996-05-26,"R9","St Kilda",9,15,69,"Carlton",13,13,91,"Waverley Park",-22,1996,"Regular",9,"Away","Carlton","St Kilda",22
11058,1996-05-26,"R9","Fremantle",17,18,120,"Richmond",10,6,66,"Subiaco",54,1996,"Regular",9,"Home","Fremantle","Richmond",54
11059,1996-05-27,"R9","Collingwood",11,10,76,"Geelong",21,13,139,"M.C.G.",-63,1996,"Regular",9,"Away","Geelong","Collingwood",63
11060,1996-06-07,"R10","Footscray",10,9,69,"North Melbourne",12,17,89,"M.C.G.",-20,1996,"Regular",10,"Away","North Melbourne","Footscray",20
11061,1996-06-08,"R10","Geelong",14,14,98,"Brisbane Lions",15,8,98,"Kardinia Park",0,1996,"Regular",10,"Home","Geelong","Brisbane Lions",0
11062,1996-06-08,"R10","Carlton",15,11,101,"Richmond",13,12,90,"M.C.G.",11,1996,"Regular",10,"Home","Carlton","Richmond",11
11063,1996-06-08,"R10","Fitzroy",10,7,67,"Sydney",21,11,137,"Western Oval",-70,1996,"Regular",10,"Away","Sydney","Fitzroy",70
11064,1996-06-08,"R10","St Kilda",9,13,67,"Essendon",13,11,89,"Waverley Park",-22,1996,"Regular",10,"Away","Essendon","St Kilda",22
11065,1996-06-09,"R10","Fremantle",7,11,53,"Hawthorn",17,8,110,"Subiaco",-57,1996,"Regular",10,"Away","Hawthorn","Fremantle",57
11066,1996-06-09,"R10","Adelaide",11,10,76,"West Coast",19,16,130,"Football Park",-54,1996,"Regular",10,"Away","West Coast","Adelaide",54
11067,1996-06-10,"R10","Melbourne",17,12,114,"Collingwood",10,16,76,"M.C.G.",38,1996,"Regular",10,"Home","Melbourne","Collingwood",38
11068,1996-06-15,"R11","Hawthorn",16,12,108,"Adelaide",14,15,99,"Waverley Park",9,1996,"Regular",11,"Home","Hawthorn","Adelaide",9
11069,1996-06-15,"R11","Geelong",20,9,129,"Footscray",12,13,85,"Kardinia Park",44,1996,"Regular",11,"Home","Geelong","Footscray",44
11070,1996-06-15,"R11","North Melbourne",10,13,73,"Sydney",24,8,152,"Princes Park",-79,1996,"Regular",11,"Away","Sydney","North Melbourne",79
11071,1996-06-15,"R11","Richmond",21,13,139,"St Kilda",15,15,105,"M.C.G.",34,1996,"Regular",11,"Home","Richmond","St Kilda",34
11072,1996-06-15,"R11","Brisbane Lions",5,8,38,"Carlton",9,8,62,"Gabba",-24,1996,"Regular",11,"Away","Carlton","Brisbane Lions",24
11073,1996-06-16,"R11","West Coast",16,19,115,"Collingwood",9,8,62,"Subiaco",53,1996,"Regular",11,"Home","West Coast","Collingwood",53
11074,1996-06-16,"R11","Essendon",13,12,90,"Fremantle",12,17,89,"M.C.G.",1,1996,"Regular",11,"Home","Essendon","Fremantle",1
11075,1996-06-16,"R11","Fitzroy",8,8,56,"Melbourne",18,11,119,"Western Oval",-63,1996,"Regular",11,"Away","Melbourne","Fitzroy",63
11076,1996-06-21,"R12","Richmond",19,14,128,"Adelaide",13,4,82,"M.C.G.",46,1996,"Regular",12,"Home","Richmond","Adelaide",46
11077,1996-06-22,"R12","Collingwood",14,11,95,"Carlton",17,14,116,"M.C.G.",-21,1996,"Regular",12,"Away","Carlton","Collingwood",21
11078,1996-06-22,"R12","Hawthorn",17,12,114,"Fitzroy",12,11,83,"Waverley Park",31,1996,"Regular",12,"Home","Hawthorn","Fitzroy",31
11079,1996-06-22,"R12","Geelong",17,10,112,"Fremantle",13,15,93,"Kardinia Park",19,1996,"Regular",12,"Home","Geelong","Fremantle",19
11080,1996-06-22,"R12","Brisbane Lions",18,15,123,"Melbourne",6,10,46,"Gabba",77,1996,"Regular",12,"Home","Brisbane Lions","Melbourne",77
11081,1996-06-23,"R12","Sydney",18,15,123,"Footscray",11,11,77,"S.C.G.",46,1996,"Regular",12,"Home","Sydney","Footscray",46
11082,1996-06-23,"R12","North Melbourne",16,11,107,"Essendon",14,11,95,"M.C.G.",12,1996,"Regular",12,"Home","North Melbourne","Essendon",12
11083,1996-06-23,"R12","West Coast",22,9,141,"St Kilda",17,6,108,"Subiaco",33,1996,"Regular",12,"Home","West Coast","St Kilda",33
11084,1996-06-28,"R13","Collingwood",10,9,69,"Richmond",14,8,92,"M.C.G.",-23,1996,"Regular",13,"Away","Richmond","Collingwood",23
11085,1996-06-29,"R13","St Kilda",14,12,96,"Brisbane Lions",7,8,50,"Waverley Park",46,1996,"Regular",13,"Home","St Kilda","Brisbane Lions",46
11086,1996-06-29,"R13","Carlton",13,13,91,"Sydney",15,12,102,"Princes Park",-11,1996,"Regular",13,"Away","Sydney","Carlton",11
11087,1996-06-29,"R13","Essendon",18,13,121,"Hawthorn",15,10,100,"M.C.G.",21,1996,"Regular",13,"Home","Essendon","Hawthorn",21
11088,1996-06-29,"R13","Fitzroy",6,3,39,"Geelong",25,16,166,"Western Oval",-127,1996,"Regular",13,"Away","Geelong","Fitzroy",127
11089,1996-06-29,"R13","Fremantle",8,10,58,"North Melbourne",9,20,74,"W.A.C.A.",-16,1996,"Regular",13,"Away","North Melbourne","Fremantle",16
11090,1996-06-30,"R13","Adelaide",10,12,72,"Melbourne",19,9,123,"Football Park",-51,1996,"Regular",13,"Away","Melbourne","Adelaide",51
11091,1996-06-30,"R13","Footscray",9,5,59,"West Coast",11,5,71,"Western Oval",-12,1996,"Regular",13,"Away","West Coast","Footscray",12
11092,1996-07-05,"R14","North Melbourne",21,18,144,"Carlton",13,11,89,"M.C.G.",55,1996,"Regular",14,"Home","North Melbourne","Carlton",55
11093,1996-07-06,"R14","Hawthorn",17,12,114,"Collingwood",11,15,81,"Waverley Park",33,1996,"Regular",14,"Home","Hawthorn","Collingwood",33
11094,1996-07-06,"R14","Fitzroy",7,10,52,"Essendon",17,16,118,"Princes Park",-66,1996,"Regular",14,"Away","Essendon","Fitzroy",66
11095,1996-07-06,"R14","Richmond",7,9,51,"West Coast",10,8,68,"M.C.G.",-17,1996,"Regular",14,"Away","West Coast","Richmond",17
11096,1996-07-06,"R14","Adelaide",15,12,102,"Brisbane Lions",14,10,94,"Football Park",8,1996,"Regular",14,"Home","Adelaide","Brisbane Lions",8
11097,1996-07-07,"R14","Sydney",18,17,125,"Geelong",11,8,74,"S.C.G.",51,1996,"Regular",14,"Home","Sydney","Geelong",51
11098,1996-07-07,"R14","Melbourne",14,10,94,"Footscray",10,7,67,"M.C.G.",27,1996,"Regular",14,"Home","Melbourne","Footscray",27
11099,1996-07-07,"R14","Fremantle",11,11,77,"St Kilda",15,10,100,"Subiaco",-23,1996,"Regular",14,"Away","St Kilda","Fremantle",23
11100,1996-07-12,"R15","West Coast",20,11,131,"Fitzroy",9,9,63,"W.A.C.A.",68,1996,"Regular",15,"Home","West Coast","Fitzroy",68
11101,1996-07-13,"R15","Carlton",19,17,131,"Adelaide",9,10,64,"Princes Park",67,1996,"Regular",15,"Home","Carlton","Adelaide",67
11102,1996-07-13,"R15","Collingwood",22,12,144,"North Melbourne",12,11,83,"M.C.G.",61,1996,"Regular",15,"Home","Collingwood","North Melbourne",61
11103,1996-07-13,"R15","Geelong",10,12,72,"Hawthorn",11,8,74,"Kardinia Park",-2,1996,"Regular",15,"Away","Hawthorn","Geelong",2
11104,1996-07-13,"R15","St Kilda",11,13,79,"Sydney",14,12,96,"Waverley Park",-17,1996,"Regular",15,"Away","Sydney","St Kilda",17
11105,1996-07-14,"R15","Brisbane Lions",15,13,103,"Essendon",10,8,68,"Gabba",35,1996,"Regular",15,"Home","Brisbane Lions","Essendon",35
11106,1996-07-14,"R15","Footscray",18,9,117,"Fremantle",15,9,99,"Western Oval",18,1996,"Regular",15,"Home","Footscray","Fremantle",18
11107,1996-07-14,"R15","Melbourne",12,9,81,"Richmond",18,19,127,"M.C.G.",-46,1996,"Regular",15,"Away","Richmond","Melbourne",46
11108,1996-07-19,"R16","North Melbourne",17,16,118,"St Kilda",4,5,29,"M.C.G.",89,1996,"Regular",16,"Home","North Melbourne","St Kilda",89
11109,1996-07-20,"R16","Footscray",3,4,22,"Brisbane Lions",4,12,36,"Western Oval",-14,1996,"Regular",16,"Away","Brisbane Lions","Footscray",14
11110,1996-07-20,"R16","Essendon",15,18,108,"Richmond",13,10,88,"M.C.G.",20,1996,"Regular",16,"Home","Essendon","Richmond",20
11111,1996-07-20,"R16","Geelong",13,10,88,"Melbourne",4,6,30,"Kardinia Park",58,1996,"Regular",16,"Home","Geelong","Melbourne",58
11112,1996-07-20,"R16","Hawthorn",15,8,98,"Carlton",7,7,49,"Waverley Park",49,1996,"Regular",16,"Home","Hawthorn","Carlton",49
11113,1996-07-21,"R16","Sydney",16,14,110,"Adelaide",12,16,88,"S.C.G.",22,1996,"Regular",16,"Home","Sydney","Adelaide",22
11114,1996-07-21,"R16","Collingwood",17,14,116,"Fitzroy",10,16,76,"Victoria Park",40,1996,"Regular",16,"Home","Collingwood","Fitzroy",40
11115,1996-07-21,"R16","West Coast",12,10,82,"Fremantle",7,6,48,"Subiaco",34,1996,"Regular",16,"Home","West Coast","Fremantle",34
11116,1996-07-26,"R17","Melbourne",11,4,70,"North Melbourne",28,15,183,"M.C.G.",-113,1996,"Regular",17,"Away","North Melbourne","Melbourne",113
11117,1996-07-27,"R17","Brisbane Lions",25,13,163,"West Coast",17,14,116,"Gabba",47,1996,"Regular",17,"Home","Brisbane Lions","West Coast",47
11118,1996-07-27,"R17","Carlton",13,13,91,"Essendon",11,16,82,"M.C.G.",9,1996,"Regular",17,"Home","Carlton","Essendon",9
11119,1996-07-27,"R17","St Kilda",14,16,100,"Geelong",11,10,76,"Waverley Park",24,1996,"Regular",17,"Home","St Kilda","Geelong",24
11120,1996-07-27,"R17","Richmond",17,12,114,"Hawthorn",11,7,73,"Princes Park",41,1996,"Regular",17,"Home","Richmond","Hawthorn",41
11121,1996-07-28,"R17","Adelaide",26,10,166,"Fitzroy",9,13,67,"Football Park",99,1996,"Regular",17,"Home","Adelaide","Fitzroy",99
11122,1996-07-28,"R17","Footscray",16,12,108,"Collingwood",17,12,114,"M.C.G.",-6,1996,"Regular",17,"Away","Collingwood","Footscray",6
11123,1996-07-28,"R17","Fremantle",15,14,104,"Sydney",12,6,78,"Subiaco",26,1996,"Regular",17,"Home","Fremantle","Sydney",26
11124,1996-08-02,"R18","North Melbourne",19,16,130,"Hawthorn",15,9,99,"M.C.G.",31,1996,"Regular",18,"Home","North Melbourne","Hawthorn",31
11125,1996-08-03,"R18","Geelong",15,14,104,"Adelaide",10,9,69,"Kardinia Park",35,1996,"Regular",18,"Home","Geelong","Adelaide",35
11126,1996-08-03,"R18","Carlton",23,7,145,"Fremantle",11,18,84,"Princes Park",61,1996,"Regular",18,"Home","Carlton","Fremantle",61
11127,1996-08-03,"R18","St Kilda",13,10,88,"Collingwood",11,12,78,"Waverley Park",10,1996,"Regular",18,"Home","St Kilda","Collingwood",10
11128,1996-08-04,"R18","Sydney",17,13,115,"Melbourne",6,16,52,"S.C.G.",63,1996,"Regular",18,"Home","Sydney","Melbourne",63
11129,1996-08-04,"R18","Richmond",7,11,53,"Brisbane Lions",9,16,70,"Princes Park",-17,1996,"Regular",18,"Away","Brisbane Lions","Richmond",17
11130,1996-08-04,"R18","Fitzroy",6,9,45,"Footscray",8,12,60,"Western Oval",-15,1996,"Regular",18,"Away","Footscray","Fitzroy",15
11131,1996-08-04,"R18","West Coast",14,15,99,"Essendon",14,9,93,"Subiaco",6,1996,"Regular",18,"Home","West Coast","Essendon",6
11132,1996-08-09,"R19","Fremantle",15,16,106,"Collingwood",11,16,82,"W.A.C.A.",24,1996,"Regular",19,"Home","Fremantle","Collingwood",24
11133,1996-08-10,"R19","Essendon",21,17,143,"Adelaide",16,11,107,"Princes Park",36,1996,"Regular",19,"Home","Essendon","Adelaide",36
11134,1996-08-10,"R19","Melbourne",20,9,129,"Carlton",17,8,110,"M.C.G.",19,1996,"Regular",19,"Home","Melbourne","Carlton",19
11135,1996-08-10,"R19","Fitzroy",5,5,35,"St Kilda",13,10,88,"Western Oval",-53,1996,"Regular",19,"Away","St Kilda","Fitzroy",53
11136,1996-08-10,"R19","Geelong",18,19,127,"West Coast",12,10,82,"Kardinia Park",45,1996,"Regular",19,"Home","Geelong","West Coast",45
11137,1996-08-10,"R19","Hawthorn",20,12,132,"Footscray",10,5,65,"Waverley Park",67,1996,"Regular",19,"Home","Hawthorn","Footscray",67
11138,1996-08-11,"R19","North Melbourne",8,11,59,"Brisbane Lions",11,11,77,"Princes Park",-18,1996,"Regular",19,"Away","Brisbane Lions","North Melbourne",18
11139,1996-08-11,"R19","Sydney",20,10,130,"Richmond",12,10,82,"S.C.G.",48,1996,"Regular",19,"Home","Sydney","Richmond",48
11140,1996-08-16,"R20","Melbourne",13,14,92,"Fremantle",10,11,71,"M.C.G.",21,1996,"Regular",20,"Home","Melbourne","Fremantle",21
11141,1996-08-17,"R20","Fitzroy",14,16,100,"Brisbane Lions",29,13,187,"Princes Park",-87,1996,"Regular",20,"Away","Brisbane Lions","Fitzroy",87
11142,1996-08-17,"R20","Richmond",19,18,132,"Geelong",9,13,67,"M.C.G.",65,1996,"Regular",20,"Home","Richmond","Geelong",65
11143,1996-08-17,"R20","Hawthorn",7,7,49,"Sydney",9,18,72,"Waverley Park",-23,1996,"Regular",20,"Away","Sydney","Hawthorn",23
11144,1996-08-17,"R20","Adelaide",10,10,70,"North Melbourne",10,16,76,"Football Park",-6,1996,"Regular",20,"Away","North Melbourne","Adelaide",6
11145,1996-08-18,"R20","West Coast",19,13,127,"Carlton",10,8,68,"Subiaco",59,1996,"Regular",20,"Home","West Coast","Carlton",59
11146,1996-08-18,"R20","Collingwood",9,10,64,"Essendon",11,11,77,"M.C.G.",-13,1996,"Regular",20,"Away","Essendon","Collingwood",13
11147,1996-08-18,"R20","Footscray",14,11,95,"St Kilda",8,9,57,"Princes Park",38,1996,"Regular",20,"Home","Footscray","St Kilda",38
11148,1996-08-23,"R21","North Melbourne",14,12,96,"Geelong",16,13,109,"M.C.G.",-13,1996,"Regular",21,"Away","Geelong","North Melbourne",13
11149,1996-08-24,"R21","Carlton",13,18,96,"Footscray",9,12,66,"Princes Park",30,1996,"Regular",21,"Home","Carlton","Footscray",30
11150,1996-08-24,"R21","Essendon",14,16,100,"Sydney",12,10,82,"M.C.G.",18,1996,"Regular",21,"Home","Essendon","Sydney",18
11151,1996-08-24,"R21","St Kilda",9,9,63,"Hawthorn",12,8,80,"Waverley Park",-17,1996,"Regular",21,"Away","Hawthorn","St Kilda",17
11152,1996-08-24,"R21","Brisbane Lions",10,11,71,"Fremantle",10,10,70,"Gabba",1,1996,"Regular",21,"Home","Brisbane Lions","Fremantle",1
11153,1996-08-25,"R21","Richmond",28,19,187,"Fitzroy",5,6,36,"M.C.G.",151,1996,"Regular",21,"Home","Richmond","Fitzroy",151
11154,1996-08-25,"R21","West Coast",24,7,151,"Melbourne",11,12,78,"Subiaco",73,1996,"Regular",21,"Home","West Coast","Melbourne",73
11155,1996-08-25,"R21","Adelaide",14,12,96,"Collingwood",24,9,153,"Football Park",-57,1996,"Regular",21,"Away","Collingwood","Adelaide",57
11156,1996-08-30,"R22","Essendon",11,13,79,"Footscray",11,10,76,"M.C.G.",3,1996,"Regular",22,"Home","Essendon","Footscray",3
11157,1996-08-31,"R22","St Kilda",20,24,144,"Adelaide",11,9,75,"Waverley Park",69,1996,"Regular",22,"Home","St Kilda","Adelaide",69
11158,1996-08-31,"R22","Collingwood",15,10,100,"Brisbane Lions",6,15,51,"Victoria Park",49,1996,"Regular",22,"Home","Collingwood","Brisbane Lions",49
11159,1996-08-31,"R22","Geelong",9,11,65,"Carlton",16,11,107,"Kardinia Park",-42,1996,"Regular",22,"Away","Carlton","Geelong",42
11160,1996-08-31,"R22","Melbourne",15,11,101,"Hawthorn",15,12,102,"M.C.G.",-1,1996,"Regular",22,"Away","Hawthorn","Melbourne",1
11161,1996-08-31,"R22","Sydney",12,13,85,"West Coast",6,14,50,"S.C.G.",35,1996,"Regular",22,"Home","Sydney","West Coast",35
11162,1996-09-01,"R22","Fremantle",24,13,157,"Fitzroy",10,11,71,"Subiaco",86,1996,"Regular",22,"Home","Fremantle","Fitzroy",86
11163,1996-09-01,"R22","Richmond",16,13,109,"North Melbourne",21,15,141,"M.C.G.",-32,1996,"Regular",22,"Away","North Melbourne","Richmond",32
11164,1996-09-06,"QF","Brisbane Lions",15,11,101,"Essendon",15,10,100,"Gabba",1,1996,"Finals",23,"Home","Brisbane Lions","Essendon",1
11165,1996-09-07,"QF","West Coast",18,17,125,"Carlton",10,10,70,"Subiaco",55,1996,"Finals",23,"Home","West Coast","Carlton",55
11166,1996-09-07,"QF","Sydney",13,12,90,"Hawthorn",12,12,84,"S.C.G.",6,1996,"Finals",23,"Home","Sydney","Hawthorn",6
11167,1996-09-08,"QF","North Melbourne",19,17,131,"Geelong",9,17,71,"M.C.G.",60,1996,"Finals",23,"Home","North Melbourne","Geelong",60
11168,1996-09-14,"SF","West Coast",8,19,67,"Essendon",22,12,144,"M.C.G.",-77,1996,"Finals",24,"Away","Essendon","West Coast",77
11169,1996-09-14,"SF","Brisbane Lions",26,14,170,"Carlton",10,13,73,"Gabba",97,1996,"Finals",24,"Home","Brisbane Lions","Carlton",97
11170,1996-09-21,"PF","North Melbourne",17,12,114,"Brisbane Lions",11,10,76,"M.C.G.",38,1996,"Finals",25,"Home","North Melbourne","Brisbane Lions",38
11171,1996-09-21,"PF","Sydney",10,10,70,"Essendon",10,9,69,"S.C.G.",1,1996,"Finals",25,"Home","Sydney","Essendon",1
11172,1996-09-28,"GF","Sydney",13,10,88,"North Melbourne",19,17,131,"M.C.G.",-43,1996,"Finals",26,"Away","North Melbourne","Sydney",43
11173,1997-03-27,"R1","North Melbourne",7,13,55,"Melbourne",10,10,70,"M.C.G.",-15,1997,"Regular",1,"Away","Melbourne","North Melbourne",15
11174,1997-03-29,"R1","Collingwood",26,10,166,"Port Adelaide",13,9,87,"M.C.G.",79,1997,"Regular",1,"Home","Collingwood","Port Adelaide",79
11175,1997-03-29,"R1","Footscray",11,10,76,"Fremantle",10,20,80,"Princes Park",-4,1997,"Regular",1,"Away","Fremantle","Footscray",4
11176,1997-03-29,"R1","St Kilda",10,11,71,"Hawthorn",11,11,77,"Waverley Park",-6,1997,"Regular",1,"Away","Hawthorn","St Kilda",6
11177,1997-03-29,"R1","West Coast",12,6,78,"Sydney",5,7,37,"Subiaco",41,1997,"Regular",1,"Home","West Coast","Sydney",41
11178,1997-03-30,"R1","Adelaide",20,12,132,"Brisbane Lions",14,12,96,"Football Park",36,1997,"Regular",1,"Home","Adelaide","Brisbane Lions",36
11179,1997-03-30,"R1","Richmond",15,14,104,"Geelong",13,17,95,"M.C.G.",9,1997,"Regular",1,"Home","Richmond","Geelong",9
11180,1997-03-31,"R1","Essendon",16,10,106,"Carlton",15,9,99,"M.C.G.",7,1997,"Regular",1,"Home","Essendon","Carlton",7
11181,1997-04-04,"R2","Melbourne",7,14,56,"Collingwood",24,19,163,"M.C.G.",-107,1997,"Regular",2,"Away","Collingwood","Melbourne",107
11182,1997-04-05,"R2","Richmond",19,14,128,"Adelaide",15,10,100,"M.C.G.",28,1997,"Regular",2,"Home","Richmond","Adelaide",28
11183,1997-04-05,"R2","Footscray",13,12,90,"Sydney",12,11,83,"Princes Park",7,1997,"Regular",2,"Home","Footscray","Sydney",7
11184,1997-04-05,"R2","Geelong",11,12,78,"West Coast",11,6,72,"Kardinia Park",6,1997,"Regular",2,"Home","Geelong","West Coast",6
11185,1997-04-06,"R2","Brisbane Lions",23,16,154,"St Kilda",7,15,57,"Gabba",97,1997,"Regular",2,"Home","Brisbane Lions","St Kilda",97
11186,1997-04-06,"R2","Port Adelaide",8,12,60,"Essendon",14,9,93,"Football Park",-33,1997,"Regular",2,"Away","Essendon","Port Adelaide",33
11187,1997-04-06,"R2","Fremantle",13,9,87,"Hawthorn",10,13,73,"Subiaco",14,1997,"Regular",2,"Home","Fremantle","Hawthorn",14
11188,1997-04-07,"R2","North Melbourne",12,14,86,"Carlton",8,12,60,"M.C.G.",26,1997,"Regular",2,"Home","North Melbourne","Carlton",26
11189,1997-04-11,"R3","Sydney",15,9,99,"Melbourne",14,7,91,"S.C.G.",8,1997,"Regular",3,"Home","Sydney","Melbourne",8
11190,1997-04-12,"R3","St Kilda",19,11,125,"Collingwood",17,16,118,"Waverley Park",7,1997,"Regular",3,"Home","St Kilda","Collingwood",7
11191,1997-04-12,"R3","Footscray",16,9,105,"Richmond",12,14,86,"M.C.G.",19,1997,"Regular",3,"Home","Footscray","Richmond",19
11192,1997-04-12,"R3","Port Adelaide",18,21,129,"Geelong",14,6,90,"Football Park",39,1997,"Regular",3,"Home","Port Adelaide","Geelong",39
11193,1997-04-13,"R3","Carlton",15,18,108,"Adelaide",12,8,80,"Princes Park",28,1997,"Regular",3,"Home","Carlton","Adelaide",28
11194,1997-04-13,"R3","Essendon",18,14,122,"North Melbourne",12,8,80,"M.C.G.",42,1997,"Regular",3,"Home","Essendon","North Melbourne",42
11195,1997-04-13,"R3","West Coast",16,15,111,"Fremantle",9,17,71,"Subiaco",40,1997,"Regular",3,"Home","West Coast","Fremantle",40
11196,1997-04-13,"R3","Hawthorn",12,15,87,"Brisbane Lions",11,9,75,"Waverley Park",12,1997,"Regular",3,"Home","Hawthorn","Brisbane Lions",12
11197,1997-04-18,"R4","Melbourne",13,9,87,"Footscray",13,11,89,"M.C.G.",-2,1997,"Regular",4,"Away","Footscray","Melbourne",2
11198,1997-04-19,"R4","Collingwood",12,12,84,"Carlton",15,11,101,"M.C.G.",-17,1997,"Regular",4,"Away","Carlton","Collingwood",17
11199,1997-04-19,"R4","Richmond",10,12,72,"Fremantle",10,7,67,"Princes Park",5,1997,"Regular",4,"Home","Richmond","Fremantle",5
11200,1997-04-19,"R4","St Kilda",12,9,81,"Sydney",18,19,127,"Waverley Park",-46,1997,"Regular",4,"Away","Sydney","St Kilda",46
11201,1997-04-19,"R4","West Coast",17,10,112,"Hawthorn",13,10,88,"Subiaco",24,1997,"Regular",4,"Home","West Coast","Hawthorn",24
11202,1997-04-20,"R4","Brisbane Lions",15,19,109,"North Melbourne",12,11,83,"Gabba",26,1997,"Regular",4,"Home","Brisbane Lions","North Melbourne",26
11203,1997-04-20,"R4","Geelong",11,19,85,"Essendon",11,12,78,"M.C.G.",7,1997,"Regular",4,"Home","Geelong","Essendon",7
11204,1997-04-20,"R4","Adelaide",11,6,72,"Port Adelaide",11,17,83,"Football Park",-11,1997,"Regular",4,"Away","Port Adelaide","Adelaide",11
11205,1997-04-25,"R5","Essendon",10,10,70,"Collingwood",14,15,99,"M.C.G.",-29,1997,"Regular",5,"Away","Collingwood","Essendon",29
11206,1997-04-25,"R5","Fremantle",16,11,107,"St Kilda",15,11,101,"Subiaco",6,1997,"Regular",5,"Home","Fremantle","St Kilda",6
11207,1997-04-26,"R5","Footscray",9,17,71,"Adelaide",19,7,121,"Princes Park",-50,1997,"Regular",5,"Away","Adelaide","Footscray",50
11208,1997-04-26,"R5","Melbourne",12,6,78,"West Coast",19,12,126,"M.C.G.",-48,1997,"Regular",5,"Away","West Coast","Melbourne",48
11209,1997-04-26,"R5","Hawthorn",15,9,99,"Sydney",11,8,74,"Waverley Park",25,1997,"Regular",5,"Home","Hawthorn","Sydney",25
11210,1997-04-27,"R5","Carlton",12,14,86,"Geelong",13,16,94,"Princes Park",-8,1997,"Regular",5,"Away","Geelong","Carlton",8
11211,1997-04-27,"R5","North Melbourne",21,15,141,"Richmond",7,4,46,"M.C.G.",95,1997,"Regular",5,"Home","North Melbourne","Richmond",95
11212,1997-04-27,"R5","Port Adelaide",10,13,73,"Brisbane Lions",10,11,71,"Football Park",2,1997,"Regular",5,"Home","Port Adelaide","Brisbane Lions",2
11213,1997-05-02,"R6","West Coast",14,15,99,"Footscray",17,11,113,"W.A.C.A.",-14,1997,"Regular",6,"Away","Footscray","West Coast",14
11214,1997-05-03,"R6","Collingwood",13,6,84,"Adelaide",11,17,83,"Victoria Park",1,1997,"Regular",6,"Home","Collingwood","Adelaide",1
11215,1997-05-03,"R6","Essendon",15,12,102,"Brisbane Lions",9,17,71,"M.C.G.",31,1997,"Regular",6,"Home","Essendon","Brisbane Lions",31
11216,1997-05-03,"R6","Geelong",14,13,97,"Fremantle",6,7,43,"Kardinia Park",54,1997,"Regular",6,"Home","Geelong","Fremantle",54
11217,1997-05-03,"R6","Hawthorn",14,9,93,"North Melbourne",16,7,103,"Waverley Park",-10,1997,"Regular",6,"Away","North Melbourne","Hawthorn",10
11218,1997-05-04,"R6","Sydney",21,16,142,"Carlton",11,17,83,"S.C.G.",59,1997,"Regular",6,"Home","Sydney","Carlton",59
11219,1997-05-04,"R6","St Kilda",17,19,121,"Melbourne",4,11,35,"Waverley Park",86,1997,"Regular",6,"Home","St Kilda","Melbourne",86
11220,1997-05-04,"R6","Port Adelaide",19,8,122,"Richmond",8,10,58,"Football Park",64,1997,"Regular",6,"Home","Port Adelaide","Richmond",64
11221,1997-05-09,"R7","North Melbourne",9,14,68,"Collingwood",17,9,111,"M.C.G.",-43,1997,"Regular",7,"Away","Collingwood","North Melbourne",43
11222,1997-05-10,"R7","Richmond",10,16,76,"Carlton",14,14,98,"M.C.G.",-22,1997,"Regular",7,"Away","Carlton","Richmond",22
11223,1997-05-10,"R7","Footscray",19,19,133,"Hawthorn",13,10,88,"Princes Park",45,1997,"Regular",7,"Home","Footscray","Hawthorn",45
11224,1997-05-10,"R7","Geelong",11,10,76,"Sydney",6,8,44,"Kardinia Park",32,1997,"Regular",7,"Home","Geelong","Sydney",32
11225,1997-05-10,"R7","St Kilda",20,6,126,"Port Adelaide",8,13,61,"Waverley Park",65,1997,"Regular",7,"Home","St Kilda","Port Adelaide",65
11226,1997-05-10,"R7","Fremantle",17,22,124,"Melbourne",10,9,69,"W.A.C.A.",55,1997,"Regular",7,"Home","Fremantle","Melbourne",55
11227,1997-05-11,"R7","Brisbane Lions",8,12,60,"West Coast",21,13,139,"Gabba",-79,1997,"Regular",7,"Away","West Coast","Brisbane Lions",79
11228,1997-05-11,"R7","Adelaide",18,18,126,"Essendon",11,7,73,"Football Park",53,1997,"Regular",7,"Home","Adelaide","Essendon",53
11229,1997-05-16,"R8","Collingwood",19,15,129,"Footscray",11,17,83,"M.C.G.",46,1997,"Regular",8,"Home","Collingwood","Footscray",46
11230,1997-05-17,"R8","Melbourne",7,7,49,"Geelong",19,14,128,"M.C.G.",-79,1997,"Regular",8,"Away","Geelong","Melbourne",79
11231,1997-05-17,"R8","North Melbourne",19,14,128,"Port Adelaide",15,10,100,"Princes Park",28,1997,"Regular",8,"Home","North Melbourne","Port Adelaide",28
11232,1997-05-17,"R8","Adelaide",22,12,144,"Sydney",8,7,55,"Football Park",89,1997,"Regular",8,"Home","Adelaide","Sydney",89
11233,1997-05-18,"R8","Carlton",15,16,106,"Hawthorn",12,9,81,"Princes Park",25,1997,"Regular",8,"Home","Carlton","Hawthorn",25
11234,1997-05-18,"R8","Essendon",14,16,100,"St Kilda",18,16,124,"M.C.G.",-24,1997,"Regular",8,"Away","St Kilda","Essendon",24
11235,1997-05-18,"R8","Fremantle",14,14,98,"Brisbane Lions",15,3,93,"Subiaco",5,1997,"Regular",8,"Home","Fremantle","Brisbane Lions",5
11236,1997-05-19,"R8","Richmond",18,11,119,"West Coast",9,13,67,"M.C.G.",52,1997,"Regular",8,"Home","Richmond","West Coast",52
11237,1997-05-23,"R9","Port Adelaide",10,18,78,"Melbourne",3,9,27,"Football Park",51,1997,"Regular",9,"Home","Port Adelaide","Melbourne",51
11238,1997-05-24,"R9","Hawthorn",13,10,88,"Adelaide",14,18,102,"Waverley Park",-14,1997,"Regular",9,"Away","Adelaide","Hawthorn",14
11239,1997-05-24,"R9","Carlton",16,9,105,"Fremantle",14,4,88,"Princes Park",17,1997,"Regular",9,"Home","Carlton","Fremantle",17
11240,1997-05-24,"R9","Sydney",16,15,111,"Collingwood",11,8,74,"S.C.G.",37,1997,"Regular",9,"Home","Sydney","Collingwood",37
11241,1997-05-25,"R9","Brisbane Lions",19,12,126,"Geelong",15,8,98,"Gabba",28,1997,"Regular",9,"Home","Brisbane Lions","Geelong",28
11242,1997-05-25,"R9","Footscray",16,7,103,"North Melbourne",10,11,71,"M.C.G.",32,1997,"Regular",9,"Home","Footscray","North Melbourne",32
11243,1997-05-25,"R9","St Kilda",22,9,141,"Richmond",14,10,94,"Waverley Park",47,1997,"Regular",9,"Home","St Kilda","Richmond",47
11244,1997-05-25,"R9","West Coast",16,14,110,"Essendon",13,7,85,"Subiaco",25,1997,"Regular",9,"Home","West Coast","Essendon",25
11245,1997-05-30,"R10","Port Adelaide",14,9,93,"Carlton",7,13,55,"Football Park",38,1997,"Regular",10,"Home","Port Adelaide","Carlton",38
11246,1997-05-31,"R10","Hawthorn",16,12,108,"Collingwood",8,7,55,"Waverley Park",53,1997,"Regular",10,"Home","Hawthorn","Collingwood",53
11247,1997-05-31,"R10","Geelong",16,11,107,"St Kilda",11,13,79,"Kardinia Park",28,1997,"Regular",10,"Home","Geelong","St Kilda",28
11248,1997-05-31,"R10","North Melbourne",15,13,103,"West Coast",9,4,58,"Princes Park",45,1997,"Regular",10,"Home","North Melbourne","West Coast",45
11249,1997-05-31,"R10","Richmond",9,13,67,"Melbourne",14,8,92,"M.C.G.",-25,1997,"Regular",10,"Away","Melbourne","Richmond",25
11250,1997-06-01,"R10","Essendon",17,12,114,"Footscray",20,16,136,"M.C.G.",-22,1997,"Regular",10,"Away","Footscray","Essendon",22
11251,1997-06-01,"R10","Brisbane Lions",13,14,92,"Sydney",13,11,89,"Gabba",3,1997,"Regular",10,"Home","Brisbane Lions","Sydney",3
11252,1997-06-02,"R10","Fremantle",10,12,72,"Adelaide",16,9,105,"Subiaco",-33,1997,"Regular",10,"Away","Adelaide","Fremantle",33
11253,1997-06-06,"R11","Collingwood",10,11,71,"Richmond",11,11,77,"M.C.G.",-6,1997,"Regular",11,"Away","Richmond","Collingwood",6
11254,1997-06-07,"R11","Essendon",13,13,91,"Hawthorn",17,22,124,"M.C.G.",-33,1997,"Regular",11,"Away","Hawthorn","Essendon",33
11255,1997-06-07,"R11","Footscray",14,12,96,"Geelong",11,9,75,"Princes Park",21,1997,"Regular",11,"Home","Footscray","Geelong",21
11256,1997-06-07,"R11","Port Adelaide",4,17,41,"Sydney",10,16,76,"Football Park",-35,1997,"Regular",11,"Away","Sydney","Port Adelaide",35
11257,1997-06-08,"R11","Melbourne",5,15,45,"Adelaide",14,13,97,"M.C.G.",-52,1997,"Regular",11,"Away","Adelaide","Melbourne",52
11258,1997-06-08,"R11","West Coast",11,7,73,"St Kilda",13,11,89,"Subiaco",-16,1997,"Regular",11,"Away","St Kilda","West Coast",16
11259,1997-06-09,"R11","Carlton",12,12,84,"Brisbane Lions",9,9,63,"Princes Park",21,1997,"Regular",11,"Home","Carlton","Brisbane Lions",21
11260,1997-06-09,"R11","North Melbourne",15,15,105,"Fremantle",12,7,79,"M.C.G.",26,1997,"Regular",11,"Home","North Melbourne","Fremantle",26
11261,1997-06-13,"R12","Sydney",26,8,164,"Richmond",16,14,110,"S.C.G.",54,1997,"Regular",12,"Home","Sydney","Richmond",54
11262,1997-06-14,"R12","Collingwood",7,13,55,"West Coast",11,5,71,"Victoria Park",-16,1997,"Regular",12,"Away","West Coast","Collingwood",16
11263,1997-06-14,"R12","Footscray",12,10,82,"Port Adelaide",14,10,94,"Princes Park",-12,1997,"Regular",12,"Away","Port Adelaide","Footscray",12
11264,1997-06-14,"R12","Geelong",12,10,82,"Hawthorn",13,10,88,"Kardinia Park",-6,1997,"Regular",12,"Away","Hawthorn","Geelong",6
11265,1997-06-15,"R12","St Kilda",16,20,116,"Carlton",12,13,85,"Waverley Park",31,1997,"Regular",12,"Home","St Kilda","Carlton",31
11266,1997-06-15,"R12","Fremantle",24,13,157,"Essendon",9,6,60,"Subiaco",97,1997,"Regular",12,"Home","Fremantle","Essendon",97
11267,1997-06-15,"R12","Melbourne",7,8,50,"Brisbane Lions",21,9,135,"M.C.G.",-85,1997,"Regular",12,"Away","Brisbane Lions","Melbourne",85
11268,1997-06-15,"R12","Adelaide",12,11,83,"North Melbourne",16,9,105,"Football Park",-22,1997,"Regular",12,"Away","North Melbourne","Adelaide",22
11269,1997-06-27,"R13","West Coast",11,13,79,"Carlton",12,14,86,"Subiaco",-7,1997,"Regular",13,"Away","Carlton","West Coast",7
11270,1997-06-28,"R13","Geelong",17,8,110,"Adelaide",7,12,54,"Kardinia Park",56,1997,"Regular",13,"Home","Geelong","Adelaide",56
11271,1997-06-28,"R13","Richmond",4,10,34,"Essendon",19,13,127,"M.C.G.",-93,1997,"Regular",13,"Away","Essendon","Richmond",93
11272,1997-06-28,"R13","St Kilda",11,18,84,"Footscray",15,11,101,"Waverley Park",-17,1997,"Regular",13,"Away","Footscray","St Kilda",17
11273,1997-06-28,"R13","Brisbane Lions",11,22,88,"Collingwood",11,7,73,"Gabba",15,1997,"Regular",13,"Home","Brisbane Lions","Collingwood",15
11274,1997-06-28,"R13","Port Adelaide",10,9,69,"Fremantle",7,12,54,"Football Park",15,1997,"Regular",13,"Home","Port Adelaide","Fremantle",15
11275,1997-06-29,"R13","Hawthorn",17,16,118,"Melbourne",7,13,55,"Waverley Park",63,1997,"Regular",13,"Home","Hawthorn","Melbourne",63
11276,1997-06-29,"R13","Sydney",8,17,65,"North Melbourne",7,13,55,"S.C.G.",10,1997,"Regular",13,"Home","Sydney","North Melbourne",10
11277,1997-07-04,"R14","Adelaide",16,10,106,"West Coast",4,7,31,"Football Park",75,1997,"Regular",14,"Home","Adelaide","West Coast",75
11278,1997-07-05,"R14","Carlton",11,8,74,"Footscray",16,14,110,"Princes Park",-36,1997,"Regular",14,"Away","Footscray","Carlton",36
11279,1997-07-05,"R14","Geelong",9,26,80,"Collingwood",10,12,72,"M.C.G.",8,1997,"Regular",14,"Home","Geelong","Collingwood",8
11280,1997-07-05,"R14","St Kilda",20,13,133,"North Melbourne",11,13,79,"Waverley Park",54,1997,"Regular",14,"Home","St Kilda","North Melbourne",54
11281,1997-07-05,"R14","Fremantle",6,12,48,"Sydney",3,15,33,"W.A.C.A.",15,1997,"Regular",14,"Home","Fremantle","Sydney",15
11282,1997-07-06,"R14","Essendon",18,12,120,"Melbourne",8,9,57,"M.C.G.",63,1997,"Regular",14,"Home","Essendon","Melbourne",63
11283,1997-07-06,"R14","Hawthorn",18,16,124,"Port Adelaide",13,14,92,"Waverley Park",32,1997,"Regular",14,"Home","Hawthorn","Port Adelaide",32
11284,1997-07-06,"R14","Brisbane Lions",7,26,68,"Richmond",7,8,50,"Gabba",18,1997,"Regular",14,"Home","Brisbane Lions","Richmond",18
11285,1997-07-11,"R15","North Melbourne",14,8,92,"Geelong",15,12,102,"M.C.G.",-10,1997,"Regular",15,"Away","Geelong","North Melbourne",10
11286,1997-07-12,"R15","Melbourne",18,11,119,"Carlton",15,10,100,"M.C.G.",19,1997,"Regular",15,"Home","Melbourne","Carlton",19
11287,1997-07-12,"R15","Collingwood",25,10,160,"Fremantle",9,6,60,"Victoria Park",100,1997,"Regular",15,"Home","Collingwood","Fremantle",100
11288,1997-07-12,"R15","Footscray",11,7,73,"Brisbane Lions",21,11,137,"Princes Park",-64,1997,"Regular",15,"Away","Brisbane Lions","Footscray",64
11289,1997-07-12,"R15","Adelaide",10,16,76,"St Kilda",9,12,66,"Football Park",10,1997,"Regular",15,"Home","Adelaide","St Kilda",10
11290,1997-07-13,"R15","Sydney",11,13,79,"Essendon",11,12,78,"S.C.G.",1,1997,"Regular",15,"Home","Sydney","Essendon",1
11291,1997-07-13,"R15","Richmond",22,13,145,"Hawthorn",10,9,69,"M.C.G.",76,1997,"Regular",15,"Home","Richmond","Hawthorn",76
11292,1997-07-13,"R15","West Coast",12,13,85,"Port Adelaide",9,13,67,"Subiaco",18,1997,"Regular",15,"Home","West Coast","Port Adelaide",18
11293,1997-07-18,"R16","Brisbane Lions",17,16,118,"Adelaide",13,9,87,"Gabba",31,1997,"Regular",16,"Home","Brisbane Lions","Adelaide",31
11294,1997-07-19,"R16","Carlton",25,15,165,"Essendon",13,9,87,"M.C.G.",78,1997,"Regular",16,"Home","Carlton","Essendon",78
11295,1997-07-19,"R16","Geelong",16,14,110,"Richmond",12,6,78,"Kardinia Park",32,1997,"Regular",16,"Home","Geelong","Richmond",32
11296,1997-07-19,"R16","Hawthorn",9,8,62,"St Kilda",20,21,141,"Waverley Park",-79,1997,"Regular",16,"Away","St Kilda","Hawthorn",79
11297,1997-07-19,"R16","Sydney",15,22,112,"West Coast",11,9,75,"S.C.G.",37,1997,"Regular",16,"Home","Sydney","West Coast",37
11298,1997-07-19,"R16","Port Adelaide",17,9,111,"Collingwood",8,10,58,"Football Park",53,1997,"Regular",16,"Home","Port Adelaide","Collingwood",53
11299,1997-07-20,"R16","Fremantle",15,7,97,"Footscray",13,13,91,"Subiaco",6,1997,"Regular",16,"Home","Fremantle","Footscray",6
11300,1997-07-20,"R16","Melbourne",7,16,58,"North Melbourne",17,12,114,"M.C.G.",-56,1997,"Regular",16,"Away","North Melbourne","Melbourne",56
11301,1997-07-25,"R17","Essendon",10,12,72,"Port Adelaide",18,14,122,"M.C.G.",-50,1997,"Regular",17,"Away","Port Adelaide","Essendon",50
11302,1997-07-26,"R17","Carlton",7,16,58,"North Melbourne",14,12,96,"Princes Park",-38,1997,"Regular",17,"Away","North Melbourne","Carlton",38
11303,1997-07-26,"R17","Hawthorn",9,8,62,"Fremantle",10,11,71,"Waverley Park",-9,1997,"Regular",17,"Away","Fremantle","Hawthorn",9
11304,1997-07-26,"R17","Sydney",22,17,149,"Footscray",7,10,52,"S.C.G.",97,1997,"Regular",17,"Home","Sydney","Footscray",97
11305,1997-07-26,"R17","Adelaide",29,11,185,"Richmond",7,6,48,"Football Park",137,1997,"Regular",17,"Home","Adelaide","Richmond",137
11306,1997-07-27,"R17","Collingwood",20,14,134,"Melbourne",12,10,82,"M.C.G.",52,1997,"Regular",17,"Home","Collingwood","Melbourne",52
11307,1997-07-27,"R17","West Coast",20,9,129,"Geelong",12,10,82,"Subiaco",47,1997,"Regular",17,"Home","West Coast","Geelong",47
11308,1997-07-27,"R17","St Kilda",12,20,92,"Brisbane Lions",5,14,44,"Waverley Park",48,1997,"Regular",17,"Home","St Kilda","Brisbane Lions",48
11309,1997-08-01,"R18","North Melbourne",11,17,83,"Essendon",8,16,64,"M.C.G.",19,1997,"Regular",18,"Home","North Melbourne","Essendon",19
11310,1997-08-02,"R18","Richmond",17,13,115,"Footscray",15,10,100,"Princes Park",15,1997,"Regular",18,"Home","Richmond","Footscray",15
11311,1997-08-02,"R18","Geelong",25,9,159,"Port Adelaide",11,8,74,"Kardinia Park",85,1997,"Regular",18,"Home","Geelong","Port Adelaide",85
11312,1997-08-02,"R18","Melbourne",7,11,53,"Sydney",25,19,169,"M.C.G.",-116,1997,"Regular",18,"Away","Sydney","Melbourne",116
11313,1997-08-02,"R18","Brisbane Lions",21,15,141,"Hawthorn",11,5,71,"Gabba",70,1997,"Regular",18,"Home","Brisbane Lions","Hawthorn",70
11314,1997-08-03,"R18","Adelaide",18,19,127,"Carlton",13,8,86,"Football Park",41,1997,"Regular",18,"Home","Adelaide","Carlton",41
11315,1997-08-03,"R18","Collingwood",12,17,89,"St Kilda",15,21,111,"M.C.G.",-22,1997,"Regular",18,"Away","St Kilda","Collingwood",22
11316,1997-08-03,"R18","Fremantle",7,7,49,"West Coast",13,4,82,"Subiaco",-33,1997,"Regular",18,"Away","West Coast","Fremantle",33
11317,1997-08-08,"R19","North Melbourne",17,14,116,"Brisbane Lions",9,5,59,"M.C.G.",57,1997,"Regular",19,"Home","North Melbourne","Brisbane Lions",57
11318,1997-08-09,"R19","Carlton",14,23,107,"Collingwood",13,13,91,"M.C.G.",16,1997,"Regular",19,"Home","Carlton","Collingwood",16
11319,1997-08-09,"R19","Footscray",14,18,102,"Melbourne",9,10,64,"Princes Park",38,1997,"Regular",19,"Home","Footscray","Melbourne",38
11320,1997-08-09,"R19","Hawthorn",10,6,66,"West Coast",13,9,87,"Waverley Park",-21,1997,"Regular",19,"Away","West Coast","Hawthorn",21
11321,1997-08-09,"R19","Fremantle",12,13,85,"Richmond",5,12,42,"W.A.C.A.",43,1997,"Regular",19,"Home","Fremantle","Richmond",43
11322,1997-08-10,"R19","Sydney",17,17,119,"St Kilda",18,20,128,"S.C.G.",-9,1997,"Regular",19,"Away","St Kilda","Sydney",9
11323,1997-08-10,"R19","Essendon",11,7,73,"Geelong",9,14,68,"M.C.G.",5,1997,"Regular",19,"Home","Essendon","Geelong",5
11324,1997-08-10,"R19","Port Adelaide",9,4,58,"Adelaide",9,11,65,"Football Park",-7,1997,"Regular",19,"Away","Adelaide","Port Adelaide",7
11325,1997-08-15,"R20","West Coast",15,7,97,"Melbourne",7,17,59,"W.A.C.A.",38,1997,"Regular",20,"Home","West Coast","Melbourne",38
11326,1997-08-16,"R20","Geelong",13,17,95,"Carlton",9,13,67,"Kardinia Park",28,1997,"Regular",20,"Home","Geelong","Carlton",28
11327,1997-08-16,"R20","Collingwood",13,13,91,"Essendon",12,9,81,"M.C.G.",10,1997,"Regular",20,"Home","Collingwood","Essendon",10
11328,1997-08-16,"R20","St Kilda",12,5,77,"Fremantle",9,10,64,"Waverley Park",13,1997,"Regular",20,"Home","St Kilda","Fremantle",13
11329,1997-08-16,"R20","Brisbane Lions",13,15,93,"Port Adelaide",13,15,93,"Gabba",0,1997,"Regular",20,"Home","Brisbane Lions","Port Adelaide",0
11330,1997-08-17,"R20","Sydney",20,15,135,"Hawthorn",11,11,77,"S.C.G.",58,1997,"Regular",20,"Home","Sydney","Hawthorn",58
11331,1997-08-17,"R20","Richmond",14,13,97,"North Melbourne",14,12,96,"M.C.G.",1,1997,"Regular",20,"Home","Richmond","North Melbourne",1
11332,1997-08-17,"R20","Adelaide",7,18,60,"Footscray",16,7,103,"Football Park",-43,1997,"Regular",20,"Away","Footscray","Adelaide",43
11333,1997-08-22,"R21","Melbourne",8,14,62,"St Kilda",17,12,114,"M.C.G.",-52,1997,"Regular",21,"Away","St Kilda","Melbourne",52
11334,1997-08-23,"R21","Carlton",11,10,76,"Sydney",5,11,41,"Princes Park",35,1997,"Regular",21,"Home","Carlton","Sydney",35
11335,1997-08-23,"R21","Footscray",12,14,86,"West Coast",10,8,68,"Western Oval",18,1997,"Regular",21,"Home","Footscray","West Coast",18
11336,1997-08-23,"R21","North Melbourne",10,21,81,"Hawthorn",6,7,43,"M.C.G.",38,1997,"Regular",21,"Home","North Melbourne","Hawthorn",38
11337,1997-08-23,"R21","Brisbane Lions",15,12,102,"Essendon",16,10,106,"Gabba",-4,1997,"Regular",21,"Away","Essendon","Brisbane Lions",4
11338,1997-08-24,"R21","Fremantle",9,14,68,"Geelong",14,16,100,"Subiaco",-32,1997,"Regular",21,"Away","Geelong","Fremantle",32
11339,1997-08-24,"R21","Richmond",22,14,146,"Port Adelaide",8,13,61,"M.C.G.",85,1997,"Regular",21,"Home","Richmond","Port Adelaide",85
11340,1997-08-25,"R21","Adelaide",6,12,48,"Collingwood",5,9,39,"Football Park",9,1997,"Regular",21,"Home","Adelaide","Collingwood",9
11341,1997-08-29,"R22","West Coast",18,12,120,"Brisbane Lions",11,15,81,"W.A.C.A.",39,1997,"Regular",22,"Home","West Coast","Brisbane Lions",39
11342,1997-08-30,"R22","Carlton",13,11,89,"Richmond",13,13,91,"Princes Park",-2,1997,"Regular",22,"Away","Richmond","Carlton",2
11343,1997-08-30,"R22","Hawthorn",13,9,87,"Footscray",15,15,105,"Waverley Park",-18,1997,"Regular",22,"Away","Footscray","Hawthorn",18
11344,1997-08-30,"R22","Melbourne",18,11,119,"Fremantle",11,13,79,"M.C.G.",40,1997,"Regular",22,"Home","Melbourne","Fremantle",40
11345,1997-08-30,"R22","Sydney",13,12,90,"Geelong",15,10,100,"S.C.G.",-10,1997,"Regular",22,"Away","Geelong","Sydney",10
11346,1997-08-31,"R22","Essendon",16,6,102,"Adelaide",14,14,98,"Princes Park",4,1997,"Regular",22,"Home","Essendon","Adelaide",4
11347,1997-08-31,"R22","Collingwood",18,14,122,"North Melbourne",15,21,111,"M.C.G.",11,1997,"Regular",22,"Home","Collingwood","North Melbourne",11
11348,1997-08-31,"R22","Port Adelaide",12,12,84,"St Kilda",17,15,117,"Football Park",-33,1997,"Regular",22,"Away","St Kilda","Port Adelaide",33
11349,1997-09-06,"QF","Footscray",18,11,119,"Sydney",12,12,84,"M.C.G.",35,1997,"Finals",23,"Home","Footscray","Sydney",35
11350,1997-09-07,"QF","Adelaide",14,15,99,"West Coast",9,12,66,"Football Park",33,1997,"Finals",23,"Home","Adelaide","West Coast",33
11351,1997-09-07,"QF","St Kilda",20,15,135,"Brisbane Lions",13,11,89,"Waverley Park",46,1997,"Finals",23,"Home","St Kilda","Brisbane Lions",46
11352,1997-09-07,"QF","Geelong",9,7,61,"North Melbourne",11,13,79,"M.C.G.",-18,1997,"Finals",23,"Away","North Melbourne","Geelong",18
11353,1997-09-13,"SF","North Melbourne",15,8,98,"West Coast",12,13,85,"M.C.G.",13,1997,"Finals",24,"Home","North Melbourne","West Coast",13
11354,1997-09-13,"SF","Geelong",9,14,68,"Adelaide",11,10,76,"Football Park",-8,1997,"Finals",24,"Away","Adelaide","Geelong",8
11355,1997-09-19,"PF","St Kilda",15,14,104,"North Melbourne",11,7,73,"M.C.G.",31,1997,"Finals",25,"Home","St Kilda","North Melbourne",31
11356,1997-09-20,"PF","Footscray",13,13,91,"Adelaide",12,21,93,"M.C.G.",-2,1997,"Finals",25,"Away","Adelaide","Footscray",2
11357,1997-09-27,"GF","St Kilda",13,16,94,"Adelaide",19,11,125,"M.C.G.",-31,1997,"Finals",26,"Away","Adelaide","St Kilda",31
11358,1998-03-27,"R1","North Melbourne",15,13,103,"West Coast",15,11,101,"M.C.G.",2,1998,"Regular",1,"Home","North Melbourne","West Coast",2
11359,1998-03-28,"R1","Carlton",10,13,73,"Adelaide",9,9,63,"Princes Park",10,1998,"Regular",1,"Home","Carlton","Adelaide",10
11360,1998-03-28,"R1","St Kilda",17,7,109,"Geelong",13,13,91,"Waverley Park",18,1998,"Regular",1,"Home","St Kilda","Geelong",18
11361,1998-03-28,"R1","Collingwood",18,15,123,"Hawthorn",12,12,84,"M.C.G.",39,1998,"Regular",1,"Home","Collingwood","Hawthorn",39
11362,1998-03-28,"R1","Brisbane Lions",10,12,72,"Footscray",17,16,118,"Gabba",-46,1998,"Regular",1,"Away","Footscray","Brisbane Lions",46
11363,1998-03-29,"R1","Port Adelaide",17,15,117,"Sydney",20,4,124,"Football Park",-7,1998,"Regular",1,"Away","Sydney","Port Adelaide",7
11364,1998-03-29,"R1","Richmond",14,19,103,"Essendon",13,11,89,"M.C.G.",14,1998,"Regular",1,"Home","Richmond","Essendon",14
11365,1998-03-29,"R1","Fremantle",13,6,84,"Melbourne",8,13,61,"Subiaco",23,1998,"Regular",1,"Home","Fremantle","Melbourne",23
11366,1998-04-03,"R2","West Coast",17,14,116,"Collingwood",8,8,56,"Subiaco",60,1998,"Regular",2,"Home","West Coast","Collingwood",60
11367,1998-04-04,"R2","Geelong",14,15,99,"Richmond",11,14,80,"Kardinia Park",19,1998,"Regular",2,"Home","Geelong","Richmond",19
11368,1998-04-04,"R2","Hawthorn",10,7,67,"Port Adelaide",17,10,112,"Waverley Park",-45,1998,"Regular",2,"Away","Port Adelaide","Hawthorn",45
11369,1998-04-04,"R2","Melbourne",19,11,125,"North Melbourne",15,10,100,"M.C.G.",25,1998,"Regular",2,"Home","Melbourne","North Melbourne",25
11370,1998-04-04,"R2","Sydney",20,15,135,"Brisbane Lions",14,13,97,"S.C.G.",38,1998,"Regular",2,"Home","Sydney","Brisbane Lions",38
11371,1998-04-05,"R2","Adelaide",25,17,167,"Fremantle",11,8,74,"Football Park",93,1998,"Regular",2,"Home","Adelaide","Fremantle",93
11372,1998-04-05,"R2","Footscray",22,8,140,"Carlton",13,6,84,"Princes Park",56,1998,"Regular",2,"Home","Footscray","Carlton",56
11373,1998-04-05,"R2","Essendon",28,14,182,"St Kilda",13,15,93,"M.C.G.",89,1998,"Regular",2,"Home","Essendon","St Kilda",89
11374,1998-04-11,"R3","Footscray",16,23,119,"Collingwood",13,7,85,"Princes Park",34,1998,"Regular",3,"Home","Footscray","Collingwood",34
11375,1998-04-11,"R3","Richmond",15,13,103,"Hawthorn",15,7,97,"M.C.G.",6,1998,"Regular",3,"Home","Richmond","Hawthorn",6
11376,1998-04-11,"R3","Port Adelaide",10,9,69,"North Melbourne",15,8,98,"Football Park",-29,1998,"Regular",3,"Away","North Melbourne","Port Adelaide",29
11377,1998-04-12,"R3","Sydney",24,16,160,"Geelong",7,15,57,"S.C.G.",103,1998,"Regular",3,"Home","Sydney","Geelong",103
11378,1998-04-12,"R3","St Kilda",12,10,82,"Adelaide",8,12,60,"Waverley Park",22,1998,"Regular",3,"Home","St Kilda","Adelaide",22
11379,1998-04-12,"R3","Fremantle",10,7,67,"West Coast",14,10,94,"Subiaco",-27,1998,"Regular",3,"Away","West Coast","Fremantle",27
11380,1998-04-13,"R3","Carlton",14,14,98,"Essendon",14,15,99,"M.C.G.",-1,1998,"Regular",3,"Away","Essendon","Carlton",1
11381,1998-04-13,"R3","Brisbane Lions",12,15,87,"Melbourne",15,10,100,"Gabba",-13,1998,"Regular",3,"Away","Melbourne","Brisbane Lions",13
11382,1998-04-17,"R4","Collingwood",20,13,133,"Richmond",12,16,88,"M.C.G.",45,1998,"Regular",4,"Home","Collingwood","Richmond",45
11383,1998-04-18,"R4","Geelong",11,13,79,"Footscray",14,10,94,"Kardinia Park",-15,1998,"Regular",4,"Away","Footscray","Geelong",15
11384,1998-04-18,"R4","Hawthorn",18,13,121,"St Kilda",20,9,129,"Waverley Park",-8,1998,"Regular",4,"Away","St Kilda","Hawthorn",8
11385,1998-04-18,"R4","West Coast",14,15,99,"Sydney",18,10,118,"W.A.C.A.",-19,1998,"Regular",4,"Away","Sydney","West Coast",19
11386,1998-04-19,"R4","Port Adelaide",11,7,73,"Adelaide",8,16,64,"Football Park",9,1998,"Regular",4,"Home","Port Adelaide","Adelaide",9
11387,1998-04-19,"R4","Carlton",10,10,70,"Melbourne",10,12,72,"Princes Park",-2,1998,"Regular",4,"Away","Melbourne","Carlton",2
11388,1998-04-19,"R4","Essendon",11,10,76,"Fremantle",14,16,100,"Waverley Park",-24,1998,"Regular",4,"Away","Fremantle","Essendon",24
11389,1998-04-19,"R4","North Melbourne",21,11,137,"Brisbane Lions",17,18,120,"M.C.G.",17,1998,"Regular",4,"Home","North Melbourne","Brisbane Lions",17
11390,1998-04-24,"R5","Richmond",12,14,86,"West Coast",10,11,71,"M.C.G.",15,1998,"Regular",5,"Home","Richmond","West Coast",15
11391,1998-04-25,"R5","Hawthorn",18,16,124,"Brisbane Lions",12,11,83,"Waverley Park",41,1998,"Regular",5,"Home","Hawthorn","Brisbane Lions",41
11392,1998-04-25,"R5","Collingwood",15,18,108,"Essendon",12,16,88,"M.C.G.",20,1998,"Regular",5,"Home","Collingwood","Essendon",20
11393,1998-04-25,"R5","Fremantle",16,8,104,"North Melbourne",12,15,87,"W.A.C.A.",17,1998,"Regular",5,"Home","Fremantle","North Melbourne",17
11394,1998-04-26,"R5","Sydney",14,15,99,"Footscray",12,11,83,"S.C.G.",16,1998,"Regular",5,"Home","Sydney","Footscray",16
11395,1998-04-26,"R5","St Kilda",13,10,88,"Carlton",9,12,66,"Waverley Park",22,1998,"Regular",5,"Home","St Kilda","Carlton",22
11396,1998-04-26,"R5","Melbourne",14,18,102,"Port Adelaide",6,17,53,"M.C.G.",49,1998,"Regular",5,"Home","Melbourne","Port Adelaide",49
11397,1998-04-26,"R5","Adelaide",12,15,87,"Geelong",8,13,61,"Football Park",26,1998,"Regular",5,"Home","Adelaide","Geelong",26
11398,1998-05-01,"R6","Brisbane Lions",13,8,86,"Richmond",7,9,51,"Gabba",35,1998,"Regular",6,"Home","Brisbane Lions","Richmond",35
11399,1998-05-02,"R6","Footscray",13,19,97,"Essendon",13,11,89,"Princes Park",8,1998,"Regular",6,"Home","Footscray","Essendon",8
11400,1998-05-02,"R6","Geelong",13,12,90,"Hawthorn",10,13,73,"Kardinia Park",17,1998,"Regular",6,"Home","Geelong","Hawthorn",17
11401,1998-05-02,"R6","Carlton",9,13,67,"Collingwood",14,12,96,"M.C.G.",-29,1998,"Regular",6,"Away","Collingwood","Carlton",29
11402,1998-05-02,"R6","Port Adelaide",13,18,96,"Fremantle",9,6,60,"Football Park",36,1998,"Regular",6,"Home","Port Adelaide","Fremantle",36
11403,1998-05-03,"R6","Sydney",8,13,61,"Melbourne",12,8,80,"S.C.G.",-19,1998,"Regular",6,"Away","Melbourne","Sydney",19
11404,1998-05-03,"R6","North Melbourne",15,16,106,"Adelaide",15,12,102,"M.C.G.",4,1998,"Regular",6,"Home","North Melbourne","Adelaide",4
11405,1998-05-03,"R6","West Coast",18,11,119,"St Kilda",18,13,121,"Subiaco",-2,1998,"Regular",6,"Away","St Kilda","West Coast",2
11406,1998-05-08,"R7","Collingwood",12,7,79,"Sydney",18,7,115,"M.C.G.",-36,1998,"Regular",7,"Away","Sydney","Collingwood",36
11407,1998-05-08,"R7","Fremantle",8,9,57,"Hawthorn",15,9,99,"W.A.C.A.",-42,1998,"Regular",7,"Away","Hawthorn","Fremantle",42
11408,1998-05-09,"R7","Carlton",11,10,76,"Port Adelaide",25,15,165,"Princes Park",-89,1998,"Regular",7,"Away","Port Adelaide","Carlton",89
11409,1998-05-09,"R7","St Kilda",11,16,82,"Brisbane Lions",15,9,99,"Waverley Park",-17,1998,"Regular",7,"Away","Brisbane Lions","St Kilda",17
11410,1998-05-09,"R7","Essendon",11,4,70,"Geelong",12,7,79,"M.C.G.",-9,1998,"Regular",7,"Away","Geelong","Essendon",9
11411,1998-05-10,"R7","Adelaide",11,13,79,"West Coast",10,11,71,"Football Park",8,1998,"Regular",7,"Home","Adelaide","West Coast",8
11412,1998-05-10,"R7","Footscray",16,15,111,"North Melbourne",12,11,83,"Princes Park",28,1998,"Regular",7,"Home","Footscray","North Melbourne",28
11413,1998-05-10,"R7","Richmond",13,13,91,"Melbourne",7,7,49,"M.C.G.",42,1998,"Regular",7,"Home","Richmond","Melbourne",42
11414,1998-05-15,"R8","Essendon",12,12,84,"Brisbane Lions",8,22,70,"M.C.G.",14,1998,"Regular",8,"Home","Essendon","Brisbane Lions",14
11415,1998-05-16,"R8","Geelong",12,4,76,"Fremantle",6,18,54,"Kardinia Park",22,1998,"Regular",8,"Home","Geelong","Fremantle",22
11416,1998-05-16,"R8","North Melbourne",15,15,105,"Sydney",14,11,95,"M.C.G.",10,1998,"Regular",8,"Home","North Melbourne","Sydney",10
11417,1998-05-16,"R8","St Kilda",10,12,72,"Port Adelaide",5,15,45,"Waverley Park",27,1998,"Regular",8,"Home","St Kilda","Port Adelaide",27
11418,1998-05-17,"R8","Adelaide",11,13,79,"Richmond",14,8,92,"Football Park",-13,1998,"Regular",8,"Away","Richmond","Adelaide",13
11419,1998-05-17,"R8","Melbourne",17,12,114,"Collingwood",16,15,111,"M.C.G.",3,1998,"Regular",8,"Home","Melbourne","Collingwood",3
11420,1998-05-17,"R8","Hawthorn",14,12,96,"Footscray",21,10,136,"Waverley Park",-40,1998,"Regular",8,"Away","Footscray","Hawthorn",40
11421,1998-05-17,"R8","West Coast",12,20,92,"Carlton",12,12,84,"Subiaco",8,1998,"Regular",8,"Home","West Coast","Carlton",8
11422,1998-05-22,"R9","Fremantle",14,21,105,"St Kilda",13,12,90,"W.A.C.A.",15,1998,"Regular",9,"Home","Fremantle","St Kilda",15
11423,1998-05-23,"R9","Carlton",10,14,74,"North Melbourne",17,13,115,"Princes Park",-41,1998,"Regular",9,"Away","North Melbourne","Carlton",41
11424,1998-05-23,"R9","Footscray",13,10,88,"Richmond",11,9,75,"Waverley Park",13,1998,"Regular",9,"Home","Footscray","Richmond",13
11425,1998-05-23,"R9","Geelong",5,14,44,"West Coast",9,11,65,"Kardinia Park",-21,1998,"Regular",9,"Away","West Coast","Geelong",21
11426,1998-05-23,"R9","Melbourne",12,12,84,"Essendon",18,14,122,"M.C.G.",-38,1998,"Regular",9,"Away","Essendon","Melbourne",38
11427,1998-05-23,"R9","Brisbane Lions",6,14,50,"Adelaide",14,14,98,"Gabba",-48,1998,"Regular",9,"Away","Adelaide","Brisbane Lions",48
11428,1998-05-24,"R9","Sydney",17,15,117,"Hawthorn",11,14,80,"S.C.G.",37,1998,"Regular",9,"Home","Sydney","Hawthorn",37
11429,1998-05-24,"R9","Port Adelaide",11,14,80,"Collingwood",9,9,63,"Football Park",17,1998,"Regular",9,"Home","Port Adelaide","Collingwood",17
11430,1998-05-29,"R10","West Coast",16,17,113,"Footscray",15,10,100,"W.A.C.A.",13,1998,"Regular",10,"Home","West Coast","Footscray",13
11431,1998-05-30,"R10","Carlton",17,9,111,"Brisbane Lions",12,15,87,"Princes Park",24,1998,"Regular",10,"Home","Carlton","Brisbane Lions",24
11432,1998-05-30,"R10","Richmond",13,19,97,"Port Adelaide",9,13,67,"M.C.G.",30,1998,"Regular",10,"Home","Richmond","Port Adelaide",30
11433,1998-05-30,"R10","Hawthorn",13,9,87,"Essendon",13,15,93,"Waverley Park",-6,1998,"Regular",10,"Away","Essendon","Hawthorn",6
11434,1998-05-30,"R10","Sydney",8,5,53,"St Kilda",24,10,154,"S.C.G.",-101,1998,"Regular",10,"Away","St Kilda","Sydney",101
11435,1998-05-31,"R10","Adelaide",17,9,111,"Melbourne",8,10,58,"Football Park",53,1998,"Regular",10,"Home","Adelaide","Melbourne",53
11436,1998-05-31,"R10","Collingwood",19,5,119,"Fremantle",17,10,112,"Victoria Park",7,1998,"Regular",10,"Home","Collingwood","Fremantle",7
11437,1998-05-31,"R10","North Melbourne",13,13,91,"Geelong",17,12,114,"M.C.G.",-23,1998,"Regular",10,"Away","Geelong","North Melbourne",23
11438,1998-06-05,"R11","Essendon",24,16,160,"Sydney",15,10,100,"M.C.G.",60,1998,"Regular",11,"Home","Essendon","Sydney",60
11439,1998-06-06,"R11","Hawthorn",10,10,70,"Melbourne",18,9,117,"Waverley Park",-47,1998,"Regular",11,"Away","Melbourne","Hawthorn",47
11440,1998-06-06,"R11","Geelong",12,8,80,"Carlton",9,9,63,"M.C.G.",17,1998,"Regular",11,"Home","Geelong","Carlton",17
11441,1998-06-06,"R11","Port Adelaide",7,13,55,"West Coast",8,9,57,"Football Park",-2,1998,"Regular",11,"Away","West Coast","Port Adelaide",2
11442,1998-06-07,"R11","Footscray",24,11,155,"Adelaide",13,10,88,"Princes Park",67,1998,"Regular",11,"Home","Footscray","Adelaide",67
11443,1998-06-07,"R11","Fremantle",17,19,121,"Brisbane Lions",7,8,50,"Subiaco",71,1998,"Regular",11,"Home","Fremantle","Brisbane Lions",71
11444,1998-06-08,"R11","North Melbourne",19,12,126,"Collingwood",13,19,97,"M.C.G.",29,1998,"Regular",11,"Home","North Melbourne","Collingwood",29
11445,1998-06-08,"R11","St Kilda",21,11,137,"Richmond",16,14,110,"Waverley Park",27,1998,"Regular",11,"Home","St Kilda","Richmond",27
11446,1998-06-12,"R12","West Coast",19,9,123,"Hawthorn",17,6,108,"W.A.C.A.",15,1998,"Regular",12,"Home","West Coast","Hawthorn",15
11447,1998-06-13,"R12","Carlton",14,16,100,"Sydney",11,8,74,"Princes Park",26,1998,"Regular",12,"Home","Carlton","Sydney",26
11448,1998-06-13,"R12","Melbourne",7,4,46,"Geelong",22,9,141,"M.C.G.",-95,1998,"Regular",12,"Away","Geelong","Melbourne",95
11449,1998-06-13,"R12","Adelaide",15,18,108,"Essendon",15,16,106,"Football Park",2,1998,"Regular",12,"Home","Adelaide","Essendon",2
11450,1998-06-14,"R12","Collingwood",11,16,82,"St Kilda",17,15,117,"Waverley Park",-35,1998,"Regular",12,"Away","St Kilda","Collingwood",35
11451,1998-06-14,"R12","Footscray",18,14,122,"Fremantle",15,6,96,"Princes Park",26,1998,"Regular",12,"Home","Footscray","Fremantle",26
11452,1998-06-14,"R12","Richmond",19,13,127,"North Melbourne",14,8,92,"M.C.G.",35,1998,"Regular",12,"Home","Richmond","North Melbourne",35
11453,1998-06-14,"R12","Brisbane Lions",18,15,123,"Port Adelaide",18,15,123,"Gabba",0,1998,"Regular",12,"Home","Brisbane Lions","Port Adelaide",0
11454,1998-06-19,"R13","Essendon",11,6,72,"West Coast",11,17,83,"M.C.G.",-11,1998,"Regular",13,"Away","West Coast","Essendon",11
11455,1998-06-20,"R13","Collingwood",10,10,70,"Adelaide",11,13,79,"M.C.G.",-9,1998,"Regular",13,"Away","Adelaide","Collingwood",9
11456,1998-06-20,"R13","Geelong",12,8,80,"Brisbane Lions",15,16,106,"Kardinia Park",-26,1998,"Regular",13,"Away","Brisbane Lions","Geelong",26
11457,1998-06-20,"R13","Hawthorn",17,12,114,"North Melbourne",17,10,112,"Waverley Park",2,1998,"Regular",13,"Home","Hawthorn","North Melbourne",2
11458,1998-06-20,"R13","Port Adelaide",11,7,73,"Footscray",5,9,39,"Football Park",34,1998,"Regular",13,"Home","Port Adelaide","Footscray",34
11459,1998-06-21,"R13","Sydney",16,6,102,"Richmond",13,13,91,"S.C.G.",11,1998,"Regular",13,"Home","Sydney","Richmond",11
11460,1998-06-21,"R13","Melbourne",5,12,42,"St Kilda",19,13,127,"M.C.G.",-85,1998,"Regular",13,"Away","St Kilda","Melbourne",85
11461,1998-06-21,"R13","Fremantle",10,16,76,"Carlton",10,8,68,"Subiaco",8,1998,"Regular",13,"Home","Fremantle","Carlton",8
11462,1998-06-26,"R14","North Melbourne",19,13,127,"Essendon",16,13,109,"M.C.G.",18,1998,"Regular",14,"Home","North Melbourne","Essendon",18
11463,1998-06-27,"R14","Carlton",13,14,92,"Hawthorn",11,10,76,"Princes Park",16,1998,"Regular",14,"Home","Carlton","Hawthorn",16
11464,1998-06-27,"R14","St Kilda",12,15,87,"Footscray",10,12,72,"Waverley Park",15,1998,"Regular",14,"Home","St Kilda","Footscray",15
11465,1998-06-27,"R14","Richmond",23,7,145,"Fremantle",8,7,55,"M.C.G.",90,1998,"Regular",14,"Home","Richmond","Fremantle",90
11466,1998-06-27,"R14","Port Adelaide",13,13,91,"Geelong",10,13,73,"Football Park",18,1998,"Regular",14,"Home","Port Adelaide","Geelong",18
11467,1998-06-28,"R14","Sydney",12,15,87,"Adelaide",18,16,124,"S.C.G.",-37,1998,"Regular",14,"Away","Adelaide","Sydney",37
11468,1998-06-28,"R14","Brisbane Lions",19,21,135,"Collingwood",12,11,83,"Gabba",52,1998,"Regular",14,"Home","Brisbane Lions","Collingwood",52
11469,1998-06-28,"R14","West Coast",11,13,79,"Melbourne",14,12,96,"Subiaco",-17,1998,"Regular",14,"Away","Melbourne","West Coast",17
11470,1998-07-03,"R15","Richmond",20,12,132,"Carlton",11,4,70,"M.C.G.",62,1998,"Regular",15,"Home","Richmond","Carlton",62
11471,1998-07-04,"R15","Essendon",16,12,108,"Port Adelaide",12,9,81,"M.C.G.",27,1998,"Regular",15,"Home","Essendon","Port Adelaide",27
11472,1998-07-04,"R15","Footscray",12,11,83,"Melbourne",9,11,65,"Princes Park",18,1998,"Regular",15,"Home","Footscray","Melbourne",18
11473,1998-07-04,"R15","St Kilda",12,7,79,"North Melbourne",22,13,145,"Waverley Park",-66,1998,"Regular",15,"Away","North Melbourne","St Kilda",66
11474,1998-07-04,"R15","Brisbane Lions",6,13,49,"West Coast",11,10,76,"Gabba",-27,1998,"Regular",15,"Away","West Coast","Brisbane Lions",27
11475,1998-07-05,"R15","Adelaide",9,14,68,"Hawthorn",4,11,35,"Football Park",33,1998,"Regular",15,"Home","Adelaide","Hawthorn",33
11476,1998-07-05,"R15","Collingwood",10,11,71,"Geelong",9,7,61,"M.C.G.",10,1998,"Regular",15,"Home","Collingwood","Geelong",10
11477,1998-07-05,"R15","Fremantle",10,9,69,"Sydney",13,4,82,"Subiaco",-13,1998,"Regular",15,"Away","Sydney","Fremantle",13
11478,1998-07-17,"R16","Adelaide",16,5,101,"Carlton",16,9,105,"Football Park",-4,1998,"Regular",16,"Away","Carlton","Adelaide",4
11479,1998-07-18,"R16","Footscray",27,15,177,"Brisbane Lions",13,8,86,"Princes Park",91,1998,"Regular",16,"Home","Footscray","Brisbane Lions",91
11480,1998-07-18,"R16","Melbourne",16,10,106,"Fremantle",13,5,83,"M.C.G.",23,1998,"Regular",16,"Home","Melbourne","Fremantle",23
11481,1998-07-18,"R16","Geelong",10,16,76,"St Kilda",15,10,100,"Kardinia Park",-24,1998,"Regular",16,"Away","St Kilda","Geelong",24
11482,1998-07-18,"R16","Hawthorn",4,14,38,"Collingwood",19,10,124,"Waverley Park",-86,1998,"Regular",16,"Away","Collingwood","Hawthorn",86
11483,1998-07-19,"R16","Sydney",18,10,118,"Port Adelaide",12,12,84,"S.C.G.",34,1998,"Regular",16,"Home","Sydney","Port Adelaide",34
11484,1998-07-19,"R16","Essendon",14,10,94,"Richmond",10,15,75,"M.C.G.",19,1998,"Regular",16,"Home","Essendon","Richmond",19
11485,1998-07-19,"R16","West Coast",11,14,80,"North Melbourne",13,16,94,"Subiaco",-14,1998,"Regular",16,"Away","North Melbourne","West Coast",14
11486,1998-07-24,"R17","Fremantle",14,14,98,"Adelaide",15,7,97,"Subiaco",1,1998,"Regular",17,"Home","Fremantle","Adelaide",1
11487,1998-07-25,"R17","Carlton",29,11,185,"Footscray",15,15,105,"Princes Park",80,1998,"Regular",17,"Home","Carlton","Footscray",80
11488,1998-07-25,"R17","Collingwood",9,11,65,"West Coast",13,8,86,"Victoria Park",-21,1998,"Regular",17,"Away","West Coast","Collingwood",21
11489,1998-07-25,"R17","North Melbourne",22,20,152,"Melbourne",13,9,87,"M.C.G.",65,1998,"Regular",17,"Home","North Melbourne","Melbourne",65
11490,1998-07-25,"R17","Port Adelaide",18,11,119,"Hawthorn",15,8,98,"Football Park",21,1998,"Regular",17,"Home","Port Adelaide","Hawthorn",21
11491,1998-07-26,"R17","St Kilda",13,9,87,"Essendon",14,6,90,"Waverley Park",-3,1998,"Regular",17,"Away","Essendon","St Kilda",3
11492,1998-07-26,"R17","Richmond",10,7,67,"Geelong",8,10,58,"M.C.G.",9,1998,"Regular",17,"Home","Richmond","Geelong",9
11493,1998-07-26,"R17","Brisbane Lions",14,5,89,"Sydney",22,17,149,"Gabba",-60,1998,"Regular",17,"Away","Sydney","Brisbane Lions",60
11494,1998-07-31,"R18","Collingwood",10,7,67,"Footscray",16,14,110,"M.C.G.",-43,1998,"Regular",18,"Away","Footscray","Collingwood",43
11495,1998-08-01,"R18","North Melbourne",18,23,131,"Port Adelaide",10,16,76,"Manuka Oval",55,1998,"Regular",18,"Home","North Melbourne","Port Adelaide",55
11496,1998-08-01,"R18","Geelong",12,15,87,"Sydney",19,7,121,"Kardinia Park",-34,1998,"Regular",18,"Away","Sydney","Geelong",34
11497,1998-08-01,"R18","Melbourne",22,19,151,"Brisbane Lions",8,8,56,"M.C.G.",95,1998,"Regular",18,"Home","Melbourne","Brisbane Lions",95
11498,1998-08-01,"R18","Adelaide",19,23,137,"St Kilda",10,7,67,"Football Park",70,1998,"Regular",18,"Home","Adelaide","St Kilda",70
11499,1998-08-02,"R18","Essendon",12,12,84,"Carlton",11,12,78,"M.C.G.",6,1998,"Regular",18,"Home","Essendon","Carlton",6
11500,1998-08-02,"R18","West Coast",15,9,99,"Fremantle",8,12,60,"Subiaco",39,1998,"Regular",18,"Home","West Coast","Fremantle",39
11501,1998-08-02,"R18","Hawthorn",10,10,70,"Richmond",4,10,34,"Waverley Park",36,1998,"Regular",18,"Home","Hawthorn","Richmond",36
11502,1998-08-07,"R19","Brisbane Lions",12,14,86,"North Melbourne",15,23,113,"Gabba",-27,1998,"Regular",19,"Away","North Melbourne","Brisbane Lions",27
11503,1998-08-08,"R19","Melbourne",16,17,113,"Carlton",8,16,64,"M.C.G.",49,1998,"Regular",19,"Home","Melbourne","Carlton",49
11504,1998-08-08,"R19","Footscray",13,18,96,"Geelong",14,13,97,"Princes Park",-1,1998,"Regular",19,"Away","Geelong","Footscray",1
11505,1998-08-08,"R19","St Kilda",10,9,69,"Hawthorn",19,14,128,"Waverley Park",-59,1998,"Regular",19,"Away","Hawthorn","St Kilda",59
11506,1998-08-08,"R19","Fremantle",12,14,86,"Essendon",18,11,119,"Subiaco",-33,1998,"Regular",19,"Away","Essendon","Fremantle",33
11507,1998-08-09,"R19","Sydney",10,14,74,"West Coast",9,14,68,"S.C.G.",6,1998,"Regular",19,"Home","Sydney","West Coast",6
11508,1998-08-09,"R19","Richmond",12,14,86,"Collingwood",9,13,67,"M.C.G.",19,1998,"Regular",19,"Home","Richmond","Collingwood",19
11509,1998-08-09,"R19","Adelaide",22,12,144,"Port Adelaide",10,10,70,"Football Park",74,1998,"Regular",19,"Home","Adelaide","Port Adelaide",74
11510,1998-08-14,"R20","North Melbourne",22,19,151,"Fremantle",7,5,47,"M.C.G.",104,1998,"Regular",20,"Home","North Melbourne","Fremantle",104
11511,1998-08-15,"R20","Geelong",6,8,44,"Adelaide",18,10,118,"Kardinia Park",-74,1998,"Regular",20,"Away","Adelaide","Geelong",74
11512,1998-08-15,"R20","Essendon",16,13,109,"Collingwood",14,15,99,"M.C.G.",10,1998,"Regular",20,"Home","Essendon","Collingwood",10
11513,1998-08-15,"R20","Footscray",15,9,99,"Sydney",15,7,97,"Waverley Park",2,1998,"Regular",20,"Home","Footscray","Sydney",2
11514,1998-08-15,"R20","Brisbane Lions",7,17,59,"Hawthorn",13,16,94,"Gabba",-35,1998,"Regular",20,"Away","Hawthorn","Brisbane Lions",35
11515,1998-08-16,"R20","Port Adelaide",10,11,71,"Melbourne",14,10,94,"Football Park",-23,1998,"Regular",20,"Away","Melbourne","Port Adelaide",23
11516,1998-08-16,"R20","Carlton",19,20,134,"St Kilda",15,14,104,"M.C.G.",30,1998,"Regular",20,"Home","Carlton","St Kilda",30
11517,1998-08-16,"R20","West Coast",16,16,112,"Richmond",11,7,73,"Subiaco",39,1998,"Regular",20,"Home","West Coast","Richmond",39
11518,1998-08-21,"R21","Essendon",13,12,90,"Footscray",14,17,101,"M.C.G.",-11,1998,"Regular",21,"Away","Footscray","Essendon",11
11519,1998-08-22,"R21","Richmond",24,11,155,"Brisbane Lions",11,12,78,"M.C.G.",77,1998,"Regular",21,"Home","Richmond","Brisbane Lions",77
11520,1998-08-22,"R21","St Kilda",9,9,63,"West Coast",7,13,55,"Waverley Park",8,1998,"Regular",21,"Home","St Kilda","West Coast",8
11521,1998-08-22,"R21","Adelaide",13,14,92,"North Melbourne",14,21,105,"Football Park",-13,1998,"Regular",21,"Away","North Melbourne","Adelaide",13
11522,1998-08-23,"R21","Collingwood",8,15,63,"Carlton",17,16,118,"M.C.G.",-55,1998,"Regular",21,"Away","Carlton","Collingwood",55
11523,1998-08-23,"R21","Fremantle",10,11,71,"Port Adelaide",19,10,124,"Subiaco",-53,1998,"Regular",21,"Away","Port Adelaide","Fremantle",53
11524,1998-08-23,"R21","Hawthorn",11,18,84,"Geelong",8,15,63,"Waverley Park",21,1998,"Regular",21,"Home","Hawthorn","Geelong",21
11525,1998-08-24,"R21","Melbourne",17,12,114,"Sydney",12,11,83,"M.C.G.",31,1998,"Regular",21,"Home","Melbourne","Sydney",31
11526,1998-08-28,"R22","North Melbourne",17,11,113,"Footscray",16,12,108,"M.C.G.",5,1998,"Regular",22,"Home","North Melbourne","Footscray",5
11527,1998-08-29,"R22","Geelong",19,13,127,"Essendon",18,9,117,"M.C.G.",10,1998,"Regular",22,"Home","Geelong","Essendon",10
11528,1998-08-29,"R22","Hawthorn",22,17,149,"Fremantle",9,6,60,"Waverley Park",89,1998,"Regular",22,"Home","Hawthorn","Fremantle",89
11529,1998-08-29,"R22","Brisbane Lions",12,20,92,"St Kilda",13,13,91,"Gabba",1,1998,"Regular",22,"Home","Brisbane Lions","St Kilda",1
11530,1998-08-29,"R22","West Coast",12,9,81,"Adelaide",15,16,106,"Subiaco",-25,1998,"Regular",22,"Away","Adelaide","West Coast",25
11531,1998-08-30,"R22","Sydney",18,11,119,"Collingwood",16,11,107,"S.C.G.",12,1998,"Regular",22,"Home","Sydney","Collingwood",12
11532,1998-08-30,"R22","Melbourne",19,19,133,"Richmond",8,9,57,"M.C.G.",76,1998,"Regular",22,"Home","Melbourne","Richmond",76
11533,1998-08-30,"R22","Port Adelaide",12,12,84,"Carlton",21,12,138,"Football Park",-54,1998,"Regular",22,"Away","Carlton","Port Adelaide",54
11534,1998-09-04,"QF","North Melbourne",11,16,82,"Essendon",8,12,60,"M.C.G.",22,1998,"Finals",23,"Home","North Melbourne","Essendon",22
11535,1998-09-05,"QF","Melbourne",17,13,115,"Adelaide",9,13,67,"M.C.G.",48,1998,"Finals",23,"Home","Melbourne","Adelaide",48
11536,1998-09-05,"QF","Sydney",12,17,89,"St Kilda",13,9,87,"S.C.G.",2,1998,"Finals",23,"Home","Sydney","St Kilda",2
11537,1998-09-06,"QF","Footscray",18,13,121,"West Coast",7,9,51,"M.C.G.",70,1998,"Finals",23,"Home","Footscray","West Coast",70
11538,1998-09-12,"SF","Melbourne",15,17,107,"St Kilda",7,14,56,"M.C.G.",51,1998,"Finals",24,"Home","Melbourne","St Kilda",51
11539,1998-09-12,"SF","Sydney",10,7,67,"Adelaide",14,10,94,"S.C.G.",-27,1998,"Finals",24,"Away","Adelaide","Sydney",27
11540,1998-09-18,"PF","North Melbourne",17,12,114,"Melbourne",12,12,84,"M.C.G.",30,1998,"Finals",25,"Home","North Melbourne","Melbourne",30
11541,1998-09-19,"PF","Footscray",13,15,93,"Adelaide",24,17,161,"M.C.G.",-68,1998,"Finals",25,"Away","Adelaide","Footscray",68
11542,1998-09-26,"GF","North Melbourne",8,22,70,"Adelaide",15,15,105,"M.C.G.",-35,1998,"Finals",26,"Away","Adelaide","North Melbourne",35
11543,1999-03-25,"R1","Essendon",16,14,110,"Carlton",9,17,71,"M.C.G.",39,1999,"Regular",1,"Home","Essendon","Carlton",39
11544,1999-03-26,"R1","Geelong",22,9,141,"North Melbourne",21,9,135,"M.C.G.",6,1999,"Regular",1,"Home","Geelong","North Melbourne",6
11545,1999-03-27,"R1","Melbourne",14,20,104,"Richmond",13,9,87,"M.C.G.",17,1999,"Regular",1,"Home","Melbourne","Richmond",17
11546,1999-03-27,"R1","Adelaide",12,6,78,"Footscray",13,13,91,"Football Park",-13,1999,"Regular",1,"Away","Footscray","Adelaide",13
11547,1999-03-27,"R1","Brisbane Lions",23,14,152,"St Kilda",10,3,63,"Gabba",89,1999,"Regular",1,"Home","Brisbane Lions","St Kilda",89
11548,1999-03-28,"R1","Collingwood",8,11,59,"Hawthorn",10,14,74,"M.C.G.",-15,1999,"Regular",1,"Away","Hawthorn","Collingwood",15
11549,1999-03-28,"R1","Sydney",12,14,86,"Port Adelaide",17,13,115,"S.C.G.",-29,1999,"Regular",1,"Away","Port Adelaide","Sydney",29
11550,1999-03-28,"R1","Fremantle",13,20,98,"West Coast",15,12,102,"Subiaco",-4,1999,"Regular",1,"Away","West Coast","Fremantle",4
11551,1999-04-01,"R2","North Melbourne",15,16,106,"Essendon",22,9,141,"M.C.G.",-35,1999,"Regular",2,"Away","Essendon","North Melbourne",35
11552,1999-04-03,"R2","Footscray",20,14,134,"Geelong",24,11,155,"Princes Park",-21,1999,"Regular",2,"Away","Geelong","Footscray",21
11553,1999-04-03,"R2","Richmond",15,18,108,"Sydney",13,18,96,"M.C.G.",12,1999,"Regular",2,"Home","Richmond","Sydney",12
11554,1999-04-03,"R2","Hawthorn",8,8,56,"Adelaide",8,12,60,"Waverley Park",-4,1999,"Regular",2,"Away","Adelaide","Hawthorn",4
11555,1999-04-03,"R2","West Coast",11,17,83,"Brisbane Lions",11,7,73,"Subiaco",10,1999,"Regular",2,"Home","West Coast","Brisbane Lions",10
11556,1999-04-04,"R2","Port Adelaide",17,12,114,"Fremantle",15,11,101,"Football Park",13,1999,"Regular",2,"Home","Port Adelaide","Fremantle",13
11557,1999-04-04,"R2","St Kilda",19,16,130,"Melbourne",13,6,84,"Waverley Park",46,1999,"Regular",2,"Home","St Kilda","Melbourne",46
11558,1999-04-05,"R2","Carlton",15,22,112,"Collingwood",12,11,83,"M.C.G.",29,1999,"Regular",2,"Home","Carlton","Collingwood",29
11559,1999-04-09,"R3","Richmond",13,12,90,"North Melbourne",15,10,100,"M.C.G.",-10,1999,"Regular",3,"Away","North Melbourne","Richmond",10
11560,1999-04-10,"R3","Essendon",22,17,149,"Sydney",9,14,68,"M.C.G.",81,1999,"Regular",3,"Home","Essendon","Sydney",81
11561,1999-04-10,"R3","Geelong",14,13,97,"Melbourne",12,19,91,"Kardinia Park",6,1999,"Regular",3,"Home","Geelong","Melbourne",6
11562,1999-04-10,"R3","Brisbane Lions",11,14,80,"Port Adelaide",15,13,103,"Gabba",-23,1999,"Regular",3,"Away","Port Adelaide","Brisbane Lions",23
11563,1999-04-10,"R3","Fremantle",11,12,78,"Hawthorn",16,16,112,"Subiaco",-34,1999,"Regular",3,"Away","Hawthorn","Fremantle",34
11564,1999-04-11,"R3","Footscray",15,13,103,"Carlton",15,15,105,"Princes Park",-2,1999,"Regular",3,"Away","Carlton","Footscray",2
11565,1999-04-11,"R3","Collingwood",11,9,75,"West Coast",16,15,111,"Victoria Park",-36,1999,"Regular",3,"Away","West Coast","Collingwood",36
11566,1999-04-11,"R3","Adelaide",14,12,96,"St Kilda",11,15,81,"Football Park",15,1999,"Regular",3,"Home","Adelaide","St Kilda",15
11567,1999-04-16,"R4","Melbourne",12,13,85,"Hawthorn",12,12,84,"M.C.G.",1,1999,"Regular",4,"Home","Melbourne","Hawthorn",1
11568,1999-04-17,"R4","Carlton",19,7,121,"Fremantle",14,8,92,"Princes Park",29,1999,"Regular",4,"Home","Carlton","Fremantle",29
11569,1999-04-17,"R4","Collingwood",14,12,96,"Richmond",22,14,146,"M.C.G.",-50,1999,"Regular",4,"Away","Richmond","Collingwood",50
11570,1999-04-17,"R4","St Kilda",16,11,107,"Footscray",15,9,99,"Waverley Park",8,1999,"Regular",4,"Home","St Kilda","Footscray",8
11571,1999-04-17,"R4","Brisbane Lions",17,13,115,"Adelaide",8,6,54,"Gabba",61,1999,"Regular",4,"Home","Brisbane Lions","Adelaide",61
11572,1999-04-17,"R4","Sydney",10,12,72,"North Melbourne",10,10,70,"S.C.G.",2,1999,"Regular",4,"Home","Sydney","North Melbourne",2
11573,1999-04-18,"R4","Port Adelaide",10,14,74,"Geelong",17,13,115,"Football Park",-41,1999,"Regular",4,"Away","Geelong","Port Adelaide",41
11574,1999-04-18,"R4","West Coast",15,7,97,"Essendon",3,5,23,"Subiaco",74,1999,"Regular",4,"Home","West Coast","Essendon",74
11575,1999-04-23,"R5","Footscray",21,17,143,"Richmond",12,9,81,"M.C.G.",62,1999,"Regular",5,"Home","Footscray","Richmond",62
11576,1999-04-24,"R5","Carlton",9,11,65,"Geelong",17,13,115,"Princes Park",-50,1999,"Regular",5,"Away","Geelong","Carlton",50
11577,1999-04-24,"R5","Hawthorn",9,14,68,"West Coast",14,10,94,"Waverley Park",-26,1999,"Regular",5,"Away","West Coast","Hawthorn",26
11578,1999-04-24,"R5","Melbourne",13,12,90,"Port Adelaide",9,12,66,"M.C.G.",24,1999,"Regular",5,"Home","Melbourne","Port Adelaide",24
11579,1999-04-24,"R5","North Melbourne",14,8,92,"St Kilda",13,12,90,"S.C.G.",2,1999,"Regular",5,"Home","North Melbourne","St Kilda",2
11580,1999-04-25,"R5","Adelaide",23,17,155,"Sydney",11,8,74,"Football Park",81,1999,"Regular",5,"Home","Adelaide","Sydney",81
11581,1999-04-25,"R5","Essendon",15,18,108,"Collingwood",15,10,100,"M.C.G.",8,1999,"Regular",5,"Home","Essendon","Collingwood",8
11582,1999-04-25,"R5","Fremantle",7,11,53,"Brisbane Lions",15,18,108,"Subiaco",-55,1999,"Regular",5,"Away","Brisbane Lions","Fremantle",55
11583,1999-04-30,"R6","St Kilda",14,15,99,"Carlton",7,16,58,"M.C.G.",41,1999,"Regular",6,"Home","St Kilda","Carlton",41
11584,1999-05-01,"R6","Richmond",11,12,78,"Essendon",17,11,113,"M.C.G.",-35,1999,"Regular",6,"Away","Essendon","Richmond",35
11585,1999-05-01,"R6","Geelong",14,14,98,"Hawthorn",14,16,100,"Kardinia Park",-2,1999,"Regular",6,"Away","Hawthorn","Geelong",2
11586,1999-05-01,"R6","Brisbane Lions",14,9,93,"Melbourne",10,10,70,"Gabba",23,1999,"Regular",6,"Home","Brisbane Lions","Melbourne",23
11587,1999-05-01,"R6","West Coast",18,16,124,"Footscray",7,10,52,"Subiaco",72,1999,"Regular",6,"Home","West Coast","Footscray",72
11588,1999-05-02,"R6","Adelaide",18,7,115,"Port Adelaide",12,15,87,"Football Park",28,1999,"Regular",6,"Home","Adelaide","Port Adelaide",28
11589,1999-05-02,"R6","Collingwood",16,13,109,"North Melbourne",21,11,137,"M.C.G.",-28,1999,"Regular",6,"Away","North Melbourne","Collingwood",28
11590,1999-05-02,"R6","Sydney",15,10,100,"Fremantle",11,9,75,"S.C.G.",25,1999,"Regular",6,"Home","Sydney","Fremantle",25
11591,1999-05-07,"R7","Carlton",18,10,118,"Richmond",14,14,98,"M.C.G.",20,1999,"Regular",7,"Home","Carlton","Richmond",20
11592,1999-05-08,"R7","Melbourne",20,14,134,"Essendon",17,11,113,"M.C.G.",21,1999,"Regular",7,"Home","Melbourne","Essendon",21
11593,1999-05-08,"R7","St Kilda",9,14,68,"West Coast",7,6,48,"Waverley Park",20,1999,"Regular",7,"Home","St Kilda","West Coast",20
11594,1999-05-08,"R7","Brisbane Lions",13,18,96,"Collingwood",9,8,62,"Gabba",34,1999,"Regular",7,"Home","Brisbane Lions","Collingwood",34
11595,1999-05-08,"R7","Port Adelaide",10,15,75,"Footscray",18,12,120,"Football Park",-45,1999,"Regular",7,"Away","Footscray","Port Adelaide",45
11596,1999-05-09,"R7","Sydney",20,11,131,"Hawthorn",16,7,103,"S.C.G.",28,1999,"Regular",7,"Home","Sydney","Hawthorn",28
11597,1999-05-09,"R7","North Melbourne",22,9,141,"Adelaide",12,13,85,"M.C.G.",56,1999,"Regular",7,"Home","North Melbourne","Adelaide",56
11598,1999-05-09,"R7","Fremantle",16,20,116,"Geelong",15,9,99,"Subiaco",17,1999,"Regular",7,"Home","Fremantle","Geelong",17
11599,1999-05-14,"R8","Essendon",7,9,51,"St Kilda",13,16,94,"M.C.G.",-43,1999,"Regular",8,"Away","St Kilda","Essendon",43
11600,1999-05-15,"R8","Collingwood",14,15,99,"Fremantle",8,11,59,"M.C.G.",40,1999,"Regular",8,"Home","Collingwood","Fremantle",40
11601,1999-05-15,"R8","Footscray",17,15,117,"Melbourne",7,11,53,"Princes Park",64,1999,"Regular",8,"Home","Footscray","Melbourne",64
11602,1999-05-15,"R8","Port Adelaide",19,11,125,"Carlton",13,8,86,"Football Park",39,1999,"Regular",8,"Home","Port Adelaide","Carlton",39
11603,1999-05-15,"R8","Hawthorn",7,7,49,"North Melbourne",15,11,101,"Waverley Park",-52,1999,"Regular",8,"Away","North Melbourne","Hawthorn",52
11604,1999-05-16,"R8","Geelong",14,16,100,"Sydney",21,15,141,"Kardinia Park",-41,1999,"Regular",8,"Away","Sydney","Geelong",41
11605,1999-05-16,"R8","Richmond",21,9,135,"Brisbane Lions",17,17,119,"M.C.G.",16,1999,"Regular",8,"Home","Richmond","Brisbane Lions",16
11606,1999-05-16,"R8","West Coast",19,12,126,"Adelaide",11,6,72,"Subiaco",54,1999,"Regular",8,"Home","West Coast","Adelaide",54
11607,1999-05-21,"R9","Collingwood",12,16,88,"Footscray",19,12,126,"M.C.G.",-38,1999,"Regular",9,"Away","Footscray","Collingwood",38
11608,1999-05-22,"R9","Carlton",15,7,97,"Melbourne",9,10,64,"Princes Park",33,1999,"Regular",9,"Home","Carlton","Melbourne",33
11609,1999-05-22,"R9","Hawthorn",7,5,47,"Essendon",15,17,107,"Waverley Park",-60,1999,"Regular",9,"Away","Essendon","Hawthorn",60
11610,1999-05-22,"R9","Adelaide",9,13,67,"Richmond",12,6,78,"Football Park",-11,1999,"Regular",9,"Away","Richmond","Adelaide",11
11611,1999-05-22,"R9","Fremantle",12,14,86,"North Melbourne",17,14,116,"Subiaco",-30,1999,"Regular",9,"Away","North Melbourne","Fremantle",30
11612,1999-05-23,"R9","Brisbane Lions",22,12,144,"Geelong",11,21,87,"Gabba",57,1999,"Regular",9,"Home","Brisbane Lions","Geelong",57
11613,1999-05-23,"R9","St Kilda",18,11,119,"Port Adelaide",7,15,57,"Waverley Park",62,1999,"Regular",9,"Home","St Kilda","Port Adelaide",62
11614,1999-05-23,"R9","Sydney",11,15,81,"West Coast",14,10,94,"S.C.G.",-13,1999,"Regular",9,"Away","West Coast","Sydney",13
11615,1999-06-04,"R10","Melbourne",13,12,90,"Fremantle",22,12,144,"M.C.G.",-54,1999,"Regular",10,"Away","Fremantle","Melbourne",54
11616,1999-06-04,"R10","Adelaide",8,13,61,"Essendon",16,13,109,"Football Park",-48,1999,"Regular",10,"Away","Essendon","Adelaide",48
11617,1999-06-05,"R10","Geelong",16,12,108,"St Kilda",18,10,118,"Kardinia Park",-10,1999,"Regular",10,"Away","St Kilda","Geelong",10
11618,1999-06-05,"R10","Richmond",11,15,81,"Hawthorn",12,15,87,"M.C.G.",-6,1999,"Regular",10,"Away","Hawthorn","Richmond",6
11619,1999-06-05,"R10","Brisbane Lions",6,8,44,"Footscray",9,12,66,"Gabba",-22,1999,"Regular",10,"Away","Footscray","Brisbane Lions",22
11620,1999-06-06,"R10","Sydney",22,13,145,"Collingwood",14,10,94,"S.C.G.",51,1999,"Regular",10,"Home","Sydney","Collingwood",51
11621,1999-06-06,"R10","North Melbourne",20,13,133,"Port Adelaide",18,18,126,"M.C.G.",7,1999,"Regular",10,"Home","North Melbourne","Port Adelaide",7
11622,1999-06-06,"R10","West Coast",12,12,84,"Carlton",15,11,101,"Subiaco",-17,1999,"Regular",10,"Away","Carlton","West Coast",17
11623,1999-06-11,"R11","Essendon",21,11,137,"Geelong",15,14,104,"M.C.G.",33,1999,"Regular",11,"Home","Essendon","Geelong",33
11624,1999-06-12,"R11","Carlton",12,6,78,"Brisbane Lions",13,16,94,"Princes Park",-16,1999,"Regular",11,"Away","Brisbane Lions","Carlton",16
11625,1999-06-12,"R11","St Kilda",10,13,73,"Sydney",15,12,102,"Waverley Park",-29,1999,"Regular",11,"Away","Sydney","St Kilda",29
11626,1999-06-12,"R11","Port Adelaide",4,8,32,"Richmond",3,12,30,"Football Park",2,1999,"Regular",11,"Home","Port Adelaide","Richmond",2
11627,1999-06-13,"R11","Fremantle",18,14,122,"Adelaide",12,11,83,"Subiaco",39,1999,"Regular",11,"Home","Fremantle","Adelaide",39
11628,1999-06-13,"R11","Footscray",10,16,76,"Hawthorn",11,10,76,"Princes Park",0,1999,"Regular",11,"Home","Footscray","Hawthorn",0
11629,1999-06-14,"R11","North Melbourne",12,12,84,"West Coast",9,10,64,"S.C.G.",20,1999,"Regular",11,"Home","North Melbourne","West Coast",20
11630,1999-06-14,"R11","Collingwood",11,12,78,"Melbourne",13,11,89,"M.C.G.",-11,1999,"Regular",11,"Away","Melbourne","Collingwood",11
11631,1999-06-18,"R12","Richmond",15,11,101,"Geelong",9,12,66,"M.C.G.",35,1999,"Regular",12,"Home","Richmond","Geelong",35
11632,1999-06-19,"R12","Footscray",17,13,115,"Fremantle",11,13,79,"Princes Park",36,1999,"Regular",12,"Home","Footscray","Fremantle",36
11633,1999-06-19,"R12","Hawthorn",17,7,109,"St Kilda",14,12,96,"Waverley Park",13,1999,"Regular",12,"Home","Hawthorn","St Kilda",13
11634,1999-06-19,"R12","Brisbane Lions",9,17,71,"Essendon",13,11,89,"Gabba",-18,1999,"Regular",12,"Away","Essendon","Brisbane Lions",18
11635,1999-06-19,"R12","Adelaide",14,15,99,"Collingwood",14,10,94,"Football Park",5,1999,"Regular",12,"Home","Adelaide","Collingwood",5
11636,1999-06-20,"R12","Carlton",8,13,61,"Sydney",12,16,88,"Princes Park",-27,1999,"Regular",12,"Away","Sydney","Carlton",27
11637,1999-06-20,"R12","Melbourne",14,8,92,"North Melbourne",12,21,93,"M.C.G.",-1,1999,"Regular",12,"Away","North Melbourne","Melbourne",1
11638,1999-06-20,"R12","West Coast",21,11,137,"Port Adelaide",11,6,72,"Subiaco",65,1999,"Regular",12,"Home","West Coast","Port Adelaide",65
11639,1999-06-25,"R13","Essendon",10,20,80,"Footscray",11,10,76,"M.C.G.",4,1999,"Regular",13,"Home","Essendon","Footscray",4
11640,1999-06-26,"R13","St Kilda",11,16,82,"Collingwood",15,13,103,"Waverley Park",-21,1999,"Regular",13,"Away","Collingwood","St Kilda",21
11641,1999-06-26,"R13","Geelong",9,14,68,"West Coast",16,16,112,"Kardinia Park",-44,1999,"Regular",13,"Away","West Coast","Geelong",44
11642,1999-06-26,"R13","North Melbourne",13,11,89,"Carlton",8,5,53,"M.C.G.",36,1999,"Regular",13,"Home","North Melbourne","Carlton",36
11643,1999-06-26,"R13","Port Adelaide",8,17,65,"Hawthorn",6,9,45,"Football Park",20,1999,"Regular",13,"Home","Port Adelaide","Hawthorn",20
11644,1999-06-27,"R13","Sydney",15,8,98,"Brisbane Lions",20,13,133,"S.C.G.",-35,1999,"Regular",13,"Away","Brisbane Lions","Sydney",35
11645,1999-06-27,"R13","Melbourne",16,13,109,"Adelaide",13,13,91,"M.C.G.",18,1999,"Regular",13,"Home","Melbourne","Adelaide",18
11646,1999-06-27,"R13","Fremantle",19,12,126,"Richmond",19,13,127,"Subiaco",-1,1999,"Regular",13,"Away","Richmond","Fremantle",1
11647,1999-07-02,"R14","Collingwood",13,9,87,"Port Adelaide",12,16,88,"M.C.G.",-1,1999,"Regular",14,"Away","Port Adelaide","Collingwood",1
11648,1999-07-03,"R14","North Melbourne",15,12,102,"Brisbane Lions",15,10,100,"M.C.G.",2,1999,"Regular",14,"Home","North Melbourne","Brisbane Lions",2
11649,1999-07-03,"R14","St Kilda",13,18,96,"Richmond",8,7,55,"Waverley Park",41,1999,"Regular",14,"Home","St Kilda","Richmond",41
11650,1999-07-03,"R14","West Coast",16,16,112,"Melbourne",11,11,77,"Subiaco",35,1999,"Regular",14,"Home","West Coast","Melbourne",35
11651,1999-07-04,"R14","Sydney",14,17,101,"Footscray",18,15,123,"S.C.G.",-22,1999,"Regular",14,"Away","Footscray","Sydney",22
11652,1999-07-04,"R14","Hawthorn",7,13,55,"Carlton",13,11,89,"Waverley Park",-34,1999,"Regular",14,"Away","Carlton","Hawthorn",34
11653,1999-07-04,"R14","Essendon",16,12,108,"Fremantle",10,12,72,"M.C.G.",36,1999,"Regular",14,"Home","Essendon","Fremantle",36
11654,1999-07-04,"R14","Adelaide",25,9,159,"Geelong",14,12,96,"Football Park",63,1999,"Regular",14,"Home","Adelaide","Geelong",63
11655,1999-07-09,"R15","Richmond",16,8,104,"West Coast",11,9,75,"M.C.G.",29,1999,"Regular",15,"Home","Richmond","West Coast",29
11656,1999-07-10,"R15","Carlton",20,16,136,"Adelaide",13,10,88,"Princes Park",48,1999,"Regular",15,"Home","Carlton","Adelaide",48
11657,1999-07-10,"R15","Geelong",19,14,128,"Collingwood",19,11,125,"Kardinia Park",3,1999,"Regular",15,"Home","Geelong","Collingwood",3
11658,1999-07-10,"R15","Melbourne",10,14,74,"Sydney",18,17,125,"M.C.G.",-51,1999,"Regular",15,"Away","Sydney","Melbourne",51
11659,1999-07-10,"R15","Brisbane Lions",13,14,92,"Hawthorn",9,7,61,"Gabba",31,1999,"Regular",15,"Home","Brisbane Lions","Hawthorn",31
11660,1999-07-10,"R15","Fremantle",16,11,107,"St Kilda",12,12,84,"Subiaco",23,1999,"Regular",15,"Home","Fremantle","St Kilda",23
11661,1999-07-11,"R15","Port Adelaide",14,15,99,"Essendon",9,8,62,"Football Park",37,1999,"Regular",15,"Home","Port Adelaide","Essendon",37
11662,1999-07-11,"R15","Footscray",23,12,150,"North Melbourne",16,12,108,"M.C.G.",42,1999,"Regular",15,"Home","Footscray","North Melbourne",42
11663,1999-07-16,"R16","Richmond",15,17,107,"Melbourne",13,4,82,"M.C.G.",25,1999,"Regular",16,"Home","Richmond","Melbourne",25
11664,1999-07-17,"R16","Footscray",14,15,99,"Adelaide",14,13,97,"M.C.G.",2,1999,"Regular",16,"Home","Footscray","Adelaide",2
11665,1999-07-17,"R16","St Kilda",10,8,68,"Brisbane Lions",16,11,107,"Waverley Park",-39,1999,"Regular",16,"Away","Brisbane Lions","St Kilda",39
11666,1999-07-17,"R16","North Melbourne",22,11,143,"Geelong",13,10,88,"S.C.G.",55,1999,"Regular",16,"Home","North Melbourne","Geelong",55
11667,1999-07-18,"R16","Carlton",9,16,70,"Essendon",23,8,146,"M.C.G.",-76,1999,"Regular",16,"Away","Essendon","Carlton",76
11668,1999-07-18,"R16","Hawthorn",14,8,92,"Collingwood",18,16,124,"Waverley Park",-32,1999,"Regular",16,"Away","Collingwood","Hawthorn",32
11669,1999-07-18,"R16","Port Adelaide",10,12,72,"Sydney",9,10,64,"Football Park",8,1999,"Regular",16,"Home","Port Adelaide","Sydney",8
11670,1999-07-18,"R16","West Coast",11,6,72,"Fremantle",17,17,119,"Subiaco",-47,1999,"Regular",16,"Away","Fremantle","West Coast",47
11671,1999-07-23,"R17","Melbourne",11,13,79,"St Kilda",14,14,98,"M.C.G.",-19,1999,"Regular",17,"Away","St Kilda","Melbourne",19
11672,1999-07-24,"R17","Essendon",24,14,158,"North Melbourne",20,12,132,"M.C.G.",26,1999,"Regular",17,"Home","Essendon","North Melbourne",26
11673,1999-07-24,"R17","Geelong",13,13,91,"Footscray",14,14,98,"Kardinia Park",-7,1999,"Regular",17,"Away","Footscray","Geelong",7
11674,1999-07-24,"R17","Sydney",14,12,96,"Richmond",8,7,55,"S.C.G.",41,1999,"Regular",17,"Home","Sydney","Richmond",41
11675,1999-07-24,"R17","Fremantle",13,11,89,"Port Adelaide",14,12,96,"W.A.C.A.",-7,1999,"Regular",17,"Away","Port Adelaide","Fremantle",7
11676,1999-07-25,"R17","Adelaide",18,17,125,"Hawthorn",11,10,76,"Football Park",49,1999,"Regular",17,"Home","Adelaide","Hawthorn",49
11677,1999-07-25,"R17","Collingwood",14,12,96,"Carlton",23,15,153,"M.C.G.",-57,1999,"Regular",17,"Away","Carlton","Collingwood",57
11678,1999-07-25,"R17","Brisbane Lions",25,16,166,"West Coast",9,12,66,"Gabba",100,1999,"Regular",17,"Home","Brisbane Lions","West Coast",100
11679,1999-07-30,"R18","North Melbourne",15,11,101,"Richmond",11,13,79,"M.C.G.",22,1999,"Regular",18,"Home","North Melbourne","Richmond",22
11680,1999-07-31,"R18","St Kilda",9,12,66,"Adelaide",15,9,99,"Waverley Park",-33,1999,"Regular",18,"Away","Adelaide","St Kilda",33
11681,1999-07-31,"R18","Melbourne",12,8,80,"Geelong",15,11,101,"M.C.G.",-21,1999,"Regular",18,"Away","Geelong","Melbourne",21
11682,1999-07-31,"R18","Sydney",11,13,79,"Essendon",15,3,93,"S.C.G.",-14,1999,"Regular",18,"Away","Essendon","Sydney",14
11683,1999-07-31,"R18","West Coast",16,12,108,"Collingwood",10,12,72,"W.A.C.A.",36,1999,"Regular",18,"Home","West Coast","Collingwood",36
11684,1999-08-01,"R18","Carlton",14,15,99,"Footscray",14,10,94,"Princes Park",5,1999,"Regular",18,"Home","Carlton","Footscray",5
11685,1999-08-01,"R18","Hawthorn",15,12,102,"Fremantle",9,23,77,"Waverley Park",25,1999,"Regular",18,"Home","Hawthorn","Fremantle",25
11686,1999-08-01,"R18","Port Adelaide",9,12,66,"Brisbane Lions",17,16,118,"Football Park",-52,1999,"Regular",18,"Away","Brisbane Lions","Port Adelaide",52
11687,1999-08-06,"R19","Essendon",23,15,153,"West Coast",15,3,93,"M.C.G.",60,1999,"Regular",19,"Home","Essendon","West Coast",60
11688,1999-08-07,"R19","Richmond",10,19,79,"Collingwood",16,16,112,"M.C.G.",-33,1999,"Regular",19,"Away","Collingwood","Richmond",33
11689,1999-08-07,"R19","Geelong",18,10,118,"Port Adelaide",12,14,86,"Kardinia Park",32,1999,"Regular",19,"Home","Geelong","Port Adelaide",32
11690,1999-08-07,"R19","North Melbourne",17,9,111,"Sydney",15,11,101,"S.C.G.",10,1999,"Regular",19,"Home","North Melbourne","Sydney",10
11691,1999-08-07,"R19","Fremantle",8,9,57,"Carlton",19,12,126,"W.A.C.A.",-69,1999,"Regular",19,"Away","Carlton","Fremantle",69
11692,1999-08-08,"R19","Adelaide",6,8,44,"Brisbane Lions",11,17,83,"Football Park",-39,1999,"Regular",19,"Away","Brisbane Lions","Adelaide",39
11693,1999-08-08,"R19","Footscray",18,7,115,"St Kilda",13,13,91,"Princes Park",24,1999,"Regular",19,"Home","Footscray","St Kilda",24
11694,1999-08-08,"R19","Hawthorn",18,14,122,"Melbourne",8,6,54,"Waverley Park",68,1999,"Regular",19,"Home","Hawthorn","Melbourne",68
11695,1999-08-13,"R20","Collingwood",10,5,65,"Essendon",12,15,87,"M.C.G.",-22,1999,"Regular",20,"Away","Essendon","Collingwood",22
11696,1999-08-14,"R20","Richmond",12,7,79,"Footscray",17,13,115,"M.C.G.",-36,1999,"Regular",20,"Away","Footscray","Richmond",36
11697,1999-08-14,"R20","St Kilda",13,11,89,"North Melbourne",16,18,114,"Waverley Park",-25,1999,"Regular",20,"Away","North Melbourne","St Kilda",25
11698,1999-08-14,"R20","Port Adelaide",8,15,63,"Melbourne",6,10,46,"Football Park",17,1999,"Regular",20,"Home","Port Adelaide","Melbourne",17
11699,1999-08-14,"R20","West Coast",11,16,82,"Hawthorn",12,12,84,"W.A.C.A.",-2,1999,"Regular",20,"Away","Hawthorn","West Coast",2
11700,1999-08-15,"R20","Sydney",25,9,159,"Adelaide",5,11,41,"S.C.G.",118,1999,"Regular",20,"Home","Sydney","Adelaide",118
11701,1999-08-15,"R20","Geelong",17,11,113,"Carlton",15,14,104,"M.C.G.",9,1999,"Regular",20,"Home","Geelong","Carlton",9
11702,1999-08-15,"R20","Brisbane Lions",28,13,181,"Fremantle",9,13,67,"Gabba",114,1999,"Regular",20,"Home","Brisbane Lions","Fremantle",114
11703,1999-08-20,"R21","Essendon",22,15,147,"Richmond",13,11,89,"M.C.G.",58,1999,"Regular",21,"Home","Essendon","Richmond",58
11704,1999-08-21,"R21","Carlton",15,16,106,"St Kilda",7,3,45,"Princes Park",61,1999,"Regular",21,"Home","Carlton","St Kilda",61
11705,1999-08-21,"R21","Melbourne",15,14,104,"Brisbane Lions",25,9,159,"M.C.G.",-55,1999,"Regular",21,"Away","Brisbane Lions","Melbourne",55
11706,1999-08-21,"R21","Hawthorn",15,13,103,"Geelong",15,11,101,"Waverley Park",2,1999,"Regular",21,"Home","Hawthorn","Geelong",2
11707,1999-08-21,"R21","Fremantle",10,16,76,"Sydney",15,19,109,"W.A.C.A.",-33,1999,"Regular",21,"Away","Sydney","Fremantle",33
11708,1999-08-22,"R21","Port Adelaide",13,14,92,"Adelaide",9,14,68,"Football Park",24,1999,"Regular",21,"Home","Port Adelaide","Adelaide",24
11709,1999-08-22,"R21","North Melbourne",16,17,113,"Collingwood",15,10,100,"M.C.G.",13,1999,"Regular",21,"Home","North Melbourne","Collingwood",13
11710,1999-08-22,"R21","Footscray",16,10,106,"West Coast",16,8,104,"Princes Park",2,1999,"Regular",21,"Home","Footscray","West Coast",2
11711,1999-08-27,"R22","Richmond",13,12,90,"Carlton",11,13,79,"M.C.G.",11,1999,"Regular",22,"Home","Richmond","Carlton",11
11712,1999-08-28,"R22","Collingwood",8,4,52,"Brisbane Lions",13,16,94,"Victoria Park",-42,1999,"Regular",22,"Away","Brisbane Lions","Collingwood",42
11713,1999-08-28,"R22","Essendon",17,14,116,"Melbourne",15,9,99,"M.C.G.",17,1999,"Regular",22,"Home","Essendon","Melbourne",17
11714,1999-08-28,"R22","Footscray",22,13,145,"Port Adelaide",11,12,78,"Princes Park",67,1999,"Regular",22,"Home","Footscray","Port Adelaide",67
11715,1999-08-28,"R22","West Coast",12,8,80,"St Kilda",18,13,121,"W.A.C.A.",-41,1999,"Regular",22,"Away","St Kilda","West Coast",41
11716,1999-08-29,"R22","Adelaide",8,18,66,"North Melbourne",22,10,142,"Football Park",-76,1999,"Regular",22,"Away","North Melbourne","Adelaide",76
11717,1999-08-29,"R22","Geelong",21,13,139,"Fremantle",13,10,88,"Kardinia Park",51,1999,"Regular",22,"Home","Geelong","Fremantle",51
11718,1999-08-29,"R22","Hawthorn",23,15,153,"Sydney",11,2,68,"Waverley Park",85,1999,"Regular",22,"Home","Hawthorn","Sydney",85
11719,1999-09-03,"QF","Footscray",8,12,60,"West Coast",9,11,65,"M.C.G.",-5,1999,"Finals",23,"Away","West Coast","Footscray",5
11720,1999-09-04,"QF","North Melbourne",15,10,100,"Port Adelaide",8,8,56,"M.C.G.",44,1999,"Finals",23,"Home","North Melbourne","Port Adelaide",44
11721,1999-09-04,"QF","Brisbane Lions",20,18,138,"Carlton",8,17,65,"Gabba",73,1999,"Finals",23,"Home","Brisbane Lions","Carlton",73
11722,1999-09-05,"QF","Essendon",18,15,123,"Sydney",7,12,54,"M.C.G.",69,1999,"Finals",23,"Home","Essendon","Sydney",69
11723,1999-09-11,"SF","Carlton",18,16,124,"West Coast",10,10,70,"M.C.G.",54,1999,"Finals",24,"Home","Carlton","West Coast",54
11724,1999-09-11,"SF","Brisbane Lions",19,12,126,"Footscray",10,13,73,"Gabba",53,1999,"Finals",24,"Home","Brisbane Lions","Footscray",53
11725,1999-09-17,"PF","North Melbourne",19,9,123,"Brisbane Lions",11,12,78,"M.C.G.",45,1999,"Finals",25,"Home","North Melbourne","Brisbane Lions",45
11726,1999-09-18,"PF","Essendon",14,19,103,"Carlton",16,8,104,"M.C.G.",-1,1999,"Finals",25,"Away","Carlton","Essendon",1
11727,1999-09-25,"GF","North Melbourne",19,10,124,"Carlton",12,17,89,"M.C.G.",35,1999,"Finals",26,"Home","North Melbourne","Carlton",35
11728,2000-03-08,"R1","Richmond",14,10,94,"Melbourne",13,14,92,"M.C.G.",2,2000,"Regular",1,"Home","Richmond","Melbourne",2
11729,2000-03-09,"R1","Essendon",24,12,156,"Port Adelaide",8,14,62,"Docklands",94,2000,"Regular",1,"Home","Essendon","Port Adelaide",94
11730,2000-03-10,"R1","North Melbourne",16,15,111,"West Coast",24,10,154,"M.C.G.",-43,2000,"Regular",1,"Away","West Coast","North Melbourne",43
11731,2000-03-11,"R1","Adelaide",15,18,108,"Footscray",19,17,131,"Football Park",-23,2000,"Regular",1,"Away","Footscray","Adelaide",23
11732,2000-03-11,"R1","Fremantle",16,11,107,"Geelong",19,15,129,"Subiaco",-22,2000,"Regular",1,"Away","Geelong","Fremantle",22
11733,2000-03-12,"R1","St Kilda",15,10,100,"Sydney",21,8,134,"Docklands",-34,2000,"Regular",1,"Away","Sydney","St Kilda",34
11734,2000-03-13,"R1","Carlton",22,20,152,"Brisbane Lions",16,16,112,"Princes Park",40,2000,"Regular",1,"Home","Carlton","Brisbane Lions",40
11735,2000-03-13,"R1","Hawthorn",13,8,86,"Collingwood",20,20,140,"M.C.G.",-54,2000,"Regular",1,"Away","Collingwood","Hawthorn",54
11736,2000-03-16,"R2","Essendon",20,10,130,"Richmond",12,15,87,"M.C.G.",43,2000,"Regular",2,"Home","Essendon","Richmond",43
11737,2000-03-17,"R2","Melbourne",23,7,145,"North Melbourne",17,18,120,"M.C.G.",25,2000,"Regular",2,"Home","Melbourne","North Melbourne",25
11738,2000-03-18,"R2","Geelong",21,13,139,"St Kilda",15,9,99,"Kardinia Park",40,2000,"Regular",2,"Home","Geelong","St Kilda",40
11739,2000-03-18,"R2","Port Adelaide",12,15,87,"Fremantle",19,11,125,"Football Park",-38,2000,"Regular",2,"Away","Fremantle","Port Adelaide",38
11740,2000-03-19,"R2","Carlton",22,22,154,"Hawthorn",18,4,112,"Princes Park",42,2000,"Regular",2,"Home","Carlton","Hawthorn",42
11741,2000-03-19,"R2","Collingwood",14,19,103,"Adelaide",13,14,92,"M.C.G.",11,2000,"Regular",2,"Home","Collingwood","Adelaide",11
11742,2000-03-19,"R2","Footscray",17,8,110,"Brisbane Lions",21,13,139,"Docklands",-29,2000,"Regular",2,"Away","Brisbane Lions","Footscray",29
11743,2000-03-19,"R2","West Coast",10,10,70,"Sydney",12,10,82,"Subiaco",-12,2000,"Regular",2,"Away","Sydney","West Coast",12
11744,2000-03-24,"R3","Richmond",20,14,134,"North Melbourne",27,8,170,"M.C.G.",-36,2000,"Regular",3,"Away","North Melbourne","Richmond",36
11745,2000-03-25,"R3","Hawthorn",16,14,110,"Brisbane Lions",15,13,103,"M.C.G.",7,2000,"Regular",3,"Home","Hawthorn","Brisbane Lions",7
11746,2000-03-25,"R3","Adelaide",14,16,100,"Geelong",17,9,111,"Football Park",-11,2000,"Regular",3,"Away","Geelong","Adelaide",11
11747,2000-03-25,"R3","St Kilda",18,8,116,"West Coast",17,14,116,"Docklands",0,2000,"Regular",3,"Home","St Kilda","West Coast",0
11748,2000-03-26,"R3","Collingwood",24,16,160,"Carlton",11,21,87,"M.C.G.",73,2000,"Regular",3,"Home","Collingwood","Carlton",73
11749,2000-03-26,"R3","Footscray",22,9,141,"Port Adelaide",14,10,94,"Docklands",47,2000,"Regular",3,"Home","Footscray","Port Adelaide",47
11750,2000-03-26,"R3","Sydney",19,12,126,"Melbourne",17,12,114,"S.C.G.",12,2000,"Regular",3,"Home","Sydney","Melbourne",12
11751,2000-03-26,"R3","Fremantle",12,16,88,"Essendon",19,10,124,"Subiaco",-36,2000,"Regular",3,"Away","Essendon","Fremantle",36
11752,2000-03-31,"R4","North Melbourne",15,14,104,"Geelong",15,9,99,"Docklands",5,2000,"Regular",4,"Home","North Melbourne","Geelong",5
11753,2000-04-01,"R4","Footscray",14,14,98,"Carlton",8,11,59,"Docklands",39,2000,"Regular",4,"Home","Footscray","Carlton",39
11754,2000-04-01,"R4","Hawthorn",14,6,90,"Essendon",20,17,137,"M.C.G.",-47,2000,"Regular",4,"Away","Essendon","Hawthorn",47
11755,2000-04-01,"R4","Sydney",15,11,101,"Collingwood",15,16,106,"S.C.G.",-5,2000,"Regular",4,"Away","Collingwood","Sydney",5
11756,2000-04-01,"R4","West Coast",29,13,187,"Adelaide",10,13,73,"W.A.C.A.",114,2000,"Regular",4,"Home","West Coast","Adelaide",114
11757,2000-04-02,"R4","Richmond",13,9,87,"Fremantle",12,16,88,"Docklands",-1,2000,"Regular",4,"Away","Fremantle","Richmond",1
11758,2000-04-02,"R4","Melbourne",25,15,165,"St Kilda",11,9,75,"M.C.G.",90,2000,"Regular",4,"Home","Melbourne","St Kilda",90
11759,2000-04-02,"R4","Port Adelaide",23,11,149,"Brisbane Lions",15,16,106,"Football Park",43,2000,"Regular",4,"Home","Port Adelaide","Brisbane Lions",43
11760,2000-04-07,"R5","Footscray",16,14,110,"Collingwood",17,16,118,"Docklands",-8,2000,"Regular",5,"Away","Collingwood","Footscray",8
11761,2000-04-08,"R5","Essendon",18,15,123,"Carlton",15,9,99,"M.C.G.",24,2000,"Regular",5,"Home","Essendon","Carlton",24
11762,2000-04-08,"R5","Brisbane Lions",17,20,122,"Adelaide",13,14,92,"Gabba",30,2000,"Regular",5,"Home","Brisbane Lions","Adelaide",30
11763,2000-04-08,"R5","Fremantle",10,15,75,"Melbourne",14,22,106,"W.A.C.A.",-31,2000,"Regular",5,"Away","Melbourne","Fremantle",31
11764,2000-04-09,"R5","Geelong",24,18,162,"West Coast",11,15,81,"Kardinia Park",81,2000,"Regular",5,"Home","Geelong","West Coast",81
11765,2000-04-09,"R5","North Melbourne",19,14,128,"Sydney",18,12,120,"S.C.G.",8,2000,"Regular",5,"Home","North Melbourne","Sydney",8
11766,2000-04-09,"R5","St Kilda",11,18,84,"Richmond",17,8,110,"Docklands",-26,2000,"Regular",5,"Away","Richmond","St Kilda",26
11767,2000-04-09,"R5","Port Adelaide",10,14,74,"Hawthorn",16,17,113,"Football Park",-39,2000,"Regular",5,"Away","Hawthorn","Port Adelaide",39
11768,2000-04-14,"R6","Footscray",12,9,81,"Essendon",22,12,144,"Docklands",-63,2000,"Regular",6,"Away","Essendon","Footscray",63
11769,2000-04-15,"R6","Carlton",26,13,169,"Port Adelaide",12,6,78,"Princes Park",91,2000,"Regular",6,"Home","Carlton","Port Adelaide",91
11770,2000-04-15,"R6","Collingwood",11,16,82,"North Melbourne",17,12,114,"M.C.G.",-32,2000,"Regular",6,"Away","North Melbourne","Collingwood",32
11771,2000-04-15,"R6","St Kilda",9,12,66,"Brisbane Lions",15,15,105,"Docklands",-39,2000,"Regular",6,"Away","Brisbane Lions","St Kilda",39
11772,2000-04-15,"R6","West Coast",28,10,178,"Fremantle",9,7,61,"Subiaco",117,2000,"Regular",6,"Home","West Coast","Fremantle",117
11773,2000-04-16,"R6","Sydney",16,10,106,"Richmond",17,10,112,"S.C.G.",-6,2000,"Regular",6,"Away","Richmond","Sydney",6
11774,2000-04-16,"R6","Geelong",15,19,109,"Melbourne",12,12,84,"Kardinia Park",25,2000,"Regular",6,"Home","Geelong","Melbourne",25
11775,2000-04-16,"R6","Adelaide",22,11,143,"Hawthorn",8,9,57,"Football Park",86,2000,"Regular",6,"Home","Adelaide","Hawthorn",86
11776,2000-04-22,"R7","Hawthorn",19,9,123,"Footscray",14,8,92,"M.C.G.",31,2000,"Regular",7,"Home","Hawthorn","Footscray",31
11777,2000-04-22,"R7","Sydney",15,9,99,"Geelong",17,6,108,"S.C.G.",-9,2000,"Regular",7,"Away","Geelong","Sydney",9
11778,2000-04-22,"R7","St Kilda",18,9,117,"North Melbourne",19,15,129,"Docklands",-12,2000,"Regular",7,"Away","North Melbourne","St Kilda",12
11779,2000-04-23,"R7","Port Adelaide",13,13,91,"Adelaide",14,14,98,"Football Park",-7,2000,"Regular",7,"Away","Adelaide","Port Adelaide",7
11780,2000-04-23,"R7","Melbourne",20,18,138,"West Coast",12,5,77,"Docklands",61,2000,"Regular",7,"Home","Melbourne","West Coast",61
11781,2000-04-24,"R7","Richmond",10,9,69,"Carlton",18,12,120,"M.C.G.",-51,2000,"Regular",7,"Away","Carlton","Richmond",51
11782,2000-04-25,"R7","Collingwood",15,10,100,"Essendon",21,14,140,"M.C.G.",-40,2000,"Regular",7,"Away","Essendon","Collingwood",40
11783,2000-04-25,"R7","Fremantle",17,9,111,"Brisbane Lions",15,10,100,"Subiaco",11,2000,"Regular",7,"Home","Fremantle","Brisbane Lions",11
11784,2000-04-28,"R8","North Melbourne",9,13,67,"Hawthorn",18,20,128,"M.C.G.",-61,2000,"Regular",8,"Away","Hawthorn","North Melbourne",61
11785,2000-04-29,"R8","St Kilda",10,8,68,"Adelaide",14,24,108,"Docklands",-40,2000,"Regular",8,"Away","Adelaide","St Kilda",40
11786,2000-04-29,"R8","West Coast",15,18,108,"Footscray",15,12,102,"W.A.C.A.",6,2000,"Regular",8,"Home","West Coast","Footscray",6
11787,2000-04-30,"R8","Carlton",16,13,109,"Sydney",9,10,64,"Princes Park",45,2000,"Regular",8,"Home","Carlton","Sydney",45
11788,2000-04-30,"R8","Geelong",11,11,77,"Richmond",23,9,147,"Docklands",-70,2000,"Regular",8,"Away","Richmond","Geelong",70
11789,2000-04-30,"R8","Port Adelaide",12,14,86,"Melbourne",17,9,111,"Football Park",-25,2000,"Regular",8,"Away","Melbourne","Port Adelaide",25
11790,2000-05-01,"R8","Collingwood",12,13,85,"Fremantle",15,17,107,"Docklands",-22,2000,"Regular",8,"Away","Fremantle","Collingwood",22
11791,2000-05-01,"R8","Brisbane Lions",9,9,63,"Essendon",19,13,127,"Gabba",-64,2000,"Regular",8,"Away","Essendon","Brisbane Lions",64
11792,2000-05-05,"R9","Footscray",16,9,105,"St Kilda",16,8,104,"Docklands",1,2000,"Regular",9,"Home","Footscray","St Kilda",1
11793,2000-05-06,"R9","Hawthorn",14,14,98,"Geelong",10,13,73,"M.C.G.",25,2000,"Regular",9,"Home","Hawthorn","Geelong",25
11794,2000-05-06,"R9","Adelaide",19,11,125,"North Melbourne",19,14,128,"Football Park",-3,2000,"Regular",9,"Away","North Melbourne","Adelaide",3
11795,2000-05-06,"R9","Richmond",11,13,79,"West Coast",9,16,70,"Docklands",9,2000,"Regular",9,"Home","Richmond","West Coast",9
11796,2000-05-07,"R9","Brisbane Lions",22,14,146,"Collingwood",18,9,117,"Gabba",29,2000,"Regular",9,"Home","Brisbane Lions","Collingwood",29
11797,2000-05-07,"R9","Melbourne",13,15,93,"Essendon",15,16,106,"M.C.G.",-13,2000,"Regular",9,"Away","Essendon","Melbourne",13
11798,2000-05-07,"R9","Sydney",16,15,111,"Port Adelaide",11,19,85,"S.C.G.",26,2000,"Regular",9,"Home","Sydney","Port Adelaide",26
11799,2000-05-07,"R9","Fremantle",13,4,82,"Carlton",21,21,147,"Subiaco",-65,2000,"Regular",9,"Away","Carlton","Fremantle",65
11800,2000-05-12,"R10","West Coast",17,16,118,"Hawthorn",13,10,88,"Subiaco",30,2000,"Regular",10,"Home","West Coast","Hawthorn",30
11801,2000-05-13,"R10","Richmond",15,12,102,"Collingwood",7,12,54,"M.C.G.",48,2000,"Regular",10,"Home","Richmond","Collingwood",48
11802,2000-05-13,"R10","St Kilda",11,16,82,"Carlton",15,19,109,"Docklands",-27,2000,"Regular",10,"Away","Carlton","St Kilda",27
11803,2000-05-13,"R10","Port Adelaide",10,18,78,"Geelong",12,6,78,"Football Park",0,2000,"Regular",10,"Home","Port Adelaide","Geelong",0
11804,2000-05-14,"R10","Essendon",20,12,132,"Adelaide",12,12,84,"Docklands",48,2000,"Regular",10,"Home","Essendon","Adelaide",48
11805,2000-05-14,"R10","Footscray",21,11,137,"Sydney",12,7,79,"S.C.G.",58,2000,"Regular",10,"Home","Footscray","Sydney",58
11806,2000-05-14,"R10","North Melbourne",22,16,148,"Fremantle",8,12,60,"M.C.G.",88,2000,"Regular",10,"Home","North Melbourne","Fremantle",88
11807,2000-05-15,"R10","Melbourne",15,12,102,"Brisbane Lions",11,18,84,"Docklands",18,2000,"Regular",10,"Home","Melbourne","Brisbane Lions",18
11808,2000-05-19,"R11","St Kilda",17,15,117,"Port Adelaide",8,7,55,"Docklands",62,2000,"Regular",11,"Home","St Kilda","Port Adelaide",62
11809,2000-05-20,"R11","Carlton",20,9,129,"North Melbourne",15,9,99,"Princes Park",30,2000,"Regular",11,"Home","Carlton","North Melbourne",30
11810,2000-05-20,"R11","Hawthorn",11,11,77,"Richmond",11,14,80,"M.C.G.",-3,2000,"Regular",11,"Away","Richmond","Hawthorn",3
11811,2000-05-20,"R11","Geelong",13,9,87,"Essendon",22,13,145,"Docklands",-58,2000,"Regular",11,"Away","Essendon","Geelong",58
11812,2000-05-20,"R11","Fremantle",12,9,81,"Footscray",27,12,174,"Subiaco",-93,2000,"Regular",11,"Away","Footscray","Fremantle",93
11813,2000-05-21,"R11","Adelaide",15,15,105,"Melbourne",8,22,70,"Football Park",35,2000,"Regular",11,"Home","Adelaide","Melbourne",35
11814,2000-05-21,"R11","Collingwood",13,14,92,"West Coast",18,20,128,"Docklands",-36,2000,"Regular",11,"Away","West Coast","Collingwood",36
11815,2000-05-21,"R11","Sydney",15,17,107,"Brisbane Lions",16,14,110,"S.C.G.",-3,2000,"Regular",11,"Away","Brisbane Lions","Sydney",3
11816,2000-05-26,"R12","Essendon",25,19,169,"St Kilda",13,5,83,"Docklands",86,2000,"Regular",12,"Home","Essendon","St Kilda",86
11817,2000-05-27,"R12","Collingwood",9,13,67,"Geelong",10,11,71,"M.C.G.",-4,2000,"Regular",12,"Away","Geelong","Collingwood",4
11818,2000-05-27,"R12","Adelaide",14,14,98,"Sydney",7,6,48,"Football Park",50,2000,"Regular",12,"Home","Adelaide","Sydney",50
11819,2000-05-27,"R12","Hawthorn",19,7,121,"Fremantle",8,14,62,"Docklands",59,2000,"Regular",12,"Home","Hawthorn","Fremantle",59
11820,2000-05-27,"R12","Brisbane Lions",14,15,99,"Richmond",17,9,111,"Gabba",-12,2000,"Regular",12,"Away","Richmond","Brisbane Lions",12
11821,2000-05-28,"R12","North Melbourne",10,16,76,"Port Adelaide",8,11,59,"S.C.G.",17,2000,"Regular",12,"Home","North Melbourne","Port Adelaide",17
11822,2000-05-28,"R12","Footscray",16,12,108,"Melbourne",13,5,83,"Docklands",25,2000,"Regular",12,"Home","Footscray","Melbourne",25
11823,2000-05-28,"R12","West Coast",11,12,78,"Carlton",20,8,128,"Subiaco",-50,2000,"Regular",12,"Away","Carlton","West Coast",50
11824,2000-06-02,"R13","Richmond",17,10,112,"Adelaide",17,19,121,"Docklands",-9,2000,"Regular",13,"Away","Adelaide","Richmond",9
11825,2000-06-03,"R13","Melbourne",9,7,61,"Carlton",25,9,159,"M.C.G.",-98,2000,"Regular",13,"Away","Carlton","Melbourne",98
11826,2000-06-03,"R13","Port Adelaide",12,17,89,"Collingwood",11,9,75,"Football Park",14,2000,"Regular",13,"Home","Port Adelaide","Collingwood",14
11827,2000-06-03,"R13","Brisbane Lions",27,11,173,"West Coast",13,11,89,"Gabba",84,2000,"Regular",13,"Home","Brisbane Lions","West Coast",84
11828,2000-06-04,"R13","Sydney",16,13,109,"Hawthorn",11,12,78,"S.C.G.",31,2000,"Regular",13,"Home","Sydney","Hawthorn",31
11829,2000-06-04,"R13","Essendon",17,17,119,"North Melbourne",11,4,70,"M.C.G.",49,2000,"Regular",13,"Home","Essendon","North Melbourne",49
11830,2000-06-04,"R13","Geelong",19,12,126,"Footscray",18,11,119,"Docklands",7,2000,"Regular",13,"Home","Geelong","Footscray",7
11831,2000-06-04,"R13","Fremantle",14,16,100,"St Kilda",8,8,56,"Subiaco",44,2000,"Regular",13,"Home","Fremantle","St Kilda",44
11832,2000-06-09,"R14","North Melbourne",17,14,116,"Brisbane Lions",17,10,112,"Docklands",4,2000,"Regular",14,"Home","North Melbourne","Brisbane Lions",4
11833,2000-06-10,"R14","Melbourne",22,11,143,"Collingwood",12,6,78,"M.C.G.",65,2000,"Regular",14,"Home","Melbourne","Collingwood",65
11834,2000-06-10,"R14","West Coast",10,11,71,"Port Adelaide",16,11,107,"Subiaco",-36,2000,"Regular",14,"Away","Port Adelaide","West Coast",36
11835,2000-06-11,"R14","Carlton",15,17,107,"Geelong",15,7,97,"Princes Park",10,2000,"Regular",14,"Home","Carlton","Geelong",10
11836,2000-06-11,"R14","Sydney",11,10,76,"Essendon",12,17,89,"S.C.G.",-13,2000,"Regular",14,"Away","Essendon","Sydney",13
11837,2000-06-11,"R14","St Kilda",13,8,86,"Hawthorn",27,9,171,"M.C.G.",-85,2000,"Regular",14,"Away","Hawthorn","St Kilda",85
11838,2000-06-11,"R14","Adelaide",22,13,145,"Fremantle",11,6,72,"Football Park",73,2000,"Regular",14,"Home","Adelaide","Fremantle",73
11839,2000-06-12,"R14","Richmond",12,15,87,"Footscray",7,10,52,"M.C.G.",35,2000,"Regular",14,"Home","Richmond","Footscray",35
11840,2000-06-16,"R15","Collingwood",17,13,115,"St Kilda",13,4,82,"M.C.G.",33,2000,"Regular",15,"Home","Collingwood","St Kilda",33
11841,2000-06-17,"R15","Carlton",19,6,120,"Adelaide",14,12,96,"Princes Park",24,2000,"Regular",15,"Home","Carlton","Adelaide",24
11842,2000-06-17,"R15","Geelong",7,17,59,"Brisbane Lions",20,8,128,"Kardinia Park",-69,2000,"Regular",15,"Away","Brisbane Lions","Geelong",69
11843,2000-06-17,"R15","Hawthorn",10,12,72,"Melbourne",22,9,141,"M.C.G.",-69,2000,"Regular",15,"Away","Melbourne","Hawthorn",69
11844,2000-06-17,"R15","Essendon",15,18,108,"West Coast",11,10,76,"Docklands",32,2000,"Regular",15,"Home","Essendon","West Coast",32
11845,2000-06-18,"R15","Port Adelaide",15,13,103,"Richmond",11,9,75,"Football Park",28,2000,"Regular",15,"Home","Port Adelaide","Richmond",28
11846,2000-06-18,"R15","Footscray",16,10,106,"North Melbourne",15,12,102,"Docklands",4,2000,"Regular",15,"Home","Footscray","North Melbourne",4
11847,2000-06-18,"R15","Fremantle",20,3,123,"Sydney",14,12,96,"Subiaco",27,2000,"Regular",15,"Home","Fremantle","Sydney",27
11848,2000-06-23,"R16","Collingwood",10,8,68,"Hawthorn",19,11,125,"Docklands",-57,2000,"Regular",16,"Away","Hawthorn","Collingwood",57
11849,2000-06-24,"R16","Geelong",12,18,90,"Fremantle",12,12,84,"Kardinia Park",6,2000,"Regular",16,"Home","Geelong","Fremantle",6
11850,2000-06-24,"R16","Melbourne",16,14,110,"Richmond",14,16,100,"M.C.G.",10,2000,"Regular",16,"Home","Melbourne","Richmond",10
11851,2000-06-24,"R16","Sydney",14,9,93,"St Kilda",10,5,65,"S.C.G.",28,2000,"Regular",16,"Home","Sydney","St Kilda",28
11852,2000-06-24,"R16","Port Adelaide",7,16,58,"Essendon",12,17,89,"Football Park",-31,2000,"Regular",16,"Away","Essendon","Port Adelaide",31
11853,2000-06-25,"R16","Brisbane Lions",17,10,112,"Carlton",23,18,156,"Gabba",-44,2000,"Regular",16,"Away","Carlton","Brisbane Lions",44
11854,2000-06-25,"R16","Footscray",21,9,135,"Adelaide",10,14,74,"Docklands",61,2000,"Regular",16,"Home","Footscray","Adelaide",61
11855,2000-06-25,"R16","West Coast",7,10,52,"North Melbourne",16,17,113,"Subiaco",-61,2000,"Regular",16,"Away","North Melbourne","West Coast",61
11856,2000-06-30,"R17","St Kilda",16,13,109,"Geelong",13,7,85,"Docklands",24,2000,"Regular",17,"Home","St Kilda","Geelong",24
11857,2000-07-01,"R17","Richmond",10,6,66,"Essendon",24,23,167,"M.C.G.",-101,2000,"Regular",17,"Away","Essendon","Richmond",101
11858,2000-07-01,"R17","North Melbourne",14,19,103,"Melbourne",14,18,102,"Docklands",1,2000,"Regular",17,"Home","North Melbourne","Melbourne",1
11859,2000-07-01,"R17","Fremantle",12,10,82,"Port Adelaide",8,16,64,"W.A.C.A.",18,2000,"Regular",17,"Home","Fremantle","Port Adelaide",18
11860,2000-07-02,"R17","Brisbane Lions",20,18,138,"Footscray",11,15,81,"Gabba",57,2000,"Regular",17,"Home","Brisbane Lions","Footscray",57
11861,2000-07-02,"R17","Hawthorn",9,9,63,"Carlton",18,12,120,"M.C.G.",-57,2000,"Regular",17,"Away","Carlton","Hawthorn",57
11862,2000-07-02,"R17","Sydney",22,19,151,"West Coast",12,8,80,"S.C.G.",71,2000,"Regular",17,"Home","Sydney","West Coast",71
11863,2000-07-02,"R17","Adelaide",22,15,147,"Collingwood",16,13,109,"Football Park",38,2000,"Regular",17,"Home","Adelaide","Collingwood",38
11864,2000-07-07,"R18","Essendon",24,15,159,"Fremantle",11,6,72,"Docklands",87,2000,"Regular",18,"Home","Essendon","Fremantle",87
11865,2000-07-08,"R18","Geelong",17,7,109,"Adelaide",14,18,102,"Kardinia Park",7,2000,"Regular",18,"Home","Geelong","Adelaide",7
11866,2000-07-08,"R18","Melbourne",19,11,125,"Sydney",15,9,99,"M.C.G.",26,2000,"Regular",18,"Home","Melbourne","Sydney",26
11867,2000-07-08,"R18","North Melbourne",20,14,134,"Richmond",7,14,56,"S.C.G.",78,2000,"Regular",18,"Home","North Melbourne","Richmond",78
11868,2000-07-08,"R18","West Coast",17,13,115,"St Kilda",4,5,29,"W.A.C.A.",86,2000,"Regular",18,"Home","West Coast","St Kilda",86
11869,2000-07-09,"R18","Port Adelaide",23,11,149,"Footscray",16,10,106,"Football Park",43,2000,"Regular",18,"Home","Port Adelaide","Footscray",43
11870,2000-07-09,"R18","Carlton",28,12,180,"Collingwood",10,9,69,"Princes Park",111,2000,"Regular",18,"Home","Carlton","Collingwood",111
11871,2000-07-09,"R18","Brisbane Lions",16,10,106,"Hawthorn",18,16,124,"Gabba",-18,2000,"Regular",18,"Away","Hawthorn","Brisbane Lions",18
11872,2000-07-14,"R19","Geelong",13,7,85,"North Melbourne",18,16,124,"Docklands",-39,2000,"Regular",19,"Away","North Melbourne","Geelong",39
11873,2000-07-14,"R19","Adelaide",15,17,107,"West Coast",13,12,90,"Football Park",17,2000,"Regular",19,"Home","Adelaide","West Coast",17
11874,2000-07-15,"R19","Carlton",11,6,72,"Footscray",11,9,75,"Princes Park",-3,2000,"Regular",19,"Away","Footscray","Carlton",3
11875,2000-07-15,"R19","Essendon",25,15,165,"Hawthorn",13,4,82,"Docklands",83,2000,"Regular",19,"Home","Essendon","Hawthorn",83
11876,2000-07-16,"R19","Brisbane Lions",18,12,120,"Port Adelaide",7,11,53,"Gabba",67,2000,"Regular",19,"Home","Brisbane Lions","Port Adelaide",67
11877,2000-07-16,"R19","Collingwood",12,12,84,"Sydney",15,14,104,"M.C.G.",-20,2000,"Regular",19,"Away","Sydney","Collingwood",20
11878,2000-07-16,"R19","St Kilda",14,14,98,"Melbourne",17,14,116,"Docklands",-18,2000,"Regular",19,"Away","Melbourne","St Kilda",18
11879,2000-07-16,"R19","Fremantle",12,7,79,"Richmond",15,16,106,"W.A.C.A.",-27,2000,"Regular",19,"Away","Richmond","Fremantle",27
11880,2000-07-21,"R20","Carlton",12,11,83,"Essendon",16,13,109,"M.C.G.",-26,2000,"Regular",20,"Away","Essendon","Carlton",26
11881,2000-07-22,"R20","Hawthorn",15,11,101,"Port Adelaide",12,8,80,"M.C.G.",21,2000,"Regular",20,"Home","Hawthorn","Port Adelaide",21
11882,2000-07-22,"R20","Collingwood",13,13,91,"Footscray",15,10,100,"Docklands",-9,2000,"Regular",20,"Away","Footscray","Collingwood",9
11883,2000-07-22,"R20","Sydney",21,19,145,"North Melbourne",14,7,91,"S.C.G.",54,2000,"Regular",20,"Home","Sydney","North Melbourne",54
11884,2000-07-22,"R20","West Coast",12,6,78,"Geelong",14,24,108,"Subiaco",-30,2000,"Regular",20,"Away","Geelong","West Coast",30
11885,2000-07-23,"R20","Adelaide",11,12,78,"Brisbane Lions",17,13,115,"Football Park",-37,2000,"Regular",20,"Away","Brisbane Lions","Adelaide",37
11886,2000-07-23,"R20","Melbourne",25,10,160,"Fremantle",11,11,77,"Docklands",83,2000,"Regular",20,"Home","Melbourne","Fremantle",83
11887,2000-07-23,"R20","Richmond",18,11,119,"St Kilda",12,7,79,"M.C.G.",40,2000,"Regular",20,"Home","Richmond","St Kilda",40
11888,2000-07-28,"R21","Essendon",12,9,81,"Footscray",14,8,92,"Docklands",-11,2000,"Regular",21,"Away","Footscray","Essendon",11
11889,2000-07-29,"R21","Hawthorn",15,8,98,"Adelaide",9,13,67,"M.C.G.",31,2000,"Regular",21,"Home","Hawthorn","Adelaide",31
11890,2000-07-29,"R21","Richmond",12,11,83,"Sydney",12,12,84,"Docklands",-1,2000,"Regular",21,"Away","Sydney","Richmond",1
11891,2000-07-29,"R21","Brisbane Lions",23,15,153,"St Kilda",8,15,63,"Gabba",90,2000,"Regular",21,"Home","Brisbane Lions","St Kilda",90
11892,2000-07-30,"R21","Port Adelaide",12,16,88,"Carlton",12,11,83,"Football Park",5,2000,"Regular",21,"Home","Port Adelaide","Carlton",5
11893,2000-07-30,"R21","North Melbourne",11,14,80,"Collingwood",14,14,98,"Docklands",-18,2000,"Regular",21,"Away","Collingwood","North Melbourne",18
11894,2000-07-30,"R21","Melbourne",18,18,126,"Geelong",17,6,108,"M.C.G.",18,2000,"Regular",21,"Home","Melbourne","Geelong",18
11895,2000-07-30,"R21","Fremantle",15,11,101,"West Coast",15,10,100,"Subiaco",1,2000,"Regular",21,"Home","Fremantle","West Coast",1
11896,2000-08-04,"R22","Footscray",9,12,66,"Hawthorn",11,15,81,"Docklands",-15,2000,"Regular",22,"Away","Hawthorn","Footscray",15
11897,2000-08-05,"R22","Essendon",13,19,97,"Collingwood",11,12,78,"M.C.G.",19,2000,"Regular",22,"Home","Essendon","Collingwood",19
11898,2000-08-05,"R22","Geelong",18,16,124,"Sydney",18,12,120,"Kardinia Park",4,2000,"Regular",22,"Home","Geelong","Sydney",4
11899,2000-08-05,"R22","Brisbane Lions",23,18,156,"Fremantle",7,7,49,"Gabba",107,2000,"Regular",22,"Home","Brisbane Lions","Fremantle",107
11900,2000-08-05,"R22","North Melbourne",18,12,120,"St Kilda",10,17,77,"Docklands",43,2000,"Regular",22,"Home","North Melbourne","St Kilda",43
11901,2000-08-06,"R22","Adelaide",14,8,92,"Port Adelaide",20,19,139,"Football Park",-47,2000,"Regular",22,"Away","Port Adelaide","Adelaide",47
11902,2000-08-06,"R22","Carlton",19,11,125,"Richmond",7,10,52,"M.C.G.",73,2000,"Regular",22,"Home","Carlton","Richmond",73
11903,2000-08-06,"R22","West Coast",15,10,100,"Melbourne",26,14,170,"Subiaco",-70,2000,"Regular",22,"Away","Melbourne","West Coast",70
11904,2000-08-11,"EF","Geelong",12,11,83,"Hawthorn",14,8,92,"Docklands",-9,2000,"Finals",23,"Away","Hawthorn","Geelong",9
11905,2000-08-12,"QF","Essendon",31,12,198,"North Melbourne",11,7,73,"M.C.G.",125,2000,"Finals",23,"Home","Essendon","North Melbourne",125
11906,2000-08-12,"EF","Brisbane Lions",15,20,110,"Footscray",10,16,76,"Gabba",34,2000,"Finals",23,"Home","Brisbane Lions","Footscray",34
11907,2000-08-13,"QF","Carlton",12,15,87,"Melbourne",15,6,96,"M.C.G.",-9,2000,"Finals",23,"Away","Melbourne","Carlton",9
11908,2000-08-18,"SF","North Melbourne",16,14,110,"Hawthorn",15,10,100,"M.C.G.",10,2000,"Finals",24,"Home","North Melbourne","Hawthorn",10
11909,2000-08-19,"SF","Carlton",23,13,151,"Brisbane Lions",10,9,69,"M.C.G.",82,2000,"Finals",24,"Home","Carlton","Brisbane Lions",82
11910,2000-08-25,"PF","Melbourne",23,18,156,"North Melbourne",17,4,106,"M.C.G.",50,2000,"Finals",25,"Home","Melbourne","North Melbourne",50
11911,2000-08-26,"PF","Essendon",18,17,125,"Carlton",12,8,80,"M.C.G.",45,2000,"Finals",25,"Home","Essendon","Carlton",45
11912,2000-09-02,"GF","Essendon",19,21,135,"Melbourne",11,9,75,"M.C.G.",60,2000,"Finals",26,"Home","Essendon","Melbourne",60
11913,2001-03-30,"R1","North Melbourne",9,7,61,"Essendon",23,8,146,"M.C.G.",-85,2001,"Regular",1,"Away","Essendon","North Melbourne",85
11914,2001-03-31,"R1","Hawthorn",13,7,85,"Collingwood",11,15,81,"M.C.G.",4,2001,"Regular",1,"Home","Hawthorn","Collingwood",4
11915,2001-03-31,"R1","Footscray",16,11,107,"St Kilda",16,16,112,"Docklands",-5,2001,"Regular",1,"Away","St Kilda","Footscray",5
11916,2001-03-31,"R1","Fremantle",18,10,118,"Carlton",18,11,119,"Subiaco",-1,2001,"Regular",1,"Away","Carlton","Fremantle",1
11917,2001-03-31,"R1","Port Adelaide",14,15,99,"Brisbane Lions",14,9,93,"Football Park",6,2001,"Regular",1,"Home","Port Adelaide","Brisbane Lions",6
11918,2001-04-01,"R1","Sydney",19,12,126,"Adelaide",10,14,74,"S.C.G.",52,2001,"Regular",1,"Home","Sydney","Adelaide",52
11919,2001-04-01,"R1","Geelong",17,13,115,"West Coast",7,7,49,"Kardinia Park",66,2001,"Regular",1,"Home","Geelong","West Coast",66
11920,2001-04-01,"R1","Melbourne",15,13,103,"Richmond",20,14,134,"M.C.G.",-31,2001,"Regular",1,"Away","Richmond","Melbourne",31
11921,2001-04-06,"R2","Essendon",23,7,145,"Port Adelaide",16,11,107,"Docklands",38,2001,"Regular",2,"Home","Essendon","Port Adelaide",38
11922,2001-04-07,"R2","Carlton",11,15,81,"Hawthorn",16,11,107,"Princes Park",-26,2001,"Regular",2,"Away","Hawthorn","Carlton",26
11923,2001-04-07,"R2","Richmond",9,15,69,"Footscray",17,9,111,"M.C.G.",-42,2001,"Regular",2,"Away","Footscray","Richmond",42
11924,2001-04-07,"R2","Collingwood",15,15,105,"Fremantle",13,10,88,"Docklands",17,2001,"Regular",2,"Home","Collingwood","Fremantle",17
11925,2001-04-07,"R2","Adelaide",11,14,80,"Melbourne",12,11,83,"Football Park",-3,2001,"Regular",2,"Away","Melbourne","Adelaide",3
11926,2001-04-08,"R2","St Kilda",13,8,86,"Geelong",17,13,115,"Docklands",-29,2001,"Regular",2,"Away","Geelong","St Kilda",29
11927,2001-04-08,"R2","Brisbane Lions",17,16,118,"North Melbourne",8,10,58,"Gabba",60,2001,"Regular",2,"Home","Brisbane Lions","North Melbourne",60
11928,2001-04-08,"R2","West Coast",13,11,89,"Sydney",15,14,104,"Subiaco",-15,2001,"Regular",2,"Away","Sydney","West Coast",15
11929,2001-04-12,"R3","Carlton",14,9,93,"Essendon",11,10,76,"M.C.G.",17,2001,"Regular",3,"Home","Carlton","Essendon",17
11930,2001-04-14,"R3","Richmond",17,14,116,"Brisbane Lions",14,10,94,"M.C.G.",22,2001,"Regular",3,"Home","Richmond","Brisbane Lions",22
11931,2001-04-14,"R3","Footscray",12,9,81,"Collingwood",23,15,153,"Docklands",-72,2001,"Regular",3,"Away","Collingwood","Footscray",72
11932,2001-04-14,"R3","North Melbourne",11,5,71,"Sydney",23,13,151,"S.C.G.",-80,2001,"Regular",3,"Away","Sydney","North Melbourne",80
11933,2001-04-15,"R3","Adelaide",13,10,88,"Port Adelaide",23,15,153,"Football Park",-65,2001,"Regular",3,"Away","Port Adelaide","Adelaide",65
11934,2001-04-15,"R3","Fremantle",8,11,59,"Hawthorn",11,16,82,"Subiaco",-23,2001,"Regular",3,"Away","Hawthorn","Fremantle",23
11935,2001-04-15,"R3","St Kilda",16,11,107,"West Coast",19,11,125,"Docklands",-18,2001,"Regular",3,"Away","West Coast","St Kilda",18
11936,2001-04-16,"R3","Melbourne",18,16,124,"Geelong",15,14,104,"M.C.G.",20,2001,"Regular",3,"Home","Melbourne","Geelong",20
11937,2001-04-20,"R4","Collingwood",10,11,71,"Richmond",13,8,86,"M.C.G.",-15,2001,"Regular",4,"Away","Richmond","Collingwood",15
11938,2001-04-20,"R4","Sydney",6,19,55,"Essendon",15,12,102,"S.C.G.",-47,2001,"Regular",4,"Away","Essendon","Sydney",47
11939,2001-04-21,"R4","Carlton",8,5,53,"Adelaide",9,8,62,"Princes Park",-9,2001,"Regular",4,"Away","Adelaide","Carlton",9
11940,2001-04-21,"R4","Footscray",21,14,140,"Brisbane Lions",12,15,87,"Docklands",53,2001,"Regular",4,"Home","Footscray","Brisbane Lions",53
11941,2001-04-21,"R4","Port Adelaide",17,12,114,"St Kilda",7,8,50,"Football Park",64,2001,"Regular",4,"Home","Port Adelaide","St Kilda",64
11942,2001-04-21,"R4","Fremantle",13,10,88,"West Coast",16,16,112,"Subiaco",-24,2001,"Regular",4,"Away","West Coast","Fremantle",24
11943,2001-04-22,"R4","Geelong",4,9,33,"North Melbourne",7,11,53,"Kardinia Park",-20,2001,"Regular",4,"Away","North Melbourne","Geelong",20
11944,2001-04-22,"R4","Hawthorn",11,17,83,"Melbourne",5,14,44,"M.C.G.",39,2001,"Regular",4,"Home","Hawthorn","Melbourne",39
11945,2001-04-25,"R5","Essendon",15,13,103,"Collingwood",14,11,95,"M.C.G.",8,2001,"Regular",5,"Home","Essendon","Collingwood",8
11946,2001-04-27,"R5","West Coast",11,4,70,"Richmond",17,7,109,"Subiaco",-39,2001,"Regular",5,"Away","Richmond","West Coast",39
11947,2001-04-28,"R5","Carlton",17,23,125,"St Kilda",14,8,92,"Princes Park",33,2001,"Regular",5,"Home","Carlton","St Kilda",33
11948,2001-04-28,"R5","Footscray",19,12,126,"Hawthorn",24,11,155,"Docklands",-29,2001,"Regular",5,"Away","Hawthorn","Footscray",29
11949,2001-04-28,"R5","Adelaide",12,18,90,"North Melbourne",10,15,75,"Football Park",15,2001,"Regular",5,"Home","Adelaide","North Melbourne",15
11950,2001-04-29,"R5","Brisbane Lions",25,21,171,"Fremantle",19,8,122,"Gabba",49,2001,"Regular",5,"Home","Brisbane Lions","Fremantle",49
11951,2001-04-29,"R5","Geelong",15,12,102,"Port Adelaide",23,10,148,"Kardinia Park",-46,2001,"Regular",5,"Away","Port Adelaide","Geelong",46
11952,2001-04-29,"R5","Melbourne",18,11,119,"Sydney",15,14,104,"M.C.G.",15,2001,"Regular",5,"Home","Melbourne","Sydney",15
11953,2001-05-04,"R6","North Melbourne",12,6,78,"Richmond",19,15,129,"Docklands",-51,2001,"Regular",6,"Away","Richmond","North Melbourne",51
11954,2001-05-05,"R6","St Kilda",18,12,120,"Sydney",14,10,94,"Docklands",26,2001,"Regular",6,"Home","St Kilda","Sydney",26
11955,2001-05-05,"R6","Port Adelaide",20,9,129,"Footscray",13,8,86,"Football Park",43,2001,"Regular",6,"Home","Port Adelaide","Footscray",43
11956,2001-05-05,"R6","Fremantle",9,20,74,"Melbourne",18,11,119,"Subiaco",-45,2001,"Regular",6,"Away","Melbourne","Fremantle",45
11957,2001-05-05,"R6","Brisbane Lions",17,14,116,"Geelong",8,13,61,"Gabba",55,2001,"Regular",6,"Home","Brisbane Lions","Geelong",55
11958,2001-05-06,"R6","Hawthorn",16,8,104,"Adelaide",12,19,91,"York Park",13,2001,"Regular",6,"Home","Hawthorn","Adelaide",13
11959,2001-05-06,"R6","Essendon",24,14,158,"West Coast",10,10,70,"Docklands",88,2001,"Regular",6,"Home","Essendon","West Coast",88
11960,2001-05-06,"R6","Collingwood",15,13,103,"Carlton",14,11,95,"M.C.G.",8,2001,"Regular",6,"Home","Collingwood","Carlton",8
11961,2001-05-11,"R7","Melbourne",12,5,77,"Footscray",15,17,107,"M.C.G.",-30,2001,"Regular",7,"Away","Footscray","Melbourne",30
11962,2001-05-12,"R7","Richmond",10,14,74,"Essendon",16,24,120,"M.C.G.",-46,2001,"Regular",7,"Away","Essendon","Richmond",46
11963,2001-05-12,"R7","St Kilda",15,9,99,"Hawthorn",16,14,110,"Docklands",-11,2001,"Regular",7,"Away","Hawthorn","St Kilda",11
11964,2001-05-12,"R7","Adelaide",14,19,103,"Fremantle",12,11,83,"Football Park",20,2001,"Regular",7,"Home","Adelaide","Fremantle",20
11965,2001-05-13,"R7","Geelong",9,14,68,"Carlton",17,6,108,"M.C.G.",-40,2001,"Regular",7,"Away","Carlton","Geelong",40
11966,2001-05-13,"R7","Collingwood",14,13,97,"North Melbourne",15,9,99,"Docklands",-2,2001,"Regular",7,"Away","North Melbourne","Collingwood",2
11967,2001-05-13,"R7","Sydney",12,8,80,"Brisbane Lions",15,22,112,"S.C.G.",-32,2001,"Regular",7,"Away","Brisbane Lions","Sydney",32
11968,2001-05-13,"R7","West Coast",7,8,50,"Port Adelaide",17,19,121,"Subiaco",-71,2001,"Regular",7,"Away","Port Adelaide","West Coast",71
11969,2001-05-18,"R8","Richmond",14,8,92,"Adelaide",17,18,120,"M.C.G.",-28,2001,"Regular",8,"Away","Adelaide","Richmond",28
11970,2001-05-19,"R8","North Melbourne",19,24,138,"St Kilda",13,11,89,"Manuka Oval",49,2001,"Regular",8,"Home","North Melbourne","St Kilda",49
11971,2001-05-19,"R8","Carlton",21,16,142,"Brisbane Lions",9,14,68,"Princes Park",74,2001,"Regular",8,"Home","Carlton","Brisbane Lions",74
11972,2001-05-19,"R8","Hawthorn",21,12,138,"West Coast",8,10,58,"M.C.G.",80,2001,"Regular",8,"Home","Hawthorn","West Coast",80
11973,2001-05-19,"R8","Port Adelaide",16,14,110,"Collingwood",18,11,119,"Football Park",-9,2001,"Regular",8,"Away","Collingwood","Port Adelaide",9
11974,2001-05-20,"R8","Melbourne",11,13,79,"Essendon",12,13,85,"M.C.G.",-6,2001,"Regular",8,"Away","Essendon","Melbourne",6
11975,2001-05-20,"R8","Footscray",18,14,122,"Sydney",15,11,101,"S.C.G.",21,2001,"Regular",8,"Home","Footscray","Sydney",21
11976,2001-05-20,"R8","Fremantle",10,13,73,"Geelong",14,11,95,"Subiaco",-22,2001,"Regular",8,"Away","Geelong","Fremantle",22
11977,2001-05-25,"R9","North Melbourne",10,9,69,"Carlton",12,10,82,"M.C.G.",-13,2001,"Regular",9,"Away","Carlton","North Melbourne",13
11978,2001-05-26,"R9","Collingwood",14,14,98,"St Kilda",12,8,80,"M.C.G.",18,2001,"Regular",9,"Home","Collingwood","St Kilda",18
11979,2001-05-26,"R9","Brisbane Lions",18,14,122,"Adelaide",19,13,127,"Gabba",-5,2001,"Regular",9,"Away","Adelaide","Brisbane Lions",5
11980,2001-05-26,"R9","Essendon",18,14,122,"Hawthorn",8,9,57,"Docklands",65,2001,"Regular",9,"Home","Essendon","Hawthorn",65
11981,2001-05-26,"R9","West Coast",11,11,77,"Footscray",18,17,125,"Subiaco",-48,2001,"Regular",9,"Away","Footscray","West Coast",48
11982,2001-05-27,"R9","Sydney",12,12,84,"Fremantle",10,5,65,"S.C.G.",19,2001,"Regular",9,"Home","Sydney","Fremantle",19
11983,2001-05-27,"R9","Geelong",17,16,118,"Richmond",11,10,76,"Kardinia Park",42,2001,"Regular",9,"Home","Geelong","Richmond",42
11984,2001-05-27,"R9","Port Adelaide",13,10,88,"Melbourne",9,14,68,"Football Park",20,2001,"Regular",9,"Home","Port Adelaide","Melbourne",20
11985,2001-06-01,"R10","Footscray",11,13,79,"North Melbourne",19,11,125,"Docklands",-46,2001,"Regular",10,"Away","North Melbourne","Footscray",46
11986,2001-06-02,"R10","Carlton",21,23,149,"West Coast",3,12,30,"Princes Park",119,2001,"Regular",10,"Home","Carlton","West Coast",119
11987,2001-06-02,"R10","Hawthorn",10,13,73,"Port Adelaide",17,14,116,"M.C.G.",-43,2001,"Regular",10,"Away","Port Adelaide","Hawthorn",43
11988,2001-06-02,"R10","St Kilda",17,11,113,"Melbourne",22,12,144,"Docklands",-31,2001,"Regular",10,"Away","Melbourne","St Kilda",31
11989,2001-06-02,"R10","Brisbane Lions",15,12,102,"Essendon",10,14,74,"Gabba",28,2001,"Regular",10,"Home","Brisbane Lions","Essendon",28
11990,2001-06-03,"R10","Adelaide",9,12,66,"Geelong",8,7,55,"Football Park",11,2001,"Regular",10,"Home","Adelaide","Geelong",11
11991,2001-06-03,"R10","Collingwood",7,13,55,"Sydney",11,7,73,"Docklands",-18,2001,"Regular",10,"Away","Sydney","Collingwood",18
11992,2001-06-03,"R10","Fremantle",6,10,46,"Richmond",12,12,84,"Subiaco",-38,2001,"Regular",10,"Away","Richmond","Fremantle",38
11993,2001-06-08,"R11","St Kilda",13,8,86,"Essendon",19,14,128,"Docklands",-42,2001,"Regular",11,"Away","Essendon","St Kilda",42
11994,2001-06-09,"R11","Geelong",14,9,93,"Hawthorn",13,12,90,"Docklands",3,2001,"Regular",11,"Home","Geelong","Hawthorn",3
11995,2001-06-09,"R11","Adelaide",14,13,97,"Footscray",19,13,127,"Football Park",-30,2001,"Regular",11,"Away","Footscray","Adelaide",30
11996,2001-06-09,"R11","West Coast",9,8,62,"Brisbane Lions",11,18,84,"Subiaco",-22,2001,"Regular",11,"Away","Brisbane Lions","West Coast",22
11997,2001-06-10,"R11","Richmond",13,10,88,"Carlton",8,13,61,"M.C.G.",27,2001,"Regular",11,"Home","Richmond","Carlton",27
11998,2001-06-10,"R11","North Melbourne",23,16,154,"Fremantle",10,8,68,"Docklands",86,2001,"Regular",11,"Home","North Melbourne","Fremantle",86
11999,2001-06-10,"R11","Sydney",18,17,125,"Port Adelaide",10,18,78,"S.C.G.",47,2001,"Regular",11,"Home","Sydney","Port Adelaide",47
12000,2001-06-11,"R11","Melbourne",8,9,57,"Collingwood",19,20,134,"M.C.G.",-77,2001,"Regular",11,"Away","Collingwood","Melbourne",77
12001,2001-06-15,"R12","Essendon",18,14,122,"Adelaide",11,7,73,"Docklands",49,2001,"Regular",12,"Home","Essendon","Adelaide",49
12002,2001-06-16,"R12","Geelong",13,9,87,"Footscray",15,4,94,"Kardinia Park",-7,2001,"Regular",12,"Away","Footscray","Geelong",7
12003,2001-06-16,"R12","Fremantle",11,14,80,"St Kilda",12,18,90,"Subiaco",-10,2001,"Regular",12,"Away","St Kilda","Fremantle",10
12004,2001-06-17,"R12","Melbourne",14,15,99,"Brisbane Lions",23,10,148,"Gabba",-49,2001,"Regular",12,"Away","Brisbane Lions","Melbourne",49
12005,2001-06-22,"R12","Collingwood",26,17,173,"West Coast",14,8,92,"Docklands",81,2001,"Regular",12,"Home","Collingwood","West Coast",81
12006,2001-06-23,"R12","Hawthorn",15,11,101,"North Melbourne",14,14,98,"M.C.G.",3,2001,"Regular",12,"Home","Hawthorn","North Melbourne",3
12007,2001-06-23,"R12","Richmond",12,14,86,"Sydney",8,12,60,"Docklands",26,2001,"Regular",12,"Home","Richmond","Sydney",26
12008,2001-06-24,"R12","Port Adelaide",10,10,70,"Carlton",15,14,104,"Football Park",-34,2001,"Regular",12,"Away","Carlton","Port Adelaide",34
12009,2001-06-29,"R13","Brisbane Lions",20,20,140,"Hawthorn",8,5,53,"Gabba",87,2001,"Regular",13,"Home","Brisbane Lions","Hawthorn",87
12010,2001-06-30,"R13","North Melbourne",14,11,95,"Port Adelaide",10,13,73,"Manuka Oval",22,2001,"Regular",13,"Home","North Melbourne","Port Adelaide",22
12011,2001-06-30,"R13","Carlton",23,15,153,"Footscray",13,14,92,"Princes Park",61,2001,"Regular",13,"Home","Carlton","Footscray",61
12012,2001-06-30,"R13","Essendon",18,10,118,"Fremantle",10,12,72,"Docklands",46,2001,"Regular",13,"Home","Essendon","Fremantle",46
12013,2001-06-30,"R13","Adelaide",14,13,97,"Collingwood",15,9,99,"Football Park",-2,2001,"Regular",13,"Away","Collingwood","Adelaide",2
12014,2001-07-01,"R13","Sydney",9,11,65,"Geelong",12,12,84,"S.C.G.",-19,2001,"Regular",13,"Away","Geelong","Sydney",19
12015,2001-07-01,"R13","St Kilda",13,9,87,"Richmond",19,12,126,"Docklands",-39,2001,"Regular",13,"Away","Richmond","St Kilda",39
12016,2001-07-01,"R13","West Coast",15,5,95,"Melbourne",13,10,88,"Subiaco",7,2001,"Regular",13,"Home","West Coast","Melbourne",7
12017,2001-07-06,"R14","Footscray",11,10,76,"Essendon",24,10,154,"Docklands",-78,2001,"Regular",14,"Away","Essendon","Footscray",78
12018,2001-07-07,"R14","Richmond",10,11,71,"Hawthorn",20,9,129,"M.C.G.",-58,2001,"Regular",14,"Away","Hawthorn","Richmond",58
12019,2001-07-07,"R14","Adelaide",8,16,64,"West Coast",7,9,51,"Football Park",13,2001,"Regular",14,"Home","Adelaide","West Coast",13
12020,2001-07-07,"R14","Brisbane Lions",17,17,119,"St Kilda",9,8,62,"Gabba",57,2001,"Regular",14,"Home","Brisbane Lions","St Kilda",57
12021,2001-07-08,"R14","Sydney",12,19,91,"Carlton",12,9,81,"S.C.G.",10,2001,"Regular",14,"Home","Sydney","Carlton",10
12022,2001-07-08,"R14","Geelong",16,15,111,"Collingwood",14,9,93,"Docklands",18,2001,"Regular",14,"Home","Geelong","Collingwood",18
12023,2001-07-08,"R14","Melbourne",13,15,93,"North Melbourne",18,13,121,"M.C.G.",-28,2001,"Regular",14,"Away","North Melbourne","Melbourne",28
12024,2001-07-08,"R14","Fremantle",11,5,71,"Port Adelaide",25,13,163,"Subiaco",-92,2001,"Regular",14,"Away","Port Adelaide","Fremantle",92
12025,2001-07-13,"R15","St Kilda",9,5,59,"Adelaide",23,18,156,"Docklands",-97,2001,"Regular",15,"Away","Adelaide","St Kilda",97
12026,2001-07-14,"R15","Carlton",16,15,111,"Melbourne",18,9,117,"Princes Park",-6,2001,"Regular",15,"Away","Melbourne","Carlton",6
12027,2001-07-14,"R15","Footscray",16,23,119,"Fremantle",11,19,85,"Docklands",34,2001,"Regular",15,"Home","Footscray","Fremantle",34
12028,2001-07-14,"R15","Hawthorn",11,11,77,"Sydney",14,14,98,"M.C.G.",-21,2001,"Regular",15,"Away","Sydney","Hawthorn",21
12029,2001-07-14,"R15","Port Adelaide",14,12,96,"Richmond",7,10,52,"Football Park",44,2001,"Regular",15,"Home","Port Adelaide","Richmond",44
12030,2001-07-15,"R15","Collingwood",16,7,103,"Brisbane Lions",19,15,129,"M.C.G.",-26,2001,"Regular",15,"Away","Brisbane Lions","Collingwood",26
12031,2001-07-15,"R15","Essendon",19,13,127,"Geelong",17,10,112,"Docklands",15,2001,"Regular",15,"Home","Essendon","Geelong",15
12032,2001-07-15,"R15","West Coast",17,8,110,"North Melbourne",24,10,154,"Subiaco",-44,2001,"Regular",15,"Away","North Melbourne","West Coast",44
12033,2001-07-20,"R16","Richmond",19,13,127,"Melbourne",12,14,86,"M.C.G.",41,2001,"Regular",16,"Home","Richmond","Melbourne",41
12034,2001-07-21,"R16","Carlton",19,17,131,"Fremantle",8,8,56,"Princes Park",75,2001,"Regular",16,"Home","Carlton","Fremantle",75
12035,2001-07-21,"R16","Collingwood",14,5,89,"Hawthorn",21,18,144,"M.C.G.",-55,2001,"Regular",16,"Away","Hawthorn","Collingwood",55
12036,2001-07-21,"R16","St Kilda",12,6,78,"Footscray",16,16,112,"Docklands",-34,2001,"Regular",16,"Away","Footscray","St Kilda",34
12037,2001-07-21,"R16","Brisbane Lions",13,16,94,"Port Adelaide",8,12,60,"Gabba",34,2001,"Regular",16,"Home","Brisbane Lions","Port Adelaide",34
12038,2001-07-22,"R16","Adelaide",7,14,56,"Sydney",16,9,105,"Football Park",-49,2001,"Regular",16,"Away","Sydney","Adelaide",49
12039,2001-07-22,"R16","Essendon",27,9,171,"North Melbourne",25,9,159,"M.C.G.",12,2001,"Regular",16,"Home","Essendon","North Melbourne",12
12040,2001-07-22,"R16","West Coast",12,8,80,"Geelong",22,18,150,"Subiaco",-70,2001,"Regular",16,"Away","Geelong","West Coast",70
12041,2001-07-27,"R17","Footscray",15,10,100,"Richmond",15,12,102,"Docklands",-2,2001,"Regular",17,"Away","Richmond","Footscray",2
12042,2001-07-28,"R17","Melbourne",12,12,84,"Adelaide",15,10,100,"M.C.G.",-16,2001,"Regular",17,"Away","Adelaide","Melbourne",16
12043,2001-07-28,"R17","Geelong",12,6,78,"St Kilda",10,6,66,"Kardinia Park",12,2001,"Regular",17,"Home","Geelong","St Kilda",12
12044,2001-07-28,"R17","North Melbourne",18,7,115,"Brisbane Lions",21,10,136,"Docklands",-21,2001,"Regular",17,"Away","Brisbane Lions","North Melbourne",21
12045,2001-07-28,"R17","Fremantle",13,12,90,"Collingwood",19,5,119,"Subiaco",-29,2001,"Regular",17,"Away","Collingwood","Fremantle",29
12046,2001-07-29,"R17","Hawthorn",15,6,96,"Carlton",13,15,93,"M.C.G.",3,2001,"Regular",17,"Home","Hawthorn","Carlton",3
12047,2001-07-29,"R17","Port Adelaide",15,14,104,"Essendon",14,13,97,"Football Park",7,2001,"Regular",17,"Home","Port Adelaide","Essendon",7
12048,2001-07-29,"R17","Sydney",11,17,83,"West Coast",6,12,48,"S.C.G.",35,2001,"Regular",17,"Home","Sydney","West Coast",35
12049,2001-08-03,"R18","Richmond",10,11,71,"Collingwood",6,15,51,"M.C.G.",20,2001,"Regular",18,"Home","Richmond","Collingwood",20
12050,2001-08-04,"R18","Hawthorn",13,12,90,"Fremantle",16,10,106,"Docklands",-16,2001,"Regular",18,"Away","Fremantle","Hawthorn",16
12051,2001-08-04,"R18","Geelong",15,10,100,"Melbourne",16,7,103,"M.C.G.",-3,2001,"Regular",18,"Away","Melbourne","Geelong",3
12052,2001-08-04,"R18","Sydney",22,11,143,"North Melbourne",3,18,36,"S.C.G.",107,2001,"Regular",18,"Home","Sydney","North Melbourne",107
12053,2001-08-05,"R18","Port Adelaide",16,11,107,"Adelaide",15,9,99,"Football Park",8,2001,"Regular",18,"Home","Port Adelaide","Adelaide",8
12054,2001-08-05,"R18","Essendon",14,11,95,"Carlton",16,6,102,"M.C.G.",-7,2001,"Regular",18,"Away","Carlton","Essendon",7
12055,2001-08-05,"R18","Brisbane Lions",19,22,136,"Footscray",15,13,103,"Gabba",33,2001,"Regular",18,"Home","Brisbane Lions","Footscray",33
12056,2001-08-05,"R18","West Coast",26,15,171,"St Kilda",12,7,79,"Subiaco",92,2001,"Regular",18,"Home","West Coast","St Kilda",92
12057,2001-08-10,"R19","North Melbourne",21,5,131,"Geelong",12,10,82,"Docklands",49,2001,"Regular",19,"Home","North Melbourne","Geelong",49
12058,2001-08-11,"R19","St Kilda",16,18,114,"Port Adelaide",19,11,125,"Docklands",-11,2001,"Regular",19,"Away","Port Adelaide","St Kilda",11
12059,2001-08-11,"R19","Melbourne",10,11,71,"Hawthorn",24,12,156,"M.C.G.",-85,2001,"Regular",19,"Away","Hawthorn","Melbourne",85
12060,2001-08-11,"R19","Adelaide",16,10,106,"Carlton",8,5,53,"Football Park",53,2001,"Regular",19,"Home","Adelaide","Carlton",53
12061,2001-08-12,"R19","Collingwood",17,17,119,"Footscray",11,11,77,"M.C.G.",42,2001,"Regular",19,"Home","Collingwood","Footscray",42
12062,2001-08-12,"R19","Essendon",11,13,79,"Sydney",11,11,77,"Docklands",2,2001,"Regular",19,"Home","Essendon","Sydney",2
12063,2001-08-12,"R19","Brisbane Lions",19,14,128,"Richmond",15,7,97,"Gabba",31,2001,"Regular",19,"Home","Brisbane Lions","Richmond",31
12064,2001-08-12,"R19","West Coast",14,14,98,"Fremantle",9,10,64,"Subiaco",34,2001,"Regular",19,"Home","West Coast","Fremantle",34
12065,2001-08-17,"R20","North Melbourne",15,10,100,"Adelaide",25,12,162,"Docklands",-62,2001,"Regular",20,"Away","Adelaide","North Melbourne",62
12066,2001-08-18,"R20","Richmond",20,18,138,"West Coast",10,13,73,"Docklands",65,2001,"Regular",20,"Home","Richmond","West Coast",65
12067,2001-08-18,"R20","Collingwood",13,9,87,"Essendon",15,17,107,"M.C.G.",-20,2001,"Regular",20,"Away","Essendon","Collingwood",20
12068,2001-08-18,"R20","Port Adelaide",14,15,99,"Geelong",10,9,69,"Football Park",30,2001,"Regular",20,"Home","Port Adelaide","Geelong",30
12069,2001-08-19,"R20","St Kilda",16,8,104,"Carlton",22,16,148,"Docklands",-44,2001,"Regular",20,"Away","Carlton","St Kilda",44
12070,2001-08-19,"R20","Hawthorn",12,7,79,"Footscray",17,23,125,"M.C.G.",-46,2001,"Regular",20,"Away","Footscray","Hawthorn",46
12071,2001-08-19,"R20","Fremantle",12,15,87,"Brisbane Lions",21,12,138,"Subiaco",-51,2001,"Regular",20,"Away","Brisbane Lions","Fremantle",51
12072,2001-08-19,"R20","Sydney",14,14,98,"Melbourne",19,17,131,"S.C.G.",-33,2001,"Regular",20,"Away","Melbourne","Sydney",33
12073,2001-08-24,"R21","Richmond",13,14,92,"North Melbourne",13,10,88,"M.C.G.",4,2001,"Regular",21,"Home","Richmond","North Melbourne",4
12074,2001-08-25,"R21","Carlton",20,10,130,"Collingwood",9,8,62,"M.C.G.",68,2001,"Regular",21,"Home","Carlton","Collingwood",68
12075,2001-08-25,"R21","Footscray",10,13,73,"Port Adelaide",22,18,150,"Docklands",-77,2001,"Regular",21,"Away","Port Adelaide","Footscray",77
12076,2001-08-25,"R21","West Coast",6,11,47,"Essendon",21,10,136,"Subiaco",-89,2001,"Regular",21,"Away","Essendon","West Coast",89
12077,2001-08-26,"R21","Adelaide",13,13,91,"Hawthorn",8,5,53,"Football Park",38,2001,"Regular",21,"Home","Adelaide","Hawthorn",38
12078,2001-08-26,"R21","Melbourne",16,18,114,"Fremantle",12,7,79,"Docklands",35,2001,"Regular",21,"Home","Melbourne","Fremantle",35
12079,2001-08-26,"R21","Geelong",9,13,67,"Brisbane Lions",16,14,110,"Kardinia Park",-43,2001,"Regular",21,"Away","Brisbane Lions","Geelong",43
12080,2001-08-26,"R21","Sydney",21,16,142,"St Kilda",8,7,55,"S.C.G.",87,2001,"Regular",21,"Home","Sydney","St Kilda",87
12081,2001-08-31,"R22","Essendon",12,11,83,"Richmond",17,5,107,"M.C.G.",-24,2001,"Regular",22,"Away","Richmond","Essendon",24
12082,2001-09-01,"R22","Carlton",13,19,97,"Geelong",3,9,27,"Princes Park",70,2001,"Regular",22,"Home","Carlton","Geelong",70
12083,2001-09-01,"R22","Hawthorn",13,9,87,"St Kilda",13,11,89,"M.C.G.",-2,2001,"Regular",22,"Away","St Kilda","Hawthorn",2
12084,2001-09-01,"R22","Brisbane Lions",13,15,93,"Sydney",9,8,62,"Gabba",31,2001,"Regular",22,"Home","Brisbane Lions","Sydney",31
12085,2001-09-01,"R22","Fremantle",17,18,120,"Adelaide",11,17,83,"Subiaco",37,2001,"Regular",22,"Home","Fremantle","Adelaide",37
12086,2001-09-02,"R22","North Melbourne",11,17,83,"Collingwood",19,12,126,"Manuka Oval",-43,2001,"Regular",22,"Away","Collingwood","North Melbourne",43
12087,2001-09-02,"R22","Footscray",19,9,123,"Melbourne",21,7,133,"Docklands",-10,2001,"Regular",22,"Away","Melbourne","Footscray",10
12088,2001-09-02,"R22","Port Adelaide",24,19,163,"West Coast",7,9,51,"Football Park",112,2001,"Regular",22,"Home","Port Adelaide","West Coast",112
12089,2001-09-07,"QF","Essendon",17,11,113,"Richmond",5,13,43,"M.C.G.",70,2001,"Finals",23,"Home","Essendon","Richmond",70
12090,2001-09-08,"EF","Carlton",17,16,118,"Adelaide",6,14,50,"M.C.G.",68,2001,"Finals",23,"Home","Carlton","Adelaide",68
12091,2001-09-08,"QF","Brisbane Lions",12,16,88,"Port Adelaide",8,8,56,"Gabba",32,2001,"Finals",23,"Home","Brisbane Lions","Port Adelaide",32
12092,2001-09-09,"EF","Hawthorn",19,15,129,"Sydney",11,8,74,"Docklands",55,2001,"Finals",23,"Home","Hawthorn","Sydney",55
12093,2001-09-15,"SF","Richmond",10,7,67,"Carlton",7,14,56,"M.C.G.",11,2001,"Finals",24,"Home","Richmond","Carlton",11
12094,2001-09-15,"SF","Port Adelaide",10,9,69,"Hawthorn",10,12,72,"Football Park",-3,2001,"Finals",24,"Away","Hawthorn","Port Adelaide",3
12095,2001-09-22,"PF","Essendon",11,10,76,"Hawthorn",9,13,67,"M.C.G.",9,2001,"Finals",25,"Home","Essendon","Hawthorn",9
12096,2001-09-22,"PF","Brisbane Lions",20,16,136,"Richmond",10,8,68,"Gabba",68,2001,"Finals",25,"Home","Brisbane Lions","Richmond",68
12097,2001-09-29,"GF","Essendon",12,10,82,"Brisbane Lions",15,18,108,"M.C.G.",-26,2001,"Finals",26,"Away","Brisbane Lions","Essendon",26
12098,2002-03-28,"R1","Richmond",24,11,155,"Collingwood",18,10,118,"M.C.G.",37,2002,"Regular",1,"Home","Richmond","Collingwood",37
12099,2002-03-30,"R1","St Kilda",14,5,89,"Carlton",10,5,65,"Docklands",24,2002,"Regular",1,"Home","St Kilda","Carlton",24
12100,2002-03-30,"R1","Geelong",11,10,76,"Essendon",18,18,126,"M.C.G.",-50,2002,"Regular",1,"Away","Essendon","Geelong",50
12101,2002-03-30,"R1","Port Adelaide",11,7,73,"North Melbourne",12,11,83,"Football Park",-10,2002,"Regular",1,"Away","North Melbourne","Port Adelaide",10
12102,2002-03-31,"R1","Sydney",12,15,87,"Brisbane Lions",17,8,110,"S.C.G.",-23,2002,"Regular",1,"Away","Brisbane Lions","Sydney",23
12103,2002-03-31,"R1","Footscray",12,21,93,"Adelaide",16,16,112,"Docklands",-19,2002,"Regular",1,"Away","Adelaide","Footscray",19
12104,2002-03-31,"R1","West Coast",21,11,137,"Fremantle",18,10,118,"Subiaco",19,2002,"Regular",1,"Home","West Coast","Fremantle",19
12105,2002-04-01,"R1","Hawthorn",15,13,103,"Melbourne",20,9,129,"M.C.G.",-26,2002,"Regular",1,"Away","Melbourne","Hawthorn",26
12106,2002-04-05,"R2","Essendon",16,16,112,"Richmond",8,12,60,"M.C.G.",52,2002,"Regular",2,"Home","Essendon","Richmond",52
12107,2002-04-06,"R2","Carlton",4,9,33,"Sydney",17,9,111,"Princes Park",-78,2002,"Regular",2,"Away","Sydney","Carlton",78
12108,2002-04-06,"R2","Collingwood",17,18,120,"West Coast",18,11,119,"M.C.G.",1,2002,"Regular",2,"Home","Collingwood","West Coast",1
12109,2002-04-06,"R2","North Melbourne",16,14,110,"Footscray",14,13,97,"Docklands",13,2002,"Regular",2,"Home","North Melbourne","Footscray",13
12110,2002-04-06,"R2","Adelaide",16,14,110,"Geelong",12,7,79,"Football Park",31,2002,"Regular",2,"Home","Adelaide","Geelong",31
12111,2002-04-07,"R2","Brisbane Lions",21,22,148,"Hawthorn",6,10,46,"Gabba",102,2002,"Regular",2,"Home","Brisbane Lions","Hawthorn",102
12112,2002-04-07,"R2","Melbourne",16,13,109,"Port Adelaide",11,16,82,"M.C.G.",27,2002,"Regular",2,"Home","Melbourne","Port Adelaide",27
12113,2002-04-07,"R2","Fremantle",10,16,76,"St Kilda",11,7,73,"Subiaco",3,2002,"Regular",2,"Home","Fremantle","St Kilda",3
12114,2002-04-12,"R3","Carlton",11,9,75,"Collingwood",7,13,55,"M.C.G.",20,2002,"Regular",3,"Home","Carlton","Collingwood",20
12115,2002-04-13,"R3","Richmond",13,18,96,"Melbourne",11,10,76,"M.C.G.",20,2002,"Regular",3,"Home","Richmond","Melbourne",20
12116,2002-04-13,"R3","Adelaide",17,12,114,"Sydney",13,6,84,"Football Park",30,2002,"Regular",3,"Home","Adelaide","Sydney",30
12117,2002-04-13,"R3","Brisbane Lions",17,15,117,"Essendon",9,13,67,"Gabba",50,2002,"Regular",3,"Home","Brisbane Lions","Essendon",50
12118,2002-04-13,"R3","North Melbourne",10,7,67,"Geelong",11,9,75,"Docklands",-8,2002,"Regular",3,"Away","Geelong","North Melbourne",8
12119,2002-04-14,"R3","Hawthorn",13,11,89,"Fremantle",11,13,79,"York Park",10,2002,"Regular",3,"Home","Hawthorn","Fremantle",10
12120,2002-04-14,"R3","St Kilda",8,8,56,"Port Adelaide",20,19,139,"Docklands",-83,2002,"Regular",3,"Away","Port Adelaide","St Kilda",83
12121,2002-04-14,"R3","West Coast",17,11,113,"Footscray",11,15,81,"Subiaco",32,2002,"Regular",3,"Home","West Coast","Footscray",32
12122,2002-04-19,"R4","Essendon",19,8,122,"Adelaide",11,15,81,"Docklands",41,2002,"Regular",4,"Home","Essendon","Adelaide",41
12123,2002-04-20,"R4","Collingwood",15,14,104,"Hawthorn",9,9,63,"M.C.G.",41,2002,"Regular",4,"Home","Collingwood","Hawthorn",41
12124,2002-04-20,"R4","Melbourne",21,11,137,"West Coast",15,13,103,"Princes Park",34,2002,"Regular",4,"Home","Melbourne","West Coast",34
12125,2002-04-20,"R4","Sydney",15,13,103,"North Melbourne",14,16,100,"S.C.G.",3,2002,"Regular",4,"Home","Sydney","North Melbourne",3
12126,2002-04-20,"R4","Footscray",12,6,78,"Brisbane Lions",14,10,94,"Docklands",-16,2002,"Regular",4,"Away","Brisbane Lions","Footscray",16
12127,2002-04-21,"R4","Port Adelaide",23,10,148,"Carlton",14,11,95,"Football Park",53,2002,"Regular",4,"Home","Port Adelaide","Carlton",53
12128,2002-04-21,"R4","Geelong",26,10,166,"St Kilda",6,8,44,"Kardinia Park",122,2002,"Regular",4,"Home","Geelong","St Kilda",122
12129,2002-04-21,"R4","Fremantle",21,12,138,"Richmond",11,6,72,"Subiaco",66,2002,"Regular",4,"Home","Fremantle","Richmond",66
12130,2002-04-25,"R5","Collingwood",9,12,66,"Essendon",4,9,33,"M.C.G.",33,2002,"Regular",5,"Home","Collingwood","Essendon",33
12131,2002-04-26,"R5","Footscray",10,21,81,"Melbourne",15,14,104,"Docklands",-23,2002,"Regular",5,"Away","Melbourne","Footscray",23
12132,2002-04-27,"R5","Hawthorn",19,11,125,"Richmond",12,11,83,"M.C.G.",42,2002,"Regular",5,"Home","Hawthorn","Richmond",42
12133,2002-04-27,"R5","West Coast",18,13,121,"Brisbane Lions",10,15,75,"Subiaco",46,2002,"Regular",5,"Home","West Coast","Brisbane Lions",46
12134,2002-04-27,"R5","St Kilda",8,8,56,"Sydney",8,8,56,"Docklands",0,2002,"Regular",5,"Home","St Kilda","Sydney",0
12135,2002-04-27,"R5","Adelaide",12,10,82,"Port Adelaide",14,6,90,"Football Park",-8,2002,"Regular",5,"Away","Port Adelaide","Adelaide",8
12136,2002-04-28,"R5","Geelong",17,9,111,"Fremantle",6,13,49,"Kardinia Park",62,2002,"Regular",5,"Home","Geelong","Fremantle",62
12137,2002-04-28,"R5","Carlton",17,10,112,"North Melbourne",19,17,131,"Docklands",-19,2002,"Regular",5,"Away","North Melbourne","Carlton",19
12138,2002-05-03,"R6","St Kilda",3,10,28,"Collingwood",16,15,111,"Docklands",-83,2002,"Regular",6,"Away","Collingwood","St Kilda",83
12139,2002-05-04,"R6","North Melbourne",13,9,87,"Hawthorn",24,11,155,"M.C.G.",-68,2002,"Regular",6,"Away","Hawthorn","North Melbourne",68
12140,2002-05-04,"R6","Fremantle",13,11,89,"Essendon",9,8,62,"Subiaco",27,2002,"Regular",6,"Home","Fremantle","Essendon",27
12141,2002-05-04,"R6","Carlton",9,14,68,"Footscray",14,12,96,"Docklands",-28,2002,"Regular",6,"Away","Footscray","Carlton",28
12142,2002-05-04,"R6","Brisbane Lions",21,20,146,"Geelong",13,11,89,"Gabba",57,2002,"Regular",6,"Home","Brisbane Lions","Geelong",57
12143,2002-05-05,"R6","Sydney",15,9,99,"Melbourne",10,11,71,"S.C.G.",28,2002,"Regular",6,"Home","Sydney","Melbourne",28
12144,2002-05-05,"R6","Richmond",11,7,73,"Adelaide",14,21,105,"Docklands",-32,2002,"Regular",6,"Away","Adelaide","Richmond",32
12145,2002-05-05,"R6","Port Adelaide",20,13,133,"West Coast",11,13,79,"Football Park",54,2002,"Regular",6,"Home","Port Adelaide","West Coast",54
12146,2002-05-10,"R7","Essendon",12,15,87,"Carlton",9,8,62,"M.C.G.",25,2002,"Regular",7,"Home","Essendon","Carlton",25
12147,2002-05-11,"R7","Hawthorn",20,10,130,"Geelong",11,12,78,"M.C.G.",52,2002,"Regular",7,"Home","Hawthorn","Geelong",52
12148,2002-05-11,"R7","West Coast",21,13,139,"North Melbourne",13,12,90,"Subiaco",49,2002,"Regular",7,"Home","West Coast","North Melbourne",49
12149,2002-05-11,"R7","Richmond",13,10,88,"Sydney",12,10,82,"Docklands",6,2002,"Regular",7,"Home","Richmond","Sydney",6
12150,2002-05-11,"R7","Adelaide",18,10,118,"Fremantle",13,11,89,"Football Park",29,2002,"Regular",7,"Home","Adelaide","Fremantle",29
12151,2002-05-12,"R7","Brisbane Lions",19,15,129,"Port Adelaide",11,6,72,"Gabba",57,2002,"Regular",7,"Home","Brisbane Lions","Port Adelaide",57
12152,2002-05-12,"R7","Footscray",8,15,63,"Collingwood",11,7,73,"Docklands",-10,2002,"Regular",7,"Away","Collingwood","Footscray",10
12153,2002-05-12,"R7","Melbourne",15,15,105,"St Kilda",15,12,102,"M.C.G.",3,2002,"Regular",7,"Home","Melbourne","St Kilda",3
12154,2002-05-17,"R8","Hawthorn",12,17,89,"Carlton",12,8,80,"M.C.G.",9,2002,"Regular",8,"Home","Hawthorn","Carlton",9
12155,2002-05-18,"R8","Richmond",13,16,94,"West Coast",10,13,73,"M.C.G.",21,2002,"Regular",8,"Home","Richmond","West Coast",21
12156,2002-05-18,"R8","Port Adelaide",20,9,129,"Geelong",7,12,54,"Football Park",75,2002,"Regular",8,"Home","Port Adelaide","Geelong",75
12157,2002-05-18,"R8","Collingwood",17,12,114,"Brisbane Lions",16,15,111,"Docklands",3,2002,"Regular",8,"Home","Collingwood","Brisbane Lions",3
12158,2002-05-18,"R8","Fremantle",14,10,94,"Melbourne",13,11,89,"Subiaco",5,2002,"Regular",8,"Home","Fremantle","Melbourne",5
12159,2002-05-19,"R8","North Melbourne",16,14,110,"Adelaide",14,9,93,"Manuka Oval",17,2002,"Regular",8,"Home","North Melbourne","Adelaide",17
12160,2002-05-19,"R8","Footscray",24,15,159,"Sydney",11,24,90,"S.C.G.",69,2002,"Regular",8,"Home","Footscray","Sydney",69
12161,2002-05-19,"R8","Essendon",26,15,171,"St Kilda",11,6,72,"Docklands",99,2002,"Regular",8,"Home","Essendon","St Kilda",99
12162,2002-05-24,"R9","Port Adelaide",14,7,91,"Collingwood",12,14,86,"Football Park",5,2002,"Regular",9,"Home","Port Adelaide","Collingwood",5
12163,2002-05-25,"R9","Geelong",17,3,105,"Footscray",18,9,117,"Kardinia Park",-12,2002,"Regular",9,"Away","Footscray","Geelong",12
12164,2002-05-25,"R9","Melbourne",17,9,111,"North Melbourne",15,17,107,"M.C.G.",4,2002,"Regular",9,"Home","Melbourne","North Melbourne",4
12165,2002-05-25,"R9","Sydney",11,17,83,"Essendon",12,13,85,"Stadium Australia",-2,2002,"Regular",9,"Away","Essendon","Sydney",2
12166,2002-05-25,"R9","St Kilda",10,12,72,"Richmond",9,9,63,"Docklands",9,2002,"Regular",9,"Home","St Kilda","Richmond",9
12167,2002-05-26,"R9","Brisbane Lions",16,13,109,"Fremantle",11,13,79,"Gabba",30,2002,"Regular",9,"Home","Brisbane Lions","Fremantle",30
12168,2002-05-26,"R9","Carlton",11,9,75,"Adelaide",20,11,131,"Princes Park",-56,2002,"Regular",9,"Away","Adelaide","Carlton",56
12169,2002-05-26,"R9","West Coast",19,12,126,"Hawthorn",14,4,88,"Subiaco",38,2002,"Regular",9,"Home","West Coast","Hawthorn",38
12170,2002-05-31,"R10","North Melbourne",12,20,92,"Essendon",12,12,84,"M.C.G.",8,2002,"Regular",10,"Home","North Melbourne","Essendon",8
12171,2002-06-01,"R10","Richmond",14,14,98,"Footscray",17,15,117,"M.C.G.",-19,2002,"Regular",10,"Away","Footscray","Richmond",19
12172,2002-06-01,"R10","Geelong",12,17,89,"Melbourne",9,9,63,"Kardinia Park",26,2002,"Regular",10,"Home","Geelong","Melbourne",26
12173,2002-06-01,"R10","Collingwood",14,11,95,"Sydney",12,12,84,"Docklands",11,2002,"Regular",10,"Home","Collingwood","Sydney",11
12174,2002-06-01,"R10","Adelaide",15,11,101,"Brisbane Lions",14,10,94,"Football Park",7,2002,"Regular",10,"Home","Adelaide","Brisbane Lions",7
12175,2002-06-02,"R10","Hawthorn",12,5,77,"Port Adelaide",17,15,117,"York Park",-40,2002,"Regular",10,"Away","Port Adelaide","Hawthorn",40
12176,2002-06-02,"R10","St Kilda",20,7,127,"West Coast",11,11,77,"Docklands",50,2002,"Regular",10,"Home","St Kilda","West Coast",50
12177,2002-06-02,"R10","Fremantle",14,12,96,"Carlton",10,8,68,"Subiaco",28,2002,"Regular",10,"Home","Fremantle","Carlton",28
12178,2002-06-07,"R11","North Melbourne",14,11,95,"Richmond",11,18,84,"Docklands",11,2002,"Regular",11,"Home","North Melbourne","Richmond",11
12179,2002-06-08,"R11","Adelaide",14,18,102,"Hawthorn",8,10,58,"Football Park",44,2002,"Regular",11,"Home","Adelaide","Hawthorn",44
12180,2002-06-08,"R11","Essendon",7,7,49,"Port Adelaide",16,12,108,"Docklands",-59,2002,"Regular",11,"Away","Port Adelaide","Essendon",59
12181,2002-06-08,"R11","West Coast",15,12,102,"Sydney",13,11,89,"Subiaco",13,2002,"Regular",11,"Home","West Coast","Sydney",13
12182,2002-06-09,"R11","Brisbane Lions",16,17,113,"St Kilda",7,10,52,"Gabba",61,2002,"Regular",11,"Home","Brisbane Lions","St Kilda",61
12183,2002-06-09,"R11","Geelong",15,10,100,"Carlton",14,12,96,"Docklands",4,2002,"Regular",11,"Home","Geelong","Carlton",4
12184,2002-06-09,"R11","Footscray",22,13,145,"Fremantle",12,8,80,"Princes Park",65,2002,"Regular",11,"Home","Footscray","Fremantle",65
12185,2002-06-10,"R11","Melbourne",10,15,75,"Collingwood",19,12,126,"M.C.G.",-51,2002,"Regular",11,"Away","Collingwood","Melbourne",51
12186,2002-06-14,"R12","Essendon",10,12,72,"Hawthorn",10,5,65,"M.C.G.",7,2002,"Regular",12,"Home","Essendon","Hawthorn",7
12187,2002-06-15,"R12","Carlton",12,16,88,"West Coast",12,17,89,"Princes Park",-1,2002,"Regular",12,"Away","West Coast","Carlton",1
12188,2002-06-15,"R12","Sydney",15,9,99,"Geelong",15,11,101,"S.C.G.",-2,2002,"Regular",12,"Away","Geelong","Sydney",2
12189,2002-06-16,"R12","Fremantle",12,18,90,"Collingwood",12,7,79,"Subiaco",11,2002,"Regular",12,"Home","Fremantle","Collingwood",11
12190,2002-06-21,"R12","Footscray",19,19,133,"St Kilda",13,8,86,"Docklands",47,2002,"Regular",12,"Home","Footscray","St Kilda",47
12191,2002-06-22,"R12","Melbourne",14,14,98,"Adelaide",10,13,73,"Princes Park",25,2002,"Regular",12,"Home","Melbourne","Adelaide",25
12192,2002-06-22,"R12","Brisbane Lions",20,18,138,"North Melbourne",19,9,123,"Gabba",15,2002,"Regular",12,"Home","Brisbane Lions","North Melbourne",15
12193,2002-06-23,"R12","Port Adelaide",23,16,154,"Richmond",10,10,70,"Football Park",84,2002,"Regular",12,"Home","Port Adelaide","Richmond",84
12194,2002-06-28,"R13","Essendon",18,12,120,"Melbourne",16,12,108,"Docklands",12,2002,"Regular",13,"Home","Essendon","Melbourne",12
12195,2002-06-29,"R13","Richmond",7,12,54,"Geelong",14,12,96,"M.C.G.",-42,2002,"Regular",13,"Away","Geelong","Richmond",42
12196,2002-06-29,"R13","Port Adelaide",25,11,161,"Footscray",18,7,115,"Football Park",46,2002,"Regular",13,"Home","Port Adelaide","Footscray",46
12197,2002-06-29,"R13","Brisbane Lions",19,10,124,"Carlton",16,13,109,"Gabba",15,2002,"Regular",13,"Home","Brisbane Lions","Carlton",15
12198,2002-06-29,"R13","Collingwood",13,15,93,"North Melbourne",8,12,60,"Docklands",33,2002,"Regular",13,"Home","Collingwood","North Melbourne",33
12199,2002-06-30,"R13","Sydney",20,19,139,"Fremantle",9,8,62,"S.C.G.",77,2002,"Regular",13,"Home","Sydney","Fremantle",77
12200,2002-06-30,"R13","St Kilda",11,12,78,"Hawthorn",13,9,87,"Docklands",-9,2002,"Regular",13,"Away","Hawthorn","St Kilda",9
12201,2002-06-30,"R13","West Coast",20,15,135,"Adelaide",18,9,117,"Subiaco",18,2002,"Regular",13,"Home","West Coast","Adelaide",18
12202,2002-07-05,"R14","Carlton",13,8,86,"Richmond",12,13,85,"M.C.G.",1,2002,"Regular",14,"Home","Carlton","Richmond",1
12203,2002-07-06,"R14","Geelong",8,17,65,"West Coast",4,9,33,"Kardinia Park",32,2002,"Regular",14,"Home","Geelong","West Coast",32
12204,2002-07-06,"R14","Hawthorn",11,8,74,"Sydney",9,10,64,"M.C.G.",10,2002,"Regular",14,"Home","Hawthorn","Sydney",10
12205,2002-07-06,"R14","Footscray",18,10,118,"Essendon",17,16,118,"Docklands",0,2002,"Regular",14,"Home","Footscray","Essendon",0
12206,2002-07-06,"R14","Fremantle",9,9,63,"Port Adelaide",22,15,147,"Subiaco",-84,2002,"Regular",14,"Away","Port Adelaide","Fremantle",84
12207,2002-07-07,"R14","Melbourne",20,11,131,"Brisbane Lions",16,14,110,"Gabba",21,2002,"Regular",14,"Home","Melbourne","Brisbane Lions",21
12208,2002-07-07,"R14","St Kilda",13,6,84,"North Melbourne",20,8,128,"Docklands",-44,2002,"Regular",14,"Away","North Melbourne","St Kilda",44
12209,2002-07-07,"R14","Adelaide",17,14,116,"Collingwood",21,12,138,"Football Park",-22,2002,"Regular",14,"Away","Collingwood","Adelaide",22
12210,2002-07-12,"R15","Hawthorn",17,14,116,"Footscray",14,9,93,"Docklands",23,2002,"Regular",15,"Home","Hawthorn","Footscray",23
12211,2002-07-13,"R15","North Melbourne",12,11,83,"Fremantle",12,10,82,"Manuka Oval",1,2002,"Regular",15,"Home","North Melbourne","Fremantle",1
12212,2002-07-13,"R15","Collingwood",15,9,99,"Geelong",19,13,127,"M.C.G.",-28,2002,"Regular",15,"Away","Geelong","Collingwood",28
12213,2002-07-13,"R15","Richmond",7,13,55,"Brisbane Lions",18,10,118,"Docklands",-63,2002,"Regular",15,"Away","Brisbane Lions","Richmond",63
12214,2002-07-13,"R15","Adelaide",15,9,99,"St Kilda",12,9,81,"Football Park",18,2002,"Regular",15,"Home","Adelaide","St Kilda",18
12215,2002-07-14,"R15","Sydney",13,14,92,"Port Adelaide",14,10,94,"S.C.G.",-2,2002,"Regular",15,"Away","Port Adelaide","Sydney",2
12216,2002-07-14,"R15","Carlton",14,11,95,"Melbourne",21,13,139,"Docklands",-44,2002,"Regular",15,"Away","Melbourne","Carlton",44
12217,2002-07-14,"R15","West Coast",13,12,90,"Essendon",8,15,63,"Subiaco",27,2002,"Regular",15,"Home","West Coast","Essendon",27
12218,2002-07-19,"R16","Collingwood",13,11,89,"Richmond",7,7,49,"M.C.G.",40,2002,"Regular",16,"Home","Collingwood","Richmond",40
12219,2002-07-20,"R16","Melbourne",9,13,67,"Hawthorn",14,9,93,"M.C.G.",-26,2002,"Regular",16,"Away","Hawthorn","Melbourne",26
12220,2002-07-20,"R16","North Melbourne",14,15,99,"Port Adelaide",10,10,70,"Princes Park",29,2002,"Regular",16,"Home","North Melbourne","Port Adelaide",29
12221,2002-07-20,"R16","Essendon",8,8,56,"Geelong",14,11,95,"Docklands",-39,2002,"Regular",16,"Away","Geelong","Essendon",39
12222,2002-07-20,"R16","Fremantle",15,10,100,"West Coast",11,4,70,"Subiaco",30,2002,"Regular",16,"Home","Fremantle","West Coast",30
12223,2002-07-21,"R16","Brisbane Lions",17,15,117,"Sydney",12,7,79,"Gabba",38,2002,"Regular",16,"Home","Brisbane Lions","Sydney",38
12224,2002-07-21,"R16","Carlton",14,13,97,"St Kilda",22,8,140,"Docklands",-43,2002,"Regular",16,"Away","St Kilda","Carlton",43
12225,2002-07-21,"R16","Adelaide",21,12,138,"Footscray",14,11,95,"Football Park",43,2002,"Regular",16,"Home","Adelaide","Footscray",43
12226,2002-07-26,"R17","Richmond",7,11,53,"Essendon",7,12,54,"M.C.G.",-1,2002,"Regular",17,"Away","Essendon","Richmond",1
12227,2002-07-27,"R17","Hawthorn",10,8,68,"Brisbane Lions",18,16,124,"M.C.G.",-56,2002,"Regular",17,"Away","Brisbane Lions","Hawthorn",56
12228,2002-07-27,"R17","West Coast",17,12,114,"Collingwood",8,8,56,"Subiaco",58,2002,"Regular",17,"Home","West Coast","Collingwood",58
12229,2002-07-27,"R17","Sydney",13,14,92,"Carlton",10,9,69,"Stadium Australia",23,2002,"Regular",17,"Home","Sydney","Carlton",23
12230,2002-07-27,"R17","Port Adelaide",17,14,116,"Melbourne",17,10,112,"Football Park",4,2002,"Regular",17,"Home","Port Adelaide","Melbourne",4
12231,2002-07-28,"R17","Geelong",12,18,90,"Adelaide",15,3,93,"Kardinia Park",-3,2002,"Regular",17,"Away","Adelaide","Geelong",3
12232,2002-07-28,"R17","Footscray",21,13,139,"North Melbourne",16,9,105,"Docklands",34,2002,"Regular",17,"Home","Footscray","North Melbourne",34
12233,2002-07-28,"R17","St Kilda",18,10,118,"Fremantle",11,13,79,"Princes Park",39,2002,"Regular",17,"Home","St Kilda","Fremantle",39
12234,2002-08-02,"R18","Collingwood",21,15,141,"Carlton",4,9,33,"M.C.G.",108,2002,"Regular",18,"Home","Collingwood","Carlton",108
12235,2002-08-03,"R18","Geelong",7,9,51,"North Melbourne",17,13,115,"Kardinia Park",-64,2002,"Regular",18,"Away","North Melbourne","Geelong",64
12236,2002-08-03,"R18","Fremantle",14,12,96,"Hawthorn",4,11,35,"Subiaco",61,2002,"Regular",18,"Home","Fremantle","Hawthorn",61
12237,2002-08-03,"R18","Essendon",11,5,71,"Brisbane Lions",16,12,108,"Docklands",-37,2002,"Regular",18,"Away","Brisbane Lions","Essendon",37
12238,2002-08-03,"R18","Port Adelaide",16,9,105,"St Kilda",9,9,63,"Football Park",42,2002,"Regular",18,"Home","Port Adelaide","St Kilda",42
12239,2002-08-04,"R18","Sydney",15,8,98,"Adelaide",17,14,116,"S.C.G.",-18,2002,"Regular",18,"Away","Adelaide","Sydney",18
12240,2002-08-04,"R18","Footscray",22,10,142,"West Coast",14,7,91,"Princes Park",51,2002,"Regular",18,"Home","Footscray","West Coast",51
12241,2002-08-04,"R18","Melbourne",14,10,94,"Richmond",14,15,99,"M.C.G.",-5,2002,"Regular",18,"Away","Richmond","Melbourne",5
12242,2002-08-09,"R19","Hawthorn",15,15,105,"Collingwood",14,13,97,"M.C.G.",8,2002,"Regular",19,"Home","Hawthorn","Collingwood",8
12243,2002-08-10,"R19","Carlton",5,15,45,"Port Adelaide",7,12,54,"Princes Park",-9,2002,"Regular",19,"Away","Port Adelaide","Carlton",9
12244,2002-08-10,"R19","Richmond",18,14,122,"Fremantle",10,12,72,"M.C.G.",50,2002,"Regular",19,"Home","Richmond","Fremantle",50
12245,2002-08-10,"R19","Brisbane Lions",14,21,105,"Footscray",9,13,67,"Gabba",38,2002,"Regular",19,"Home","Brisbane Lions","Footscray",38
12246,2002-08-10,"R19","North Melbourne",15,7,97,"Sydney",22,12,144,"S.C.G.",-47,2002,"Regular",19,"Away","Sydney","North Melbourne",47
12247,2002-08-11,"R19","Adelaide",18,16,124,"Essendon",11,10,76,"Football Park",48,2002,"Regular",19,"Home","Adelaide","Essendon",48
12248,2002-08-11,"R19","St Kilda",15,11,101,"Geelong",16,6,102,"Docklands",-1,2002,"Regular",19,"Away","Geelong","St Kilda",1
12249,2002-08-11,"R19","West Coast",15,10,100,"Melbourne",15,16,106,"Subiaco",-6,2002,"Regular",19,"Away","Melbourne","West Coast",6
12250,2002-08-16,"R20","Richmond",16,11,107,"Hawthorn",13,15,93,"M.C.G.",14,2002,"Regular",20,"Home","Richmond","Hawthorn",14
12251,2002-08-17,"R20","North Melbourne",17,12,114,"Carlton",15,5,95,"Docklands",19,2002,"Regular",20,"Home","North Melbourne","Carlton",19
12252,2002-08-17,"R20","Fremantle",17,15,117,"Geelong",11,6,72,"Subiaco",45,2002,"Regular",20,"Home","Fremantle","Geelong",45
12253,2002-08-17,"R20","Essendon",19,12,126,"Collingwood",10,11,71,"M.C.G.",55,2002,"Regular",20,"Home","Essendon","Collingwood",55
12254,2002-08-17,"R20","Brisbane Lions",20,16,136,"West Coast",13,11,89,"Gabba",47,2002,"Regular",20,"Home","Brisbane Lions","West Coast",47
12255,2002-08-18,"R20","Sydney",12,15,87,"St Kilda",12,8,80,"S.C.G.",7,2002,"Regular",20,"Home","Sydney","St Kilda",7
12256,2002-08-18,"R20","Melbourne",15,17,107,"Footscray",14,11,95,"M.C.G.",12,2002,"Regular",20,"Home","Melbourne","Footscray",12
12257,2002-08-18,"R20","Port Adelaide",12,12,84,"Adelaide",11,10,76,"Football Park",8,2002,"Regular",20,"Home","Port Adelaide","Adelaide",8
12258,2002-08-23,"R21","Hawthorn",16,8,104,"North Melbourne",17,17,119,"M.C.G.",-15,2002,"Regular",21,"Away","North Melbourne","Hawthorn",15
12259,2002-08-24,"R21","Geelong",7,13,55,"Brisbane Lions",16,14,110,"Kardinia Park",-55,2002,"Regular",21,"Away","Brisbane Lions","Geelong",55
12260,2002-08-24,"R21","Melbourne",11,11,77,"Sydney",23,7,145,"M.C.G.",-68,2002,"Regular",21,"Away","Sydney","Melbourne",68
12261,2002-08-24,"R21","Footscray",14,13,97,"Carlton",15,9,99,"Docklands",-2,2002,"Regular",21,"Away","Carlton","Footscray",2
12262,2002-08-24,"R21","West Coast",10,5,65,"Port Adelaide",14,19,103,"Subiaco",-38,2002,"Regular",21,"Away","Port Adelaide","West Coast",38
12263,2002-08-25,"R21","Adelaide",13,9,87,"Richmond",9,11,65,"Football Park",22,2002,"Regular",21,"Home","Adelaide","Richmond",22
12264,2002-08-25,"R21","Collingwood",11,11,77,"St Kilda",9,12,66,"M.C.G.",11,2002,"Regular",21,"Home","Collingwood","St Kilda",11
12265,2002-08-25,"R21","Essendon",13,15,93,"Fremantle",10,12,72,"Docklands",21,2002,"Regular",21,"Home","Essendon","Fremantle",21
12266,2002-08-30,"R22","Geelong",8,9,57,"Hawthorn",11,9,75,"Docklands",-18,2002,"Regular",22,"Away","Hawthorn","Geelong",18
12267,2002-08-31,"R22","Collingwood",10,13,73,"Footscray",17,12,114,"M.C.G.",-41,2002,"Regular",22,"Away","Footscray","Collingwood",41
12268,2002-08-31,"R22","Port Adelaide",13,12,90,"Brisbane Lions",13,6,84,"Football Park",6,2002,"Regular",22,"Home","Port Adelaide","Brisbane Lions",6
12269,2002-08-31,"R22","St Kilda",18,9,117,"Melbourne",20,15,135,"Docklands",-18,2002,"Regular",22,"Away","Melbourne","St Kilda",18
12270,2002-08-31,"R22","Sydney",17,14,116,"Richmond",11,10,76,"Stadium Australia",40,2002,"Regular",22,"Home","Sydney","Richmond",40
12271,2002-09-01,"R22","North Melbourne",18,18,126,"West Coast",22,11,143,"Manuka Oval",-17,2002,"Regular",22,"Away","West Coast","North Melbourne",17
12272,2002-09-01,"R22","Carlton",5,7,37,"Essendon",12,20,92,"M.C.G.",-55,2002,"Regular",22,"Away","Essendon","Carlton",55
12273,2002-09-01,"R22","Fremantle",12,8,80,"Adelaide",17,18,120,"Subiaco",-40,2002,"Regular",22,"Away","Adelaide","Fremantle",40
12274,2002-09-06,"QF","Port Adelaide",14,11,95,"Collingwood",16,12,108,"Football Park",-13,2002,"Finals",23,"Away","Collingwood","Port Adelaide",13
12275,2002-09-07,"EF","Essendon",17,9,111,"West Coast",11,12,78,"Docklands",33,2002,"Finals",23,"Home","Essendon","West Coast",33
12276,2002-09-07,"QF","Brisbane Lions",17,13,115,"Adelaide",5,14,44,"Gabba",71,2002,"Finals",23,"Home","Brisbane Lions","Adelaide",71
12277,2002-09-08,"EF","Melbourne",18,14,122,"North Melbourne",11,18,84,"M.C.G.",38,2002,"Finals",23,"Home","Melbourne","North Melbourne",38
12278,2002-09-13,"SF","Port Adelaide",11,17,83,"Essendon",8,11,59,"Football Park",24,2002,"Finals",24,"Home","Port Adelaide","Essendon",24
12279,2002-09-14,"SF","Melbourne",17,16,118,"Adelaide",20,10,130,"M.C.G.",-12,2002,"Finals",24,"Away","Adelaide","Melbourne",12
12280,2002-09-21,"PF","Adelaide",9,9,63,"Collingwood",13,13,91,"M.C.G.",-28,2002,"Finals",25,"Away","Collingwood","Adelaide",28
12281,2002-09-21,"PF","Brisbane Lions",21,12,138,"Port Adelaide",12,10,82,"Gabba",56,2002,"Finals",25,"Home","Brisbane Lions","Port Adelaide",56
12282,2002-09-28,"GF","Brisbane Lions",10,15,75,"Collingwood",9,12,66,"M.C.G.",9,2002,"Finals",26,"Home","Brisbane Lions","Collingwood",9
12283,2003-03-28,"R1","Collingwood",13,16,94,"Richmond",8,18,66,"M.C.G.",28,2003,"Regular",1,"Home","Collingwood","Richmond",28
12284,2003-03-29,"R1","North Melbourne",14,12,96,"St Kilda",10,10,70,"M.C.G.",26,2003,"Regular",1,"Home","North Melbourne","St Kilda",26
12285,2003-03-29,"R1","West Coast",17,20,122,"Port Adelaide",11,8,74,"Subiaco",48,2003,"Regular",1,"Home","West Coast","Port Adelaide",48
12286,2003-03-29,"R1","Sydney",22,14,146,"Carlton",10,12,72,"Stadium Australia",74,2003,"Regular",1,"Home","Sydney","Carlton",74
12287,2003-03-29,"R1","Brisbane Lions",14,20,104,"Essendon",8,13,61,"Gabba",43,2003,"Regular",1,"Home","Brisbane Lions","Essendon",43
12288,2003-03-30,"R1","Adelaide",22,13,145,"Fremantle",13,11,89,"Football Park",56,2003,"Regular",1,"Home","Adelaide","Fremantle",56
12289,2003-03-30,"R1","Footscray",19,16,130,"Geelong",13,13,91,"Docklands",39,2003,"Regular",1,"Home","Footscray","Geelong",39
12290,2003-03-30,"R1","Melbourne",16,10,106,"Hawthorn",15,10,100,"M.C.G.",6,2003,"Regular",1,"Home","Melbourne","Hawthorn",6
12291,2003-04-04,"R2","Carlton",13,13,91,"Collingwood",16,11,107,"M.C.G.",-16,2003,"Regular",2,"Away","Collingwood","Carlton",16
12292,2003-04-05,"R2","St Kilda",15,9,99,"Adelaide",13,13,91,"Docklands",8,2003,"Regular",2,"Home","St Kilda","Adelaide",8
12293,2003-04-05,"R2","Essendon",17,10,112,"Melbourne",10,15,75,"M.C.G.",37,2003,"Regular",2,"Home","Essendon","Melbourne",37
12294,2003-04-05,"R2","Fremantle",12,14,86,"Sydney",8,12,60,"Subiaco",26,2003,"Regular",2,"Home","Fremantle","Sydney",26
12295,2003-04-05,"R2","Port Adelaide",10,16,76,"Brisbane Lions",13,8,86,"Football Park",-10,2003,"Regular",2,"Away","Brisbane Lions","Port Adelaide",10
12296,2003-04-06,"R2","Hawthorn",13,13,91,"West Coast",14,5,89,"York Park",2,2003,"Regular",2,"Home","Hawthorn","West Coast",2
12297,2003-04-06,"R2","Richmond",16,15,111,"Footscray",13,11,89,"Docklands",22,2003,"Regular",2,"Home","Richmond","Footscray",22
12298,2003-04-06,"R2","Geelong",9,17,71,"North Melbourne",13,16,94,"Kardinia Park",-23,2003,"Regular",2,"Away","North Melbourne","Geelong",23
12299,2003-04-11,"R3","Essendon",13,16,94,"Carlton",15,15,105,"M.C.G.",-11,2003,"Regular",3,"Away","Carlton","Essendon",11
12300,2003-04-12,"R3","Collingwood",18,8,116,"Geelong",10,9,69,"M.C.G.",47,2003,"Regular",3,"Home","Collingwood","Geelong",47
12301,2003-04-12,"R3","West Coast",21,18,144,"St Kilda",11,8,74,"Subiaco",70,2003,"Regular",3,"Home","West Coast","St Kilda",70
12302,2003-04-12,"R3","North Melbourne",16,13,109,"Brisbane Lions",16,13,109,"Docklands",0,2003,"Regular",3,"Home","North Melbourne","Brisbane Lions",0
12303,2003-04-12,"R3","Port Adelaide",19,14,128,"Hawthorn",11,5,71,"Football Park",57,2003,"Regular",3,"Home","Port Adelaide","Hawthorn",57
12304,2003-04-13,"R3","Sydney",11,10,76,"Adelaide",15,13,103,"S.C.G.",-27,2003,"Regular",3,"Away","Adelaide","Sydney",27
12305,2003-04-13,"R3","Melbourne",20,7,127,"Footscray",14,11,95,"Docklands",32,2003,"Regular",3,"Home","Melbourne","Footscray",32
12306,2003-04-13,"R3","Richmond",14,10,94,"Fremantle",6,10,46,"M.C.G.",48,2003,"Regular",3,"Home","Richmond","Fremantle",48
12307,2003-04-17,"R4","Brisbane Lions",14,11,95,"Collingwood",11,15,81,"Gabba",14,2003,"Regular",4,"Home","Brisbane Lions","Collingwood",14
12308,2003-04-19,"R4","Geelong",13,12,90,"Melbourne",6,8,44,"Kardinia Park",46,2003,"Regular",4,"Home","Geelong","Melbourne",46
12309,2003-04-19,"R4","Footscray",16,14,110,"Essendon",20,9,129,"Docklands",-19,2003,"Regular",4,"Away","Essendon","Footscray",19
12310,2003-04-19,"R4","Hawthorn",17,8,110,"Sydney",10,8,68,"M.C.G.",42,2003,"Regular",4,"Home","Hawthorn","Sydney",42
12311,2003-04-20,"R4","Adelaide",15,16,106,"West Coast",10,13,73,"Football Park",33,2003,"Regular",4,"Home","Adelaide","West Coast",33
12312,2003-04-20,"R4","Carlton",12,12,84,"Port Adelaide",17,12,114,"Princes Park",-30,2003,"Regular",4,"Away","Port Adelaide","Carlton",30
12313,2003-04-20,"R4","Fremantle",25,17,167,"North Melbourne",19,8,122,"Subiaco",45,2003,"Regular",4,"Home","Fremantle","North Melbourne",45
12314,2003-04-21,"R4","St Kilda",11,15,81,"Richmond",17,5,107,"Docklands",-26,2003,"Regular",4,"Away","Richmond","St Kilda",26
12315,2003-04-25,"R5","Essendon",23,9,147,"Collingwood",12,9,81,"M.C.G.",66,2003,"Regular",5,"Home","Essendon","Collingwood",66
12316,2003-04-25,"R5","Sydney",17,7,109,"Melbourne",13,7,85,"S.C.G.",24,2003,"Regular",5,"Home","Sydney","Melbourne",24
12317,2003-04-26,"R5","Hawthorn",14,11,95,"Richmond",18,7,115,"M.C.G.",-20,2003,"Regular",5,"Away","Richmond","Hawthorn",20
12318,2003-04-26,"R5","North Melbourne",16,17,113,"Carlton",18,14,122,"Docklands",-9,2003,"Regular",5,"Away","Carlton","North Melbourne",9
12319,2003-04-26,"R5","Adelaide",9,12,66,"Port Adelaide",12,6,78,"Football Park",-12,2003,"Regular",5,"Away","Port Adelaide","Adelaide",12
12320,2003-04-27,"R5","Brisbane Lions",15,16,106,"Footscray",12,7,79,"Gabba",27,2003,"Regular",5,"Home","Brisbane Lions","Footscray",27
12321,2003-04-27,"R5","St Kilda",18,11,119,"Geelong",11,8,74,"Docklands",45,2003,"Regular",5,"Home","St Kilda","Geelong",45
12322,2003-04-27,"R5","Fremantle",10,13,73,"West Coast",16,12,108,"Subiaco",-35,2003,"Regular",5,"Away","West Coast","Fremantle",35
12323,2003-05-02,"R6","North Melbourne",9,16,70,"Adelaide",19,10,124,"Docklands",-54,2003,"Regular",6,"Away","Adelaide","North Melbourne",54
12324,2003-05-03,"R6","Carlton",9,9,63,"Hawthorn",11,8,74,"Princes Park",-11,2003,"Regular",6,"Away","Hawthorn","Carlton",11
12325,2003-05-03,"R6","Melbourne",14,10,94,"West Coast",19,13,127,"M.C.G.",-33,2003,"Regular",6,"Away","West Coast","Melbourne",33
12326,2003-05-03,"R6","Collingwood",13,11,89,"Sydney",17,7,109,"Docklands",-20,2003,"Regular",6,"Away","Sydney","Collingwood",20
12327,2003-05-03,"R6","Port Adelaide",12,12,84,"Richmond",8,9,57,"Football Park",27,2003,"Regular",6,"Home","Port Adelaide","Richmond",27
12328,2003-05-04,"R6","Geelong",12,6,78,"Brisbane Lions",13,14,92,"Kardinia Park",-14,2003,"Regular",6,"Away","Brisbane Lions","Geelong",14
12329,2003-05-04,"R6","Footscray",12,13,85,"St Kilda",15,10,100,"Docklands",-15,2003,"Regular",6,"Away","St Kilda","Footscray",15
12330,2003-05-04,"R6","Fremantle",20,11,131,"Essendon",15,10,100,"Subiaco",31,2003,"Regular",6,"Home","Fremantle","Essendon",31
12331,2003-05-09,"R7","Hawthorn",13,11,89,"North Melbourne",18,9,117,"Docklands",-28,2003,"Regular",7,"Away","North Melbourne","Hawthorn",28
12332,2003-05-10,"R7","Richmond",11,18,84,"Essendon",5,12,42,"M.C.G.",42,2003,"Regular",7,"Home","Richmond","Essendon",42
12333,2003-05-10,"R7","West Coast",17,11,113,"Geelong",14,13,97,"Subiaco",16,2003,"Regular",7,"Home","West Coast","Geelong",16
12334,2003-05-10,"R7","St Kilda",16,17,113,"Carlton",15,11,101,"Docklands",12,2003,"Regular",7,"Home","St Kilda","Carlton",12
12335,2003-05-10,"R7","Adelaide",16,13,109,"Collingwood",18,6,114,"Football Park",-5,2003,"Regular",7,"Away","Collingwood","Adelaide",5
12336,2003-05-11,"R7","Sydney",15,8,98,"Brisbane Lions",11,13,79,"S.C.G.",19,2003,"Regular",7,"Home","Sydney","Brisbane Lions",19
12337,2003-05-11,"R7","Footscray",10,12,72,"Fremantle",23,17,155,"Docklands",-83,2003,"Regular",7,"Away","Fremantle","Footscray",83
12338,2003-05-11,"R7","Melbourne",16,15,111,"Port Adelaide",12,12,84,"M.C.G.",27,2003,"Regular",7,"Home","Melbourne","Port Adelaide",27
12339,2003-05-16,"R8","Hawthorn",8,5,53,"Essendon",15,16,106,"M.C.G.",-53,2003,"Regular",8,"Away","Essendon","Hawthorn",53
12340,2003-05-17,"R8","Collingwood",15,13,103,"West Coast",18,11,119,"Docklands",-16,2003,"Regular",8,"Away","West Coast","Collingwood",16
12341,2003-05-17,"R8","Port Adelaide",15,13,103,"North Melbourne",7,7,49,"Football Park",54,2003,"Regular",8,"Home","Port Adelaide","North Melbourne",54
12342,2003-05-17,"R8","Brisbane Lions",16,11,107,"Adelaide",12,17,89,"Gabba",18,2003,"Regular",8,"Home","Brisbane Lions","Adelaide",18
12343,2003-05-17,"R8","Richmond",17,10,112,"Melbourne",16,7,103,"M.C.G.",9,2003,"Regular",8,"Home","Richmond","Melbourne",9
12344,2003-05-18,"R8","Sydney",17,10,112,"Geelong",11,7,73,"S.C.G.",39,2003,"Regular",8,"Home","Sydney","Geelong",39
12345,2003-05-18,"R8","Carlton",15,17,107,"Footscray",14,16,100,"Princes Park",7,2003,"Regular",8,"Home","Carlton","Footscray",7
12346,2003-05-18,"R8","Fremantle",18,15,123,"St Kilda",11,16,82,"Subiaco",41,2003,"Regular",8,"Home","Fremantle","St Kilda",41
12347,2003-05-23,"R9","Essendon",14,12,96,"Port Adelaide",23,8,146,"Docklands",-50,2003,"Regular",9,"Away","Port Adelaide","Essendon",50
12348,2003-05-24,"R9","Carlton",11,10,76,"Brisbane Lions",23,15,153,"Princes Park",-77,2003,"Regular",9,"Away","Brisbane Lions","Carlton",77
12349,2003-05-24,"R9","Melbourne",10,11,71,"Fremantle",16,5,101,"M.C.G.",-30,2003,"Regular",9,"Away","Fremantle","Melbourne",30
12350,2003-05-24,"R9","Collingwood",22,17,149,"St Kilda",12,12,84,"Docklands",65,2003,"Regular",9,"Home","Collingwood","St Kilda",65
12351,2003-05-24,"R9","West Coast",18,16,124,"Richmond",11,6,72,"Subiaco",52,2003,"Regular",9,"Home","West Coast","Richmond",52
12352,2003-05-25,"R9","North Melbourne",12,12,84,"Sydney",8,11,59,"Manuka Oval",25,2003,"Regular",9,"Home","North Melbourne","Sydney",25
12353,2003-05-25,"R9","Geelong",16,13,109,"Hawthorn",11,9,75,"Docklands",34,2003,"Regular",9,"Home","Geelong","Hawthorn",34
12354,2003-05-25,"R9","Adelaide",16,13,109,"Footscray",14,9,93,"Football Park",16,2003,"Regular",9,"Home","Adelaide","Footscray",16
12355,2003-05-30,"R10","Port Adelaide",14,14,98,"Collingwood",10,13,73,"Football Park",25,2003,"Regular",10,"Home","Port Adelaide","Collingwood",25
12356,2003-05-31,"R10","Footscray",22,13,145,"North Melbourne",24,12,156,"Docklands",-11,2003,"Regular",10,"Away","North Melbourne","Footscray",11
12357,2003-05-31,"R10","Fremantle",19,13,127,"Carlton",15,9,99,"Subiaco",28,2003,"Regular",10,"Home","Fremantle","Carlton",28
12358,2003-05-31,"R10","Melbourne",9,9,63,"Brisbane Lions",18,15,123,"Gabba",-60,2003,"Regular",10,"Away","Brisbane Lions","Melbourne",60
12359,2003-05-31,"R10","Richmond",10,12,72,"Sydney",16,8,104,"M.C.G.",-32,2003,"Regular",10,"Away","Sydney","Richmond",32
12360,2003-06-01,"R10","Geelong",8,11,59,"Adelaide",11,10,76,"Kardinia Park",-17,2003,"Regular",10,"Away","Adelaide","Geelong",17
12361,2003-06-01,"R10","Essendon",19,14,128,"West Coast",16,10,106,"Docklands",22,2003,"Regular",10,"Home","Essendon","West Coast",22
12362,2003-06-01,"R10","St Kilda",17,16,118,"Hawthorn",14,6,90,"M.C.G.",28,2003,"Regular",10,"Home","St Kilda","Hawthorn",28
12363,2003-06-06,"R11","North Melbourne",13,14,92,"Richmond",13,11,89,"Docklands",3,2003,"Regular",11,"Home","North Melbourne","Richmond",3
12364,2003-06-07,"R11","Hawthorn",11,9,75,"Adelaide",10,10,70,"M.C.G.",5,2003,"Regular",11,"Home","Hawthorn","Adelaide",5
12365,2003-06-07,"R11","St Kilda",13,12,90,"Brisbane Lions",13,7,85,"Docklands",5,2003,"Regular",11,"Home","St Kilda","Brisbane Lions",5
12366,2003-06-07,"R11","Sydney",21,7,133,"Essendon",12,7,79,"Stadium Australia",54,2003,"Regular",11,"Home","Sydney","Essendon",54
12367,2003-06-08,"R11","Port Adelaide",16,16,112,"Fremantle",9,9,63,"Football Park",49,2003,"Regular",11,"Home","Port Adelaide","Fremantle",49
12368,2003-06-08,"R11","Geelong",17,13,115,"Carlton",12,3,75,"Docklands",40,2003,"Regular",11,"Home","Geelong","Carlton",40
12369,2003-06-08,"R11","West Coast",19,10,124,"Footscray",19,10,124,"Subiaco",0,2003,"Regular",11,"Home","West Coast","Footscray",0
12370,2003-06-09,"R11","Melbourne",10,17,77,"Collingwood",20,13,133,"M.C.G.",-56,2003,"Regular",11,"Away","Collingwood","Melbourne",56
12371,2003-06-13,"R12","Essendon",13,10,88,"North Melbourne",14,12,96,"Docklands",-8,2003,"Regular",12,"Away","North Melbourne","Essendon",8
12372,2003-06-14,"R12","St Kilda",7,15,57,"Port Adelaide",15,9,99,"York Park",-42,2003,"Regular",12,"Away","Port Adelaide","St Kilda",42
12373,2003-06-14,"R12","Richmond",12,14,86,"Carlton",14,9,93,"M.C.G.",-7,2003,"Regular",12,"Away","Carlton","Richmond",7
12374,2003-06-14,"R12","Footscray",9,9,63,"Sydney",19,13,127,"S.C.G.",-64,2003,"Regular",12,"Away","Sydney","Footscray",64
12375,2003-06-14,"R12","Fremantle",13,10,88,"Geelong",10,12,72,"Subiaco",16,2003,"Regular",12,"Home","Fremantle","Geelong",16
12376,2003-06-15,"R12","Brisbane Lions",13,13,91,"West Coast",24,16,160,"Gabba",-69,2003,"Regular",12,"Away","West Coast","Brisbane Lions",69
12377,2003-06-15,"R12","Collingwood",6,15,51,"Hawthorn",12,12,84,"M.C.G.",-33,2003,"Regular",12,"Away","Hawthorn","Collingwood",33
12378,2003-06-15,"R12","Adelaide",21,12,138,"Melbourne",10,5,65,"Football Park",73,2003,"Regular",12,"Home","Adelaide","Melbourne",73
12379,2003-06-27,"R13","Essendon",20,9,129,"Geelong",15,3,93,"Docklands",36,2003,"Regular",13,"Home","Essendon","Geelong",36
12380,2003-06-28,"R13","Melbourne",21,10,136,"St Kilda",14,10,94,"M.C.G.",42,2003,"Regular",13,"Home","Melbourne","St Kilda",42
12381,2003-06-28,"R13","Port Adelaide",14,15,99,"Sydney",8,12,60,"Football Park",39,2003,"Regular",13,"Home","Port Adelaide","Sydney",39
12382,2003-06-28,"R13","Footscray",12,13,85,"Collingwood",18,20,128,"Docklands",-43,2003,"Regular",13,"Away","Collingwood","Footscray",43
12383,2003-06-28,"R13","Brisbane Lions",15,14,104,"Richmond",9,7,61,"Gabba",43,2003,"Regular",13,"Home","Brisbane Lions","Richmond",43
12384,2003-06-29,"R13","Hawthorn",15,8,98,"Fremantle",10,8,68,"York Park",30,2003,"Regular",13,"Home","Hawthorn","Fremantle",30
12385,2003-06-29,"R13","Carlton",7,8,50,"Adelaide",13,14,92,"Princes Park",-42,2003,"Regular",13,"Away","Adelaide","Carlton",42
12386,2003-06-29,"R13","West Coast",11,10,76,"North Melbourne",10,7,67,"Subiaco",9,2003,"Regular",13,"Home","West Coast","North Melbourne",9
12387,2003-07-04,"R14","St Kilda",7,9,51,"Essendon",17,17,119,"Docklands",-68,2003,"Regular",14,"Away","Essendon","St Kilda",68
12388,2003-07-05,"R14","Hawthorn",23,16,154,"Footscray",12,11,83,"M.C.G.",71,2003,"Regular",14,"Home","Hawthorn","Footscray",71
12389,2003-07-05,"R14","Fremantle",10,15,75,"Brisbane Lions",10,12,72,"Subiaco",3,2003,"Regular",14,"Home","Fremantle","Brisbane Lions",3
12390,2003-07-05,"R14","North Melbourne",7,8,50,"Collingwood",19,12,126,"Docklands",-76,2003,"Regular",14,"Away","Collingwood","North Melbourne",76
12391,2003-07-05,"R14","Adelaide",10,12,72,"Richmond",6,8,44,"Football Park",28,2003,"Regular",14,"Home","Adelaide","Richmond",28
12392,2003-07-06,"R14","Sydney",13,14,92,"West Coast",12,12,84,"S.C.G.",8,2003,"Regular",14,"Home","Sydney","West Coast",8
12393,2003-07-06,"R14","Carlton",14,6,90,"Melbourne",14,13,97,"Princes Park",-7,2003,"Regular",14,"Away","Melbourne","Carlton",7
12394,2003-07-06,"R14","Geelong",10,10,70,"Port Adelaide",10,9,69,"Kardinia Park",1,2003,"Regular",14,"Home","Geelong","Port Adelaide",1
12395,2003-07-11,"R15","Adelaide",13,12,90,"Essendon",7,7,49,"Football Park",41,2003,"Regular",15,"Home","Adelaide","Essendon",41
12396,2003-07-12,"R15","Collingwood",15,9,99,"Fremantle",7,16,58,"M.C.G.",41,2003,"Regular",15,"Home","Collingwood","Fremantle",41
12397,2003-07-12,"R15","Richmond",15,7,97,"Geelong",15,11,101,"Docklands",-4,2003,"Regular",15,"Away","Geelong","Richmond",4
12398,2003-07-12,"R15","Sydney",15,22,112,"St Kilda",9,7,61,"S.C.G.",51,2003,"Regular",15,"Home","Sydney","St Kilda",51
12399,2003-07-12,"R15","West Coast",28,19,187,"Carlton",10,11,71,"Subiaco",116,2003,"Regular",15,"Home","West Coast","Carlton",116
12400,2003-07-13,"R15","Brisbane Lions",14,9,93,"Hawthorn",11,15,81,"Gabba",12,2003,"Regular",15,"Home","Brisbane Lions","Hawthorn",12
12401,2003-07-13,"R15","Footscray",14,9,93,"Port Adelaide",15,18,108,"Docklands",-15,2003,"Regular",15,"Away","Port Adelaide","Footscray",15
12402,2003-07-13,"R15","North Melbourne",15,11,101,"Melbourne",14,10,94,"M.C.G.",7,2003,"Regular",15,"Home","North Melbourne","Melbourne",7
12403,2003-07-18,"R16","Richmond",9,8,62,"Collingwood",20,11,131,"M.C.G.",-69,2003,"Regular",16,"Away","Collingwood","Richmond",69
12404,2003-07-19,"R16","Carlton",12,12,84,"Sydney",18,7,115,"Princes Park",-31,2003,"Regular",16,"Away","Sydney","Carlton",31
12405,2003-07-19,"R16","Hawthorn",17,11,113,"Melbourne",15,16,106,"M.C.G.",7,2003,"Regular",16,"Home","Hawthorn","Melbourne",7
12406,2003-07-19,"R16","Essendon",14,10,94,"Brisbane Lions",12,14,86,"Docklands",8,2003,"Regular",16,"Home","Essendon","Brisbane Lions",8
12407,2003-07-19,"R16","Port Adelaide",17,12,114,"West Coast",7,8,50,"Football Park",64,2003,"Regular",16,"Home","Port Adelaide","West Coast",64
12408,2003-07-20,"R16","Geelong",11,15,81,"Footscray",15,9,99,"Kardinia Park",-18,2003,"Regular",16,"Away","Footscray","Geelong",18
12409,2003-07-20,"R16","St Kilda",21,6,132,"North Melbourne",19,13,127,"Docklands",5,2003,"Regular",16,"Home","St Kilda","North Melbourne",5
12410,2003-07-20,"R16","Fremantle",13,13,91,"Adelaide",13,12,90,"Subiaco",1,2003,"Regular",16,"Home","Fremantle","Adelaide",1
12411,2003-07-25,"R17","West Coast",14,14,98,"Hawthorn",5,12,42,"Subiaco",56,2003,"Regular",17,"Home","West Coast","Hawthorn",56
12412,2003-07-26,"R17","North Melbourne",16,8,104,"Geelong",12,14,86,"Manuka Oval",18,2003,"Regular",17,"Home","North Melbourne","Geelong",18
12413,2003-07-26,"R17","Melbourne",10,11,71,"Essendon",13,10,88,"M.C.G.",-17,2003,"Regular",17,"Away","Essendon","Melbourne",17
12414,2003-07-26,"R17","Footscray",14,11,95,"Richmond",24,11,155,"Docklands",-60,2003,"Regular",17,"Away","Richmond","Footscray",60
12415,2003-07-26,"R17","Brisbane Lions",15,13,103,"Port Adelaide",15,14,104,"Gabba",-1,2003,"Regular",17,"Away","Port Adelaide","Brisbane Lions",1
12416,2003-07-27,"R17","Sydney",17,9,111,"Fremantle",14,13,97,"S.C.G.",14,2003,"Regular",17,"Home","Sydney","Fremantle",14
12417,2003-07-27,"R17","Collingwood",20,15,135,"Carlton",8,14,62,"M.C.G.",73,2003,"Regular",17,"Home","Collingwood","Carlton",73
12418,2003-07-27,"R17","Adelaide",22,11,143,"St Kilda",13,8,86,"Football Park",57,2003,"Regular",17,"Home","Adelaide","St Kilda",57
12419,2003-08-01,"R18","Footscray",14,17,101,"Melbourne",12,8,80,"Docklands",21,2003,"Regular",18,"Home","Footscray","Melbourne",21
12420,2003-08-02,"R18","Carlton",7,14,56,"Essendon",13,12,90,"M.C.G.",-34,2003,"Regular",18,"Away","Essendon","Carlton",34
12421,2003-08-02,"R18","Fremantle",15,14,104,"Richmond",11,15,81,"Subiaco",23,2003,"Regular",18,"Home","Fremantle","Richmond",23
12422,2003-08-02,"R18","Geelong",10,13,73,"Collingwood",14,13,97,"Docklands",-24,2003,"Regular",18,"Away","Collingwood","Geelong",24
12423,2003-08-02,"R18","Brisbane Lions",20,17,137,"North Melbourne",11,17,83,"Gabba",54,2003,"Regular",18,"Home","Brisbane Lions","North Melbourne",54
12424,2003-08-03,"R18","Adelaide",14,13,97,"Sydney",14,9,93,"Football Park",4,2003,"Regular",18,"Home","Adelaide","Sydney",4
12425,2003-08-03,"R18","Hawthorn",11,14,80,"Port Adelaide",12,12,84,"M.C.G.",-4,2003,"Regular",18,"Away","Port Adelaide","Hawthorn",4
12426,2003-08-03,"R18","St Kilda",19,14,128,"West Coast",9,13,67,"Docklands",61,2003,"Regular",18,"Home","St Kilda","West Coast",61
12427,2003-08-08,"R19","Melbourne",6,9,45,"Geelong",11,18,84,"M.C.G.",-39,2003,"Regular",19,"Away","Geelong","Melbourne",39
12428,2003-08-09,"R19","Collingwood",8,14,62,"Brisbane Lions",15,11,101,"M.C.G.",-39,2003,"Regular",19,"Away","Brisbane Lions","Collingwood",39
12429,2003-08-09,"R19","West Coast",10,7,67,"Adelaide",13,13,91,"Subiaco",-24,2003,"Regular",19,"Away","Adelaide","West Coast",24
12430,2003-08-09,"R19","Sydney",14,9,93,"Hawthorn",17,8,110,"S.C.G.",-17,2003,"Regular",19,"Away","Hawthorn","Sydney",17
12431,2003-08-09,"R19","Richmond",7,8,50,"St Kilda",20,10,130,"Docklands",-80,2003,"Regular",19,"Away","St Kilda","Richmond",80
12432,2003-08-10,"R19","Port Adelaide",18,17,125,"Carlton",12,9,81,"Football Park",44,2003,"Regular",19,"Home","Port Adelaide","Carlton",44
12433,2003-08-10,"R19","Essendon",22,15,147,"Footscray",12,8,80,"Docklands",67,2003,"Regular",19,"Home","Essendon","Footscray",67
12434,2003-08-10,"R19","North Melbourne",15,8,98,"Fremantle",15,9,99,"M.C.G.",-1,2003,"Regular",19,"Away","Fremantle","North Melbourne",1
12435,2003-08-15,"R20","Collingwood",15,18,108,"Adelaide",11,5,71,"Docklands",37,2003,"Regular",20,"Home","Collingwood","Adelaide",37
12436,2003-08-16,"R20","Carlton",11,9,75,"St Kilda",26,10,166,"Princes Park",-91,2003,"Regular",20,"Away","St Kilda","Carlton",91
12437,2003-08-16,"R20","Geelong",9,9,63,"West Coast",9,9,63,"Kardinia Park",0,2003,"Regular",20,"Home","Geelong","West Coast",0
12438,2003-08-16,"R20","North Melbourne",14,12,96,"Hawthorn",16,14,110,"Docklands",-14,2003,"Regular",20,"Away","Hawthorn","North Melbourne",14
12439,2003-08-16,"R20","Port Adelaide",17,10,112,"Melbourne",15,8,98,"Football Park",14,2003,"Regular",20,"Home","Port Adelaide","Melbourne",14
12440,2003-08-17,"R20","Brisbane Lions",10,16,76,"Sydney",14,6,90,"Gabba",-14,2003,"Regular",20,"Away","Sydney","Brisbane Lions",14
12441,2003-08-17,"R20","Essendon",13,14,92,"Richmond",7,11,53,"M.C.G.",39,2003,"Regular",20,"Home","Essendon","Richmond",39
12442,2003-08-17,"R20","Fremantle",18,25,133,"Footscray",12,5,77,"Subiaco",56,2003,"Regular",20,"Home","Fremantle","Footscray",56
12443,2003-08-22,"R21","Hawthorn",20,18,138,"Carlton",10,4,64,"M.C.G.",74,2003,"Regular",21,"Home","Hawthorn","Carlton",74
12444,2003-08-23,"R21","Essendon",20,13,133,"Fremantle",11,7,73,"Docklands",60,2003,"Regular",21,"Home","Essendon","Fremantle",60
12445,2003-08-23,"R21","Adelaide",10,4,64,"North Melbourne",9,20,74,"Football Park",-10,2003,"Regular",21,"Away","North Melbourne","Adelaide",10
12446,2003-08-23,"R21","Brisbane Lions",19,9,123,"Geelong",13,8,86,"Gabba",37,2003,"Regular",21,"Home","Brisbane Lions","Geelong",37
12447,2003-08-23,"R21","Sydney",12,9,81,"Collingwood",14,15,99,"Stadium Australia",-18,2003,"Regular",21,"Away","Collingwood","Sydney",18
12448,2003-08-24,"R21","St Kilda",13,17,95,"Footscray",3,12,30,"York Park",65,2003,"Regular",21,"Home","St Kilda","Footscray",65
12449,2003-08-24,"R21","Richmond",16,8,104,"Port Adelaide",18,16,124,"Docklands",-20,2003,"Regular",21,"Away","Port Adelaide","Richmond",20
12450,2003-08-24,"R21","West Coast",21,17,143,"Melbourne",14,7,91,"Subiaco",52,2003,"Regular",21,"Home","West Coast","Melbourne",52
12451,2003-08-29,"R22","Collingwood",12,11,83,"Essendon",9,13,67,"M.C.G.",16,2003,"Regular",22,"Home","Collingwood","Essendon",16
12452,2003-08-30,"R22","Geelong",12,12,84,"St Kilda",9,11,65,"Kardinia Park",19,2003,"Regular",22,"Home","Geelong","St Kilda",19
12453,2003-08-30,"R22","Melbourne",9,6,60,"Sydney",14,10,94,"M.C.G.",-34,2003,"Regular",22,"Away","Sydney","Melbourne",34
12454,2003-08-30,"R22","Footscray",13,8,86,"Brisbane Lions",26,14,170,"Docklands",-84,2003,"Regular",22,"Away","Brisbane Lions","Footscray",84
12455,2003-08-30,"R22","West Coast",11,16,82,"Fremantle",14,12,96,"Subiaco",-14,2003,"Regular",22,"Away","Fremantle","West Coast",14
12456,2003-08-31,"R22","Port Adelaide",14,10,94,"Adelaide",12,6,78,"Football Park",16,2003,"Regular",22,"Home","Port Adelaide","Adelaide",16
12457,2003-08-31,"R22","Carlton",9,9,63,"North Melbourne",28,19,187,"Docklands",-124,2003,"Regular",22,"Away","North Melbourne","Carlton",124
12458,2003-08-31,"R22","Richmond",11,8,74,"Hawthorn",11,12,78,"M.C.G.",-4,2003,"Regular",22,"Away","Hawthorn","Richmond",4
12459,2003-09-05,"EF","Fremantle",8,9,57,"Essendon",15,11,101,"Subiaco",-44,2003,"Finals",23,"Away","Essendon","Fremantle",44
12460,2003-09-06,"EF","Adelaide",16,17,113,"West Coast",8,9,57,"Football Park",56,2003,"Finals",23,"Home","Adelaide","West Coast",56
12461,2003-09-06,"QF","Collingwood",9,12,66,"Brisbane Lions",7,9,51,"M.C.G.",15,2003,"Finals",23,"Home","Collingwood","Brisbane Lions",15
12462,2003-09-07,"QF","Port Adelaide",13,10,88,"Sydney",15,10,100,"Football Park",-12,2003,"Finals",23,"Away","Sydney","Port Adelaide",12
12463,2003-09-12,"SF","Brisbane Lions",18,16,124,"Adelaide",12,10,82,"Gabba",42,2003,"Finals",24,"Home","Brisbane Lions","Adelaide",42
12464,2003-09-13,"SF","Port Adelaide",12,11,83,"Essendon",6,8,44,"Football Park",39,2003,"Finals",24,"Home","Port Adelaide","Essendon",39
12465,2003-09-20,"PF","Collingwood",17,10,112,"Port Adelaide",9,14,68,"M.C.G.",44,2003,"Finals",25,"Home","Collingwood","Port Adelaide",44
12466,2003-09-20,"PF","Sydney",8,8,56,"Brisbane Lions",14,16,100,"Stadium Australia",-44,2003,"Finals",25,"Away","Brisbane Lions","Sydney",44
12467,2003-09-27,"GF","Collingwood",12,12,84,"Brisbane Lions",20,14,134,"M.C.G.",-50,2003,"Finals",26,"Away","Brisbane Lions","Collingwood",50
12468,2004-03-26,"R1","Richmond",14,13,97,"Collingwood",8,9,57,"M.C.G.",40,2004,"Regular",1,"Home","Richmond","Collingwood",40
12469,2004-03-27,"R1","Hawthorn",17,17,119,"Melbourne",10,10,70,"M.C.G.",49,2004,"Regular",1,"Home","Hawthorn","Melbourne",49
12470,2004-03-27,"R1","Fremantle",15,17,107,"Carlton",8,12,60,"Subiaco",47,2004,"Regular",1,"Home","Fremantle","Carlton",47
12471,2004-03-27,"R1","St Kilda",19,8,122,"Geelong",9,7,61,"Docklands",61,2004,"Regular",1,"Home","St Kilda","Geelong",61
12472,2004-03-27,"R1","Brisbane Lions",11,14,80,"Sydney",11,12,78,"Gabba",2,2004,"Regular",1,"Home","Brisbane Lions","Sydney",2
12473,2004-03-28,"R1","Port Adelaide",23,20,158,"Essendon",8,14,62,"Football Park",96,2004,"Regular",1,"Home","Port Adelaide","Essendon",96
12474,2004-03-28,"R1","North Melbourne",23,11,149,"Adelaide",10,14,74,"M.C.G.",75,2004,"Regular",1,"Home","North Melbourne","Adelaide",75
12475,2004-03-28,"R1","Footscray",20,17,137,"West Coast",22,12,144,"Docklands",-7,2004,"Regular",1,"Away","West Coast","Footscray",7
12476,2004-04-02,"R2","Melbourne",20,15,135,"Richmond",12,4,76,"M.C.G.",59,2004,"Regular",2,"Home","Melbourne","Richmond",59
12477,2004-04-03,"R2","Collingwood",15,16,106,"Footscray",13,19,97,"M.C.G.",9,2004,"Regular",2,"Home","Collingwood","Footscray",9
12478,2004-04-03,"R2","Adelaide",11,17,83,"Brisbane Lions",15,14,104,"Football Park",-21,2004,"Regular",2,"Away","Brisbane Lions","Adelaide",21
12479,2004-04-03,"R2","Essendon",8,12,60,"St Kilda",13,16,94,"Docklands",-34,2004,"Regular",2,"Away","St Kilda","Essendon",34
12480,2004-04-03,"R2","West Coast",17,13,115,"Port Adelaide",18,10,118,"Subiaco",-3,2004,"Regular",2,"Away","Port Adelaide","West Coast",3
12481,2004-04-04,"R2","Sydney",15,12,102,"Fremantle",10,11,71,"S.C.G.",31,2004,"Regular",2,"Home","Sydney","Fremantle",31
12482,2004-04-04,"R2","Carlton",16,8,104,"Geelong",6,14,50,"Princes Park",54,2004,"Regular",2,"Home","Carlton","Geelong",54
12483,2004-04-04,"R2","Hawthorn",11,8,74,"North Melbourne",15,13,103,"M.C.G.",-29,2004,"Regular",2,"Away","North Melbourne","Hawthorn",29
12484,2004-04-08,"R3","Brisbane Lions",21,11,137,"Collingwood",12,5,77,"Gabba",60,2004,"Regular",3,"Home","Brisbane Lions","Collingwood",60
12485,2004-04-10,"R3","North Melbourne",17,9,111,"Carlton",16,10,106,"M.C.G.",5,2004,"Regular",3,"Home","North Melbourne","Carlton",5
12486,2004-04-10,"R3","Essendon",22,5,137,"West Coast",20,11,131,"Docklands",6,2004,"Regular",3,"Home","Essendon","West Coast",6
12487,2004-04-10,"R3","Sydney",10,13,73,"Geelong",10,7,67,"S.C.G.",6,2004,"Regular",3,"Home","Sydney","Geelong",6
12488,2004-04-11,"R3","Port Adelaide",26,15,171,"Hawthorn",13,12,90,"Football Park",81,2004,"Regular",3,"Home","Port Adelaide","Hawthorn",81
12489,2004-04-11,"R3","Footscray",12,15,87,"Melbourne",12,25,97,"M.C.G.",-10,2004,"Regular",3,"Away","Melbourne","Footscray",10
12490,2004-04-11,"R3","Fremantle",10,13,73,"Adelaide",8,16,64,"Subiaco",9,2004,"Regular",3,"Home","Fremantle","Adelaide",9
12491,2004-04-12,"R3","St Kilda",16,18,114,"Richmond",10,9,69,"Docklands",45,2004,"Regular",3,"Home","St Kilda","Richmond",45
12492,2004-04-16,"R4","Carlton",12,8,80,"Essendon",17,15,117,"M.C.G.",-37,2004,"Regular",4,"Away","Essendon","Carlton",37
12493,2004-04-17,"R4","Melbourne",18,16,124,"Port Adelaide",10,11,71,"M.C.G.",53,2004,"Regular",4,"Home","Melbourne","Port Adelaide",53
12494,2004-04-17,"R4","West Coast",12,7,79,"Brisbane Lions",10,16,76,"Subiaco",3,2004,"Regular",4,"Home","West Coast","Brisbane Lions",3
12495,2004-04-17,"R4","Geelong",19,13,127,"Richmond",11,12,78,"Docklands",49,2004,"Regular",4,"Home","Geelong","Richmond",49
12496,2004-04-17,"R4","Adelaide",15,8,98,"St Kilda",18,5,113,"Football Park",-15,2004,"Regular",4,"Away","St Kilda","Adelaide",15
12497,2004-04-18,"R4","North Melbourne",10,10,70,"Sydney",18,13,121,"Manuka Oval",-51,2004,"Regular",4,"Away","Sydney","North Melbourne",51
12498,2004-04-18,"R4","Collingwood",7,12,54,"Fremantle",12,16,88,"Docklands",-34,2004,"Regular",4,"Away","Fremantle","Collingwood",34
12499,2004-04-18,"R4","Hawthorn",14,13,97,"Footscray",16,13,109,"M.C.G.",-12,2004,"Regular",4,"Away","Footscray","Hawthorn",12
12500,2004-04-23,"R5","Richmond",9,5,59,"Adelaide",21,8,134,"Docklands",-75,2004,"Regular",5,"Away","Adelaide","Richmond",75
12501,2004-04-24,"R5","Carlton",14,8,92,"West Coast",6,7,43,"Princes Park",49,2004,"Regular",5,"Home","Carlton","West Coast",49
12502,2004-04-24,"R5","St Kilda",20,10,130,"North Melbourne",8,17,65,"Docklands",65,2004,"Regular",5,"Home","St Kilda","North Melbourne",65
12503,2004-04-24,"R5","Brisbane Lions",14,26,110,"Hawthorn",9,8,62,"Gabba",48,2004,"Regular",5,"Home","Brisbane Lions","Hawthorn",48
12504,2004-04-24,"R5","Sydney",15,9,99,"Melbourne",17,9,111,"Stadium Australia",-12,2004,"Regular",5,"Away","Melbourne","Sydney",12
12505,2004-04-25,"R5","Collingwood",11,13,79,"Essendon",17,10,112,"M.C.G.",-33,2004,"Regular",5,"Away","Essendon","Collingwood",33
12506,2004-04-25,"R5","Port Adelaide",17,17,119,"Footscray",7,22,64,"Football Park",55,2004,"Regular",5,"Home","Port Adelaide","Footscray",55
12507,2004-04-25,"R5","Fremantle",18,9,117,"Geelong",14,7,91,"Subiaco",26,2004,"Regular",5,"Home","Fremantle","Geelong",26
12508,2004-04-30,"R6","Richmond",12,12,84,"Hawthorn",13,5,83,"Docklands",1,2004,"Regular",6,"Home","Richmond","Hawthorn",1
12509,2004-05-01,"R6","Essendon",16,12,108,"Sydney",15,8,98,"M.C.G.",10,2004,"Regular",6,"Home","Essendon","Sydney",10
12510,2004-05-01,"R6","North Melbourne",18,11,119,"Footscray",19,6,120,"Manuka Oval",-1,2004,"Regular",6,"Away","Footscray","North Melbourne",1
12511,2004-05-01,"R6","St Kilda",13,14,92,"Brisbane Lions",14,7,91,"Docklands",1,2004,"Regular",6,"Home","St Kilda","Brisbane Lions",1
12512,2004-05-01,"R6","West Coast",11,7,73,"Fremantle",12,11,83,"Subiaco",-10,2004,"Regular",6,"Away","Fremantle","West Coast",10
12513,2004-05-02,"R6","Geelong",15,11,101,"Adelaide",8,10,58,"Kardinia Park",43,2004,"Regular",6,"Home","Geelong","Adelaide",43
12514,2004-05-02,"R6","Melbourne",25,10,160,"Carlton",8,7,55,"M.C.G.",105,2004,"Regular",6,"Home","Melbourne","Carlton",105
12515,2004-05-02,"R6","Port Adelaide",14,17,101,"Collingwood",12,12,84,"Football Park",17,2004,"Regular",6,"Home","Port Adelaide","Collingwood",17
12516,2004-05-07,"R7","Footscray",14,11,95,"Essendon",18,13,121,"Docklands",-26,2004,"Regular",7,"Away","Essendon","Footscray",26
12517,2004-05-08,"R7","Carlton",13,11,89,"Collingwood",11,14,80,"M.C.G.",9,2004,"Regular",7,"Home","Carlton","Collingwood",9
12518,2004-05-08,"R7","Fremantle",11,6,72,"St Kilda",14,11,95,"Subiaco",-23,2004,"Regular",7,"Away","St Kilda","Fremantle",23
12519,2004-05-08,"R7","North Melbourne",11,10,76,"Brisbane Lions",18,12,120,"Docklands",-44,2004,"Regular",7,"Away","Brisbane Lions","North Melbourne",44
12520,2004-05-08,"R7","Port Adelaide",13,9,87,"Adelaide",17,17,119,"Football Park",-32,2004,"Regular",7,"Away","Adelaide","Port Adelaide",32
12521,2004-05-09,"R7","Sydney",8,6,54,"Richmond",10,7,67,"S.C.G.",-13,2004,"Regular",7,"Away","Richmond","Sydney",13
12522,2004-05-09,"R7","Melbourne",18,14,122,"West Coast",11,7,73,"M.C.G.",49,2004,"Regular",7,"Home","Melbourne","West Coast",49
12523,2004-05-09,"R7","Hawthorn",8,4,52,"Geelong",15,18,108,"Docklands",-56,2004,"Regular",7,"Away","Geelong","Hawthorn",56
12524,2004-05-14,"R8","Adelaide",12,12,84,"Essendon",20,15,135,"Football Park",-51,2004,"Regular",8,"Away","Essendon","Adelaide",51
12525,2004-05-15,"R8","Richmond",15,15,105,"Footscray",10,22,82,"M.C.G.",23,2004,"Regular",8,"Home","Richmond","Footscray",23
12526,2004-05-15,"R8","West Coast",18,16,124,"Sydney",15,7,97,"Subiaco",27,2004,"Regular",8,"Home","West Coast","Sydney",27
12527,2004-05-15,"R8","Brisbane Lions",21,14,140,"Carlton",16,6,102,"Gabba",38,2004,"Regular",8,"Home","Brisbane Lions","Carlton",38
12528,2004-05-15,"R8","St Kilda",21,12,138,"Collingwood",13,13,91,"Docklands",47,2004,"Regular",8,"Home","St Kilda","Collingwood",47
12529,2004-05-16,"R8","Hawthorn",10,10,70,"Fremantle",8,13,61,"York Park",9,2004,"Regular",8,"Home","Hawthorn","Fremantle",9
12530,2004-05-16,"R8","Geelong",15,11,101,"Melbourne",12,15,87,"Kardinia Park",14,2004,"Regular",8,"Home","Geelong","Melbourne",14
12531,2004-05-16,"R8","North Melbourne",21,14,140,"Port Adelaide",7,6,48,"Docklands",92,2004,"Regular",8,"Home","North Melbourne","Port Adelaide",92
12532,2004-05-21,"R9","Collingwood",9,14,68,"Adelaide",9,11,65,"Docklands",3,2004,"Regular",9,"Home","Collingwood","Adelaide",3
12533,2004-05-22,"R9","Melbourne",13,18,96,"North Melbourne",11,12,78,"M.C.G.",18,2004,"Regular",9,"Home","Melbourne","North Melbourne",18
12534,2004-05-22,"R9","Fremantle",20,17,137,"Brisbane Lions",11,12,78,"Subiaco",59,2004,"Regular",9,"Home","Fremantle","Brisbane Lions",59
12535,2004-05-22,"R9","Geelong",18,12,120,"Essendon",14,13,97,"Docklands",23,2004,"Regular",9,"Home","Geelong","Essendon",23
12536,2004-05-22,"R9","Port Adelaide",19,14,128,"Richmond",7,8,50,"Football Park",78,2004,"Regular",9,"Home","Port Adelaide","Richmond",78
12537,2004-05-23,"R9","Sydney",11,14,80,"Hawthorn",12,7,79,"S.C.G.",1,2004,"Regular",9,"Home","Sydney","Hawthorn",1
12538,2004-05-23,"R9","Carlton",12,7,79,"Footscray",16,8,104,"Princes Park",-25,2004,"Regular",9,"Away","Footscray","Carlton",25
12539,2004-05-23,"R9","St Kilda",26,13,169,"West Coast",9,14,68,"Docklands",101,2004,"Regular",9,"Home","St Kilda","West Coast",101
12540,2004-05-28,"R10","Essendon",17,13,115,"Fremantle",12,13,85,"Docklands",30,2004,"Regular",10,"Home","Essendon","Fremantle",30
12541,2004-05-29,"R10","Hawthorn",6,11,47,"Adelaide",20,13,133,"M.C.G.",-86,2004,"Regular",10,"Away","Adelaide","Hawthorn",86
12542,2004-05-29,"R10","West Coast",14,16,100,"Richmond",9,9,63,"Subiaco",37,2004,"Regular",10,"Home","West Coast","Richmond",37
12543,2004-05-29,"R10","North Melbourne",9,11,65,"Collingwood",13,14,92,"Docklands",-27,2004,"Regular",10,"Away","Collingwood","North Melbourne",27
12544,2004-05-29,"R10","Footscray",10,7,67,"Sydney",12,21,93,"S.C.G.",-26,2004,"Regular",10,"Away","Sydney","Footscray",26
12545,2004-05-30,"R10","Melbourne",12,11,83,"Brisbane Lions",18,15,123,"Gabba",-40,2004,"Regular",10,"Away","Brisbane Lions","Melbourne",40
12546,2004-05-30,"R10","Carlton",13,10,88,"St Kilda",31,10,196,"Docklands",-108,2004,"Regular",10,"Away","St Kilda","Carlton",108
12547,2004-05-30,"R10","Port Adelaide",18,8,116,"Geelong",17,10,112,"Football Park",4,2004,"Regular",10,"Home","Port Adelaide","Geelong",4
12548,2004-06-04,"R11","Collingwood",14,9,93,"West Coast",11,9,75,"Docklands",18,2004,"Regular",11,"Home","Collingwood","West Coast",18
12549,2004-06-05,"R11","Hawthorn",12,8,80,"Essendon",24,10,154,"M.C.G.",-74,2004,"Regular",11,"Away","Essendon","Hawthorn",74
12550,2004-06-05,"R11","Adelaide",12,15,87,"Carlton",14,7,91,"Football Park",-4,2004,"Regular",11,"Away","Carlton","Adelaide",4
12551,2004-06-05,"R11","North Melbourne",24,10,154,"Richmond",12,8,80,"Docklands",74,2004,"Regular",11,"Home","North Melbourne","Richmond",74
12552,2004-06-05,"R11","Brisbane Lions",18,15,123,"Port Adelaide",12,14,86,"Gabba",37,2004,"Regular",11,"Home","Brisbane Lions","Port Adelaide",37
12553,2004-06-06,"R11","Sydney",17,10,112,"St Kilda",11,10,76,"S.C.G.",36,2004,"Regular",11,"Home","Sydney","St Kilda",36
12554,2004-06-06,"R11","Footscray",10,7,67,"Geelong",17,11,113,"Docklands",-46,2004,"Regular",11,"Away","Geelong","Footscray",46
12555,2004-06-06,"R11","Fremantle",9,8,62,"Melbourne",13,15,93,"Subiaco",-31,2004,"Regular",11,"Away","Melbourne","Fremantle",31
12556,2004-06-11,"R12","Carlton",15,10,100,"Hawthorn",14,4,88,"Docklands",12,2004,"Regular",12,"Home","Carlton","Hawthorn",12
12557,2004-06-12,"R12","Footscray",15,13,103,"St Kilda",11,14,80,"M.C.G.",23,2004,"Regular",12,"Home","Footscray","St Kilda",23
12558,2004-06-12,"R12","Essendon",14,12,96,"Brisbane Lions",25,12,162,"Docklands",-66,2004,"Regular",12,"Away","Brisbane Lions","Essendon",66
12559,2004-06-12,"R12","West Coast",15,18,108,"Adelaide",11,10,76,"Subiaco",32,2004,"Regular",12,"Home","West Coast","Adelaide",32
12560,2004-06-13,"R12","Port Adelaide",20,12,132,"Sydney",8,12,60,"Football Park",72,2004,"Regular",12,"Home","Port Adelaide","Sydney",72
12561,2004-06-13,"R12","Richmond",10,11,71,"Fremantle",12,9,81,"M.C.G.",-10,2004,"Regular",12,"Away","Fremantle","Richmond",10
12562,2004-06-13,"R12","Geelong",14,10,94,"North Melbourne",12,12,84,"Kardinia Park",10,2004,"Regular",12,"Home","Geelong","North Melbourne",10
12563,2004-06-14,"R12","Melbourne",12,10,82,"Collingwood",11,7,73,"M.C.G.",9,2004,"Regular",12,"Home","Melbourne","Collingwood",9
12564,2004-06-18,"R13","St Kilda",19,13,127,"Hawthorn",9,7,61,"Docklands",66,2004,"Regular",13,"Home","St Kilda","Hawthorn",66
12565,2004-06-19,"R13","Geelong",13,14,92,"Brisbane Lions",9,11,65,"Kardinia Park",27,2004,"Regular",13,"Home","Geelong","Brisbane Lions",27
12566,2004-06-19,"R13","Richmond",14,9,93,"Carlton",18,16,124,"Docklands",-31,2004,"Regular",13,"Away","Carlton","Richmond",31
12567,2004-06-19,"R13","Fremantle",16,6,102,"Port Adelaide",17,10,112,"Subiaco",-10,2004,"Regular",13,"Away","Port Adelaide","Fremantle",10
12568,2004-06-20,"R13","North Melbourne",16,12,108,"West Coast",11,9,75,"Manuka Oval",33,2004,"Regular",13,"Home","North Melbourne","West Coast",33
12569,2004-06-20,"R13","Essendon",10,9,69,"Melbourne",13,17,95,"M.C.G.",-26,2004,"Regular",13,"Away","Melbourne","Essendon",26
12570,2004-06-20,"R13","Adelaide",20,13,133,"Footscray",15,11,101,"Football Park",32,2004,"Regular",13,"Home","Adelaide","Footscray",32
12571,2004-06-26,"R13","Sydney",13,7,85,"Collingwood",11,13,79,"Stadium Australia",6,2004,"Regular",13,"Home","Sydney","Collingwood",6
12572,2004-07-02,"R14","Essendon",12,7,79,"North Melbourne",14,16,100,"Docklands",-21,2004,"Regular",14,"Away","North Melbourne","Essendon",21
12573,2004-07-03,"R14","Carlton",12,12,84,"Sydney",15,5,95,"Princes Park",-11,2004,"Regular",14,"Away","Sydney","Carlton",11
12574,2004-07-03,"R14","Collingwood",20,20,140,"Hawthorn",11,9,75,"M.C.G.",65,2004,"Regular",14,"Home","Collingwood","Hawthorn",65
12575,2004-07-03,"R14","Brisbane Lions",17,12,114,"Richmond",14,12,96,"Gabba",18,2004,"Regular",14,"Home","Brisbane Lions","Richmond",18
12576,2004-07-03,"R14","West Coast",7,9,51,"Geelong",7,7,49,"Subiaco",2,2004,"Regular",14,"Home","West Coast","Geelong",2
12577,2004-07-04,"R14","St Kilda",7,5,47,"Port Adelaide",14,9,93,"York Park",-46,2004,"Regular",14,"Away","Port Adelaide","St Kilda",46
12578,2004-07-04,"R14","Footscray",10,16,76,"Fremantle",18,9,117,"Docklands",-41,2004,"Regular",14,"Away","Fremantle","Footscray",41
12579,2004-07-04,"R14","Adelaide",22,13,145,"Melbourne",10,13,73,"Football Park",72,2004,"Regular",14,"Home","Adelaide","Melbourne",72
12580,2004-07-09,"R15","Collingwood",9,11,65,"Geelong",12,22,94,"Docklands",-29,2004,"Regular",15,"Away","Geelong","Collingwood",29
12581,2004-07-10,"R15","Hawthorn",12,10,82,"West Coast",12,14,86,"York Park",-4,2004,"Regular",15,"Away","West Coast","Hawthorn",4
12582,2004-07-10,"R15","Richmond",11,11,77,"Essendon",24,11,155,"M.C.G.",-78,2004,"Regular",15,"Away","Essendon","Richmond",78
12583,2004-07-10,"R15","Sydney",8,10,58,"Adelaide",6,9,45,"S.C.G.",13,2004,"Regular",15,"Home","Sydney","Adelaide",13
12584,2004-07-10,"R15","Fremantle",12,7,79,"North Melbourne",14,12,96,"Subiaco",-17,2004,"Regular",15,"Away","North Melbourne","Fremantle",17
12585,2004-07-11,"R15","Brisbane Lions",20,16,136,"Footscray",10,8,68,"Gabba",68,2004,"Regular",15,"Home","Brisbane Lions","Footscray",68
12586,2004-07-11,"R15","Melbourne",23,8,146,"St Kilda",13,11,89,"M.C.G.",57,2004,"Regular",15,"Home","Melbourne","St Kilda",57
12587,2004-07-11,"R15","Port Adelaide",18,15,123,"Carlton",5,10,40,"Football Park",83,2004,"Regular",15,"Home","Port Adelaide","Carlton",83
12588,2004-07-16,"R16","West Coast",18,9,117,"Essendon",10,13,73,"Subiaco",44,2004,"Regular",16,"Home","West Coast","Essendon",44
12589,2004-07-17,"R16","Carlton",9,16,70,"North Melbourne",9,8,62,"Princes Park",8,2004,"Regular",16,"Home","Carlton","North Melbourne",8
12590,2004-07-17,"R16","Richmond",9,7,61,"St Kilda",16,9,105,"Docklands",-44,2004,"Regular",16,"Away","St Kilda","Richmond",44
12591,2004-07-17,"R16","Collingwood",11,7,73,"Brisbane Lions",16,13,109,"M.C.G.",-36,2004,"Regular",16,"Away","Brisbane Lions","Collingwood",36
12592,2004-07-17,"R16","Adelaide",12,8,80,"Fremantle",14,8,92,"Football Park",-12,2004,"Regular",16,"Away","Fremantle","Adelaide",12
12593,2004-07-18,"R16","Geelong",11,11,77,"Sydney",9,8,62,"Kardinia Park",15,2004,"Regular",16,"Home","Geelong","Sydney",15
12594,2004-07-18,"R16","Melbourne",12,21,93,"Footscray",7,13,55,"Docklands",38,2004,"Regular",16,"Home","Melbourne","Footscray",38
12595,2004-07-18,"R16","Hawthorn",7,11,53,"Port Adelaide",15,15,105,"M.C.G.",-52,2004,"Regular",16,"Away","Port Adelaide","Hawthorn",52
12596,2004-07-23,"R17","St Kilda",20,7,127,"Essendon",14,8,92,"Docklands",35,2004,"Regular",17,"Home","St Kilda","Essendon",35
12597,2004-07-24,"R17","North Melbourne",22,11,143,"Hawthorn",9,9,63,"M.C.G.",80,2004,"Regular",17,"Home","North Melbourne","Hawthorn",80
12598,2004-07-24,"R17","Fremantle",18,10,118,"Sydney",14,7,91,"Subiaco",27,2004,"Regular",17,"Home","Fremantle","Sydney",27
12599,2004-07-24,"R17","Brisbane Lions",29,15,189,"Adelaide",6,12,48,"Gabba",141,2004,"Regular",17,"Home","Brisbane Lions","Adelaide",141
12600,2004-07-24,"R17","Footscray",8,18,66,"Collingwood",17,13,115,"Docklands",-49,2004,"Regular",17,"Away","Collingwood","Footscray",49
12601,2004-07-25,"R17","Port Adelaide",16,6,102,"West Coast",9,22,76,"Football Park",26,2004,"Regular",17,"Home","Port Adelaide","West Coast",26
12602,2004-07-25,"R17","Geelong",18,23,131,"Carlton",11,8,74,"Docklands",57,2004,"Regular",17,"Home","Geelong","Carlton",57
12603,2004-07-25,"R17","Richmond",10,10,70,"Melbourne",19,12,126,"M.C.G.",-56,2004,"Regular",17,"Away","Melbourne","Richmond",56
12604,2004-07-30,"R18","Adelaide",5,19,49,"North Melbourne",5,12,42,"Football Park",7,2004,"Regular",18,"Home","Adelaide","North Melbourne",7
12605,2004-07-31,"R18","Carlton",9,9,63,"Fremantle",16,15,111,"Princes Park",-48,2004,"Regular",18,"Away","Fremantle","Carlton",48
12606,2004-07-31,"R18","Collingwood",15,13,103,"Richmond",14,14,98,"M.C.G.",5,2004,"Regular",18,"Home","Collingwood","Richmond",5
12607,2004-07-31,"R18","Essendon",18,11,119,"Port Adelaide",11,13,79,"Docklands",40,2004,"Regular",18,"Home","Essendon","Port Adelaide",40
12608,2004-07-31,"R18","Sydney",12,11,83,"Brisbane Lions",7,9,51,"S.C.G.",32,2004,"Regular",18,"Home","Sydney","Brisbane Lions",32
12609,2004-08-01,"R18","Geelong",15,11,101,"St Kilda",15,4,94,"Kardinia Park",7,2004,"Regular",18,"Home","Geelong","St Kilda",7
12610,2004-08-01,"R18","Melbourne",15,17,107,"Hawthorn",9,9,63,"M.C.G.",44,2004,"Regular",18,"Home","Melbourne","Hawthorn",44
12611,2004-08-01,"R18","West Coast",15,16,106,"Footscray",8,9,57,"Subiaco",49,2004,"Regular",18,"Home","West Coast","Footscray",49
12612,2004-08-06,"R19","Fremantle",11,7,73,"Collingwood",14,22,106,"Subiaco",-33,2004,"Regular",19,"Away","Collingwood","Fremantle",33
12613,2004-08-07,"R19","St Kilda",14,7,91,"Adelaide",10,8,68,"York Park",23,2004,"Regular",19,"Home","St Kilda","Adelaide",23
12614,2004-08-07,"R19","Essendon",8,9,57,"Carlton",10,14,74,"M.C.G.",-17,2004,"Regular",19,"Away","Carlton","Essendon",17
12615,2004-08-07,"R19","Footscray",16,13,109,"Hawthorn",19,6,120,"Docklands",-11,2004,"Regular",19,"Away","Hawthorn","Footscray",11
12616,2004-08-07,"R19","Sydney",18,4,112,"North Melbourne",17,16,118,"S.C.G.",-6,2004,"Regular",19,"Away","North Melbourne","Sydney",6
12617,2004-08-08,"R19","Brisbane Lions",10,13,73,"West Coast",12,15,87,"Gabba",-14,2004,"Regular",19,"Away","West Coast","Brisbane Lions",14
12618,2004-08-08,"R19","Richmond",11,17,83,"Geelong",16,18,114,"M.C.G.",-31,2004,"Regular",19,"Away","Geelong","Richmond",31
12619,2004-08-08,"R19","Port Adelaide",18,17,125,"Melbourne",6,16,52,"Football Park",73,2004,"Regular",19,"Home","Port Adelaide","Melbourne",73
12620,2004-08-13,"R20","Essendon",18,13,121,"Collingwood",13,9,87,"M.C.G.",34,2004,"Regular",20,"Home","Essendon","Collingwood",34
12621,2004-08-14,"R20","Geelong",9,21,75,"Fremantle",3,7,25,"Kardinia Park",50,2004,"Regular",20,"Home","Geelong","Fremantle",50
12622,2004-08-14,"R20","Hawthorn",6,7,43,"Brisbane Lions",8,18,66,"M.C.G.",-23,2004,"Regular",20,"Away","Brisbane Lions","Hawthorn",23
12623,2004-08-14,"R20","Melbourne",7,4,46,"Sydney",10,7,67,"Docklands",-21,2004,"Regular",20,"Away","Sydney","Melbourne",21
12624,2004-08-14,"R20","Footscray",9,7,61,"Port Adelaide",23,9,147,"Marrara Oval",-86,2004,"Regular",20,"Away","Port Adelaide","Footscray",86
12625,2004-08-15,"R20","Adelaide",21,12,138,"Richmond",13,8,86,"Football Park",52,2004,"Regular",20,"Home","Adelaide","Richmond",52
12626,2004-08-15,"R20","North Melbourne",15,6,96,"St Kilda",23,9,147,"Docklands",-51,2004,"Regular",20,"Away","St Kilda","North Melbourne",51
12627,2004-08-15,"R20","West Coast",15,21,111,"Carlton",6,13,49,"Subiaco",62,2004,"Regular",20,"Home","West Coast","Carlton",62
12628,2004-08-20,"R21","Collingwood",9,16,70,"Port Adelaide",16,11,107,"M.C.G.",-37,2004,"Regular",21,"Away","Port Adelaide","Collingwood",37
12629,2004-08-21,"R21","Carlton",14,9,93,"Melbourne",8,14,62,"Princes Park",31,2004,"Regular",21,"Home","Carlton","Melbourne",31
12630,2004-08-21,"R21","Adelaide",15,19,109,"Geelong",12,15,87,"Football Park",22,2004,"Regular",21,"Home","Adelaide","Geelong",22
12631,2004-08-21,"R21","Footscray",21,10,136,"North Melbourne",15,16,106,"Docklands",30,2004,"Regular",21,"Home","Footscray","North Melbourne",30
12632,2004-08-21,"R21","Sydney",17,8,110,"Essendon",12,18,90,"Stadium Australia",20,2004,"Regular",21,"Home","Sydney","Essendon",20
12633,2004-08-22,"R21","Brisbane Lions",20,10,130,"St Kilda",13,7,85,"Gabba",45,2004,"Regular",21,"Home","Brisbane Lions","St Kilda",45
12634,2004-08-22,"R21","Hawthorn",16,13,109,"Richmond",13,8,86,"M.C.G.",23,2004,"Regular",21,"Home","Hawthorn","Richmond",23
12635,2004-08-22,"R21","Fremantle",6,9,45,"West Coast",13,15,93,"Subiaco",-48,2004,"Regular",21,"Away","West Coast","Fremantle",48
12636,2004-08-27,"R22","Collingwood",16,11,107,"Carlton",17,6,108,"M.C.G.",-1,2004,"Regular",22,"Away","Carlton","Collingwood",1
12637,2004-08-28,"R22","Richmond",6,8,44,"Sydney",16,12,108,"M.C.G.",-64,2004,"Regular",22,"Away","Sydney","Richmond",64
12638,2004-08-28,"R22","West Coast",15,17,107,"Melbourne",10,7,67,"Subiaco",40,2004,"Regular",22,"Home","West Coast","Melbourne",40
12639,2004-08-28,"R22","St Kilda",17,10,112,"Fremantle",12,11,83,"Docklands",29,2004,"Regular",22,"Home","St Kilda","Fremantle",29
12640,2004-08-28,"R22","Brisbane Lions",26,14,170,"North Melbourne",9,3,57,"Gabba",113,2004,"Regular",22,"Home","Brisbane Lions","North Melbourne",113
12641,2004-08-29,"R22","Adelaide",9,6,60,"Port Adelaide",12,13,85,"Football Park",-25,2004,"Regular",22,"Away","Port Adelaide","Adelaide",25
12642,2004-08-29,"R22","Essendon",17,11,113,"Footscray",14,12,96,"Docklands",17,2004,"Regular",22,"Home","Essendon","Footscray",17
12643,2004-08-29,"R22","Geelong",17,21,123,"Hawthorn",9,4,58,"Kardinia Park",65,2004,"Regular",22,"Home","Geelong","Hawthorn",65
12644,2004-09-03,"QF","Brisbane Lions",23,11,149,"St Kilda",10,9,69,"Gabba",80,2004,"Finals",23,"Home","Brisbane Lions","St Kilda",80
12645,2004-09-04,"EF","Melbourne",15,9,99,"Essendon",15,14,104,"M.C.G.",-5,2004,"Finals",23,"Away","Essendon","Melbourne",5
12646,2004-09-04,"EF","Sydney",11,9,75,"West Coast",4,10,34,"Stadium Australia",41,2004,"Finals",23,"Home","Sydney","West Coast",41
12647,2004-09-05,"QF","Port Adelaide",18,9,117,"Geelong",9,8,62,"Football Park",55,2004,"Finals",23,"Home","Port Adelaide","Geelong",55
12648,2004-09-10,"SF","St Kilda",16,11,107,"Sydney",8,8,56,"M.C.G.",51,2004,"Finals",24,"Home","St Kilda","Sydney",51
12649,2004-09-11,"SF","Geelong",10,14,74,"Essendon",9,10,64,"M.C.G.",10,2004,"Finals",24,"Home","Geelong","Essendon",10
12650,2004-09-17,"PF","Port Adelaide",14,10,94,"St Kilda",13,10,88,"Football Park",6,2004,"Finals",25,"Home","Port Adelaide","St Kilda",6
12651,2004-09-18,"PF","Brisbane Lions",12,12,84,"Geelong",10,15,75,"M.C.G.",9,2004,"Finals",25,"Home","Brisbane Lions","Geelong",9
12652,2004-09-25,"GF","Port Adelaide",17,11,113,"Brisbane Lions",10,13,73,"M.C.G.",40,2004,"Finals",26,"Home","Port Adelaide","Brisbane Lions",40
12653,2005-03-24,"R1","Brisbane Lions",18,8,116,"St Kilda",13,15,93,"Gabba",23,2005,"Regular",1,"Home","Brisbane Lions","St Kilda",23
12654,2005-03-26,"R1","North Melbourne",16,9,105,"Carlton",12,13,85,"Docklands",20,2005,"Regular",1,"Home","North Melbourne","Carlton",20
12655,2005-03-26,"R1","Melbourne",15,13,103,"Essendon",8,9,57,"M.C.G.",46,2005,"Regular",1,"Home","Melbourne","Essendon",46
12656,2005-03-26,"R1","Fremantle",13,10,88,"Port Adelaide",7,11,53,"Subiaco",35,2005,"Regular",1,"Home","Fremantle","Port Adelaide",35
12657,2005-03-27,"R1","Sydney",18,10,118,"Hawthorn",8,7,55,"S.C.G.",63,2005,"Regular",1,"Home","Sydney","Hawthorn",63
12658,2005-03-27,"R1","Richmond",15,8,98,"Geelong",25,10,160,"M.C.G.",-62,2005,"Regular",1,"Away","Geelong","Richmond",62
12659,2005-03-27,"R1","Adelaide",7,11,53,"West Coast",9,10,64,"Football Park",-11,2005,"Regular",1,"Away","West Coast","Adelaide",11
12660,2005-03-28,"R1","Collingwood",11,14,80,"Footscray",16,16,112,"M.C.G.",-32,2005,"Regular",1,"Away","Footscray","Collingwood",32
12661,2005-04-01,"R2","Carlton",16,14,110,"Essendon",17,4,106,"M.C.G.",4,2005,"Regular",2,"Home","Carlton","Essendon",4
12662,2005-04-02,"R2","Footscray",15,21,111,"Melbourne",20,17,137,"Docklands",-26,2005,"Regular",2,"Away","Melbourne","Footscray",26
12663,2005-04-02,"R2","North Melbourne",12,10,82,"Sydney",7,17,59,"Manuka Oval",23,2005,"Regular",2,"Home","North Melbourne","Sydney",23
12664,2005-04-02,"R2","West Coast",12,12,84,"Geelong",8,14,62,"Subiaco",22,2005,"Regular",2,"Home","West Coast","Geelong",22
12665,2005-04-02,"R2","Port Adelaide",11,9,75,"Brisbane Lions",11,7,73,"Football Park",2,2005,"Regular",2,"Home","Port Adelaide","Brisbane Lions",2
12666,2005-04-03,"R2","St Kilda",8,11,59,"Fremantle",8,10,58,"York Park",1,2005,"Regular",2,"Home","St Kilda","Fremantle",1
12667,2005-04-03,"R2","Collingwood",10,15,75,"Adelaide",12,9,81,"Docklands",-6,2005,"Regular",2,"Away","Adelaide","Collingwood",6
12668,2005-04-03,"R2","Hawthorn",12,17,89,"Richmond",16,7,103,"M.C.G.",-14,2005,"Regular",2,"Away","Richmond","Hawthorn",14
12669,2005-04-08,"R3","Melbourne",18,6,114,"Geelong",8,18,66,"M.C.G.",48,2005,"Regular",3,"Home","Melbourne","Geelong",48
12670,2005-04-09,"R3","Carlton",16,12,108,"Collingwood",20,8,128,"M.C.G.",-20,2005,"Regular",3,"Away","Collingwood","Carlton",20
12671,2005-04-09,"R3","St Kilda",14,9,93,"North Melbourne",15,10,100,"Docklands",-7,2005,"Regular",3,"Away","North Melbourne","St Kilda",7
12672,2005-04-09,"R3","Brisbane Lions",11,15,81,"Sydney",13,9,87,"Gabba",-6,2005,"Regular",3,"Away","Sydney","Brisbane Lions",6
12673,2005-04-09,"R3","Fremantle",12,8,80,"West Coast",12,16,88,"Subiaco",-8,2005,"Regular",3,"Away","West Coast","Fremantle",8
12674,2005-04-10,"R3","Adelaide",18,16,124,"Port Adelaide",8,8,56,"Football Park",68,2005,"Regular",3,"Home","Adelaide","Port Adelaide",68
12675,2005-04-10,"R3","Essendon",10,17,77,"Hawthorn",11,9,75,"M.C.G.",2,2005,"Regular",3,"Home","Essendon","Hawthorn",2
12676,2005-04-10,"R3","Footscray",11,18,84,"Richmond",12,16,88,"Docklands",-4,2005,"Regular",3,"Away","Richmond","Footscray",4
12677,2005-04-15,"R4","North Melbourne",14,9,93,"Collingwood",13,12,90,"M.C.G.",3,2005,"Regular",4,"Home","North Melbourne","Collingwood",3
12678,2005-04-16,"R4","Hawthorn",18,7,115,"Brisbane Lions",10,9,69,"M.C.G.",46,2005,"Regular",4,"Home","Hawthorn","Brisbane Lions",46
12679,2005-04-16,"R4","West Coast",21,17,143,"Footscray",17,5,107,"Subiaco",36,2005,"Regular",4,"Home","West Coast","Footscray",36
12680,2005-04-16,"R4","Geelong",19,17,131,"Essendon",11,9,75,"Docklands",56,2005,"Regular",4,"Home","Geelong","Essendon",56
12681,2005-04-16,"R4","Port Adelaide",15,19,109,"Carlton",16,13,109,"Football Park",0,2005,"Regular",4,"Home","Port Adelaide","Carlton",0
12682,2005-04-17,"R4","Sydney",11,13,79,"Adelaide",18,12,120,"S.C.G.",-41,2005,"Regular",4,"Away","Adelaide","Sydney",41
12683,2005-04-17,"R4","Richmond",14,16,100,"Fremantle",7,10,52,"M.C.G.",48,2005,"Regular",4,"Home","Richmond","Fremantle",48
12684,2005-04-17,"R4","St Kilda",23,13,151,"Melbourne",15,14,104,"Docklands",47,2005,"Regular",4,"Home","St Kilda","Melbourne",47
12685,2005-04-22,"R5","Port Adelaide",15,5,95,"Geelong",15,9,99,"Football Park",-4,2005,"Regular",5,"Away","Geelong","Port Adelaide",4
12686,2005-04-23,"R5","North Melbourne",16,12,108,"Hawthorn",13,11,89,"M.C.G.",19,2005,"Regular",5,"Home","North Melbourne","Hawthorn",19
12687,2005-04-23,"R5","Fremantle",15,13,103,"Carlton",11,18,84,"Subiaco",19,2005,"Regular",5,"Home","Fremantle","Carlton",19
12688,2005-04-23,"R5","Footscray",21,14,140,"Adelaide",16,13,109,"Docklands",31,2005,"Regular",5,"Home","Footscray","Adelaide",31
12689,2005-04-23,"R5","Sydney",7,18,60,"Melbourne",14,10,94,"S.C.G.",-34,2005,"Regular",5,"Away","Melbourne","Sydney",34
12690,2005-04-24,"R5","Brisbane Lions",12,12,84,"West Coast",23,19,157,"Gabba",-73,2005,"Regular",5,"Away","West Coast","Brisbane Lions",73
12691,2005-04-24,"R5","St Kilda",22,15,147,"Richmond",11,13,79,"Docklands",68,2005,"Regular",5,"Home","St Kilda","Richmond",68
12692,2005-04-25,"R5","Essendon",11,17,83,"Collingwood",10,9,69,"M.C.G.",14,2005,"Regular",5,"Home","Essendon","Collingwood",14
12693,2005-04-29,"R6","Carlton",13,11,89,"Hawthorn",12,11,83,"Docklands",6,2005,"Regular",6,"Home","Carlton","Hawthorn",6
12694,2005-04-30,"R6","Melbourne",20,9,129,"Fremantle",22,11,143,"M.C.G.",-14,2005,"Regular",6,"Away","Fremantle","Melbourne",14
12695,2005-04-30,"R6","Adelaide",10,14,74,"North Melbourne",10,4,64,"Football Park",10,2005,"Regular",6,"Home","Adelaide","North Melbourne",10
12696,2005-04-30,"R6","Essendon",12,16,88,"Brisbane Lions",21,10,136,"Docklands",-48,2005,"Regular",6,"Away","Brisbane Lions","Essendon",48
12697,2005-04-30,"R6","West Coast",15,14,104,"Sydney",8,11,59,"Subiaco",45,2005,"Regular",6,"Home","West Coast","Sydney",45
12698,2005-05-01,"R6","Geelong",16,12,108,"Footscray",11,7,73,"Kardinia Park",35,2005,"Regular",6,"Home","Geelong","Footscray",35
12699,2005-05-01,"R6","Collingwood",10,11,71,"St Kilda",16,13,109,"M.C.G.",-38,2005,"Regular",6,"Away","St Kilda","Collingwood",38
12700,2005-05-01,"R6","Richmond",19,9,123,"Port Adelaide",9,13,67,"Docklands",56,2005,"Regular",6,"Home","Richmond","Port Adelaide",56
12701,2005-05-06,"R7","Melbourne",11,12,78,"Adelaide",7,12,54,"M.C.G.",24,2005,"Regular",7,"Home","Melbourne","Adelaide",24
12702,2005-05-07,"R7","Richmond",23,13,151,"Carlton",10,6,66,"M.C.G.",85,2005,"Regular",7,"Home","Richmond","Carlton",85
12703,2005-05-07,"R7","Geelong",18,11,119,"St Kilda",15,11,101,"Docklands",18,2005,"Regular",7,"Home","Geelong","St Kilda",18
12704,2005-05-07,"R7","Sydney",13,16,94,"Essendon",14,4,88,"Stadium Australia",6,2005,"Regular",7,"Home","Sydney","Essendon",6
12705,2005-05-07,"R7","Brisbane Lions",12,15,87,"Footscray",15,20,110,"Gabba",-23,2005,"Regular",7,"Away","Footscray","Brisbane Lions",23
12706,2005-05-08,"R7","Hawthorn",12,5,77,"West Coast",14,12,96,"York Park",-19,2005,"Regular",7,"Away","West Coast","Hawthorn",19
12707,2005-05-08,"R7","Port Adelaide",18,11,119,"North Melbourne",10,12,72,"Football Park",47,2005,"Regular",7,"Home","Port Adelaide","North Melbourne",47
12708,2005-05-08,"R7","Fremantle",28,12,180,"Collingwood",10,8,68,"Subiaco",112,2005,"Regular",7,"Home","Fremantle","Collingwood",112
12709,2005-05-13,"R8","Carlton",10,13,73,"Geelong",22,11,143,"Docklands",-70,2005,"Regular",8,"Away","Geelong","Carlton",70
12710,2005-05-14,"R8","Hawthorn",19,14,128,"Melbourne",13,11,89,"M.C.G.",39,2005,"Regular",8,"Home","Hawthorn","Melbourne",39
12711,2005-05-14,"R8","West Coast",13,10,88,"St Kilda",7,10,52,"Subiaco",36,2005,"Regular",8,"Home","West Coast","St Kilda",36
12712,2005-05-14,"R8","North Melbourne",13,14,92,"Footscray",18,10,118,"Docklands",-26,2005,"Regular",8,"Away","Footscray","North Melbourne",26
12713,2005-05-14,"R8","Adelaide",8,15,63,"Brisbane Lions",11,6,72,"Football Park",-9,2005,"Regular",8,"Away","Brisbane Lions","Adelaide",9
12714,2005-05-15,"R8","Sydney",9,15,69,"Port Adelaide",6,9,45,"S.C.G.",24,2005,"Regular",8,"Home","Sydney","Port Adelaide",24
12715,2005-05-15,"R8","Collingwood",8,10,58,"Richmond",13,15,93,"M.C.G.",-35,2005,"Regular",8,"Away","Richmond","Collingwood",35
12716,2005-05-15,"R8","Essendon",17,15,117,"Fremantle",11,16,82,"Docklands",35,2005,"Regular",8,"Home","Essendon","Fremantle",35
12717,2005-05-20,"R9","St Kilda",8,9,57,"Adelaide",15,13,103,"Docklands",-46,2005,"Regular",9,"Away","Adelaide","St Kilda",46
12718,2005-05-21,"R9","Carlton",13,14,92,"Melbourne",15,20,110,"Princes Park",-18,2005,"Regular",9,"Away","Melbourne","Carlton",18
12719,2005-05-21,"R9","Collingwood",18,10,118,"West Coast",15,5,95,"M.C.G.",23,2005,"Regular",9,"Home","Collingwood","West Coast",23
12720,2005-05-21,"R9","Brisbane Lions",12,11,83,"Richmond",12,15,87,"Gabba",-4,2005,"Regular",9,"Away","Richmond","Brisbane Lions",4
12721,2005-05-21,"R9","Port Adelaide",12,13,85,"Essendon",9,12,66,"Football Park",19,2005,"Regular",9,"Home","Port Adelaide","Essendon",19
12722,2005-05-22,"R9","Footscray",10,16,76,"Sydney",13,11,89,"S.C.G.",-13,2005,"Regular",9,"Away","Sydney","Footscray",13
12723,2005-05-22,"R9","Geelong",22,14,146,"North Melbourne",8,13,61,"Kardinia Park",85,2005,"Regular",9,"Home","Geelong","North Melbourne",85
12724,2005-05-22,"R9","Fremantle",10,10,70,"Hawthorn",18,16,124,"Subiaco",-54,2005,"Regular",9,"Away","Hawthorn","Fremantle",54
12725,2005-05-27,"R10","Melbourne",20,11,131,"Richmond",11,8,74,"Docklands",57,2005,"Regular",10,"Home","Melbourne","Richmond",57
12726,2005-05-28,"R10","Hawthorn",12,8,80,"Collingwood",17,6,108,"M.C.G.",-28,2005,"Regular",10,"Away","Collingwood","Hawthorn",28
12727,2005-05-28,"R10","Geelong",11,16,82,"Fremantle",14,7,91,"Kardinia Park",-9,2005,"Regular",10,"Away","Fremantle","Geelong",9
12728,2005-05-28,"R10","Brisbane Lions",13,15,93,"North Melbourne",17,10,112,"Gabba",-19,2005,"Regular",10,"Away","North Melbourne","Brisbane Lions",19
12729,2005-05-28,"R10","St Kilda",15,11,101,"Sydney",8,10,58,"Docklands",43,2005,"Regular",10,"Home","St Kilda","Sydney",43
12730,2005-05-29,"R10","Adelaide",9,17,71,"Carlton",8,9,57,"Football Park",14,2005,"Regular",10,"Home","Adelaide","Carlton",14
12731,2005-05-29,"R10","Essendon",21,11,137,"Footscray",17,8,110,"Docklands",27,2005,"Regular",10,"Home","Essendon","Footscray",27
12732,2005-05-29,"R10","West Coast",27,17,179,"Port Adelaide",9,8,62,"Subiaco",117,2005,"Regular",10,"Home","West Coast","Port Adelaide",117
12733,2005-06-03,"R11","Collingwood",18,13,121,"Geelong",14,12,96,"Docklands",25,2005,"Regular",11,"Home","Collingwood","Geelong",25
12734,2005-06-04,"R11","Carlton",14,7,91,"Sydney",18,8,116,"Docklands",-25,2005,"Regular",11,"Away","Sydney","Carlton",25
12735,2005-06-04,"R11","Richmond",15,13,103,"West Coast",15,15,105,"M.C.G.",-2,2005,"Regular",11,"Away","West Coast","Richmond",2
12736,2005-06-04,"R11","Adelaide",24,7,151,"Essendon",9,9,63,"Football Park",88,2005,"Regular",11,"Home","Adelaide","Essendon",88
12737,2005-06-04,"R11","Fremantle",10,7,67,"Brisbane Lions",15,16,106,"Subiaco",-39,2005,"Regular",11,"Away","Brisbane Lions","Fremantle",39
12738,2005-06-05,"R11","North Melbourne",11,14,80,"Melbourne",17,14,116,"Manuka Oval",-36,2005,"Regular",11,"Away","Melbourne","North Melbourne",36
12739,2005-06-05,"R11","St Kilda",11,15,81,"Port Adelaide",16,8,104,"York Park",-23,2005,"Regular",11,"Away","Port Adelaide","St Kilda",23
12740,2005-06-05,"R11","Footscray",17,9,111,"Hawthorn",13,11,89,"Docklands",22,2005,"Regular",11,"Home","Footscray","Hawthorn",22
12741,2005-06-10,"R12","West Coast",15,16,106,"Essendon",12,10,82,"Subiaco",24,2005,"Regular",12,"Home","West Coast","Essendon",24
12742,2005-06-11,"R12","Hawthorn",8,6,54,"St Kilda",15,10,100,"M.C.G.",-46,2005,"Regular",12,"Away","St Kilda","Hawthorn",46
12743,2005-06-11,"R12","Carlton",12,10,82,"Brisbane Lions",21,14,140,"Docklands",-58,2005,"Regular",12,"Away","Brisbane Lions","Carlton",58
12744,2005-06-11,"R12","Port Adelaide",17,16,118,"Footscray",15,13,103,"Football Park",15,2005,"Regular",12,"Home","Port Adelaide","Footscray",15
12745,2005-06-12,"R12","Sydney",16,13,109,"Fremantle",10,11,71,"S.C.G.",38,2005,"Regular",12,"Home","Sydney","Fremantle",38
12746,2005-06-12,"R12","Geelong",9,7,61,"Adelaide",8,9,57,"Kardinia Park",4,2005,"Regular",12,"Home","Geelong","Adelaide",4
12747,2005-06-12,"R12","North Melbourne",17,7,109,"Richmond",10,20,80,"Docklands",29,2005,"Regular",12,"Home","North Melbourne","Richmond",29
12748,2005-06-13,"R12","Melbourne",17,15,117,"Collingwood",10,12,72,"M.C.G.",45,2005,"Regular",12,"Home","Melbourne","Collingwood",45
12749,2005-06-17,"R13","Port Adelaide",29,14,188,"Hawthorn",10,11,71,"Football Park",117,2005,"Regular",13,"Home","Port Adelaide","Hawthorn",117
12750,2005-06-18,"R13","Melbourne",13,12,90,"West Coast",15,15,105,"M.C.G.",-15,2005,"Regular",13,"Away","West Coast","Melbourne",15
12751,2005-06-18,"R13","Richmond",9,8,62,"Adelaide",20,12,132,"Docklands",-70,2005,"Regular",13,"Away","Adelaide","Richmond",70
12752,2005-06-18,"R13","Footscray",17,14,116,"Carlton",10,10,70,"Marrara Oval",46,2005,"Regular",13,"Home","Footscray","Carlton",46
12753,2005-06-19,"R13","Brisbane Lions",17,14,116,"Geelong",6,11,47,"Gabba",69,2005,"Regular",13,"Home","Brisbane Lions","Geelong",69
12754,2005-06-19,"R13","Fremantle",6,8,44,"North Melbourne",8,18,66,"Subiaco",-22,2005,"Regular",13,"Away","North Melbourne","Fremantle",22
12755,2005-06-24,"R13","Essendon",19,5,119,"St Kilda",16,8,104,"Docklands",15,2005,"Regular",13,"Home","Essendon","St Kilda",15
12756,2005-06-25,"R13","Sydney",11,11,77,"Collingwood",10,16,76,"Stadium Australia",1,2005,"Regular",13,"Home","Sydney","Collingwood",1
12757,2005-07-01,"R14","Collingwood",14,18,102,"Port Adelaide",9,17,71,"Docklands",31,2005,"Regular",14,"Home","Collingwood","Port Adelaide",31
12758,2005-07-02,"R14","Richmond",12,13,85,"Sydney",12,12,84,"M.C.G.",1,2005,"Regular",14,"Home","Richmond","Sydney",1
12759,2005-07-02,"R14","West Coast",21,13,139,"Carlton",9,8,62,"Subiaco",77,2005,"Regular",14,"Home","West Coast","Carlton",77
12760,2005-07-02,"R14","Essendon",13,8,86,"North Melbourne",19,14,128,"Docklands",-42,2005,"Regular",14,"Away","North Melbourne","Essendon",42
12761,2005-07-02,"R14","Melbourne",13,14,92,"Brisbane Lions",25,16,166,"Gabba",-74,2005,"Regular",14,"Away","Brisbane Lions","Melbourne",74
12762,2005-07-03,"R14","Adelaide",14,10,94,"Fremantle",14,4,88,"Football Park",6,2005,"Regular",14,"Home","Adelaide","Fremantle",6
12763,2005-07-03,"R14","Footscray",15,8,98,"St Kilda",17,14,116,"M.C.G.",-18,2005,"Regular",14,"Away","St Kilda","Footscray",18
12764,2005-07-03,"R14","Geelong",16,17,113,"Hawthorn",8,10,58,"Docklands",55,2005,"Regular",14,"Home","Geelong","Hawthorn",55
12765,2005-07-08,"R15","North Melbourne",14,13,97,"West Coast",15,11,101,"Docklands",-4,2005,"Regular",15,"Away","West Coast","North Melbourne",4
12766,2005-07-09,"R15","Richmond",14,8,92,"Essendon",9,12,66,"M.C.G.",26,2005,"Regular",15,"Home","Richmond","Essendon",26
12767,2005-07-09,"R15","Port Adelaide",20,17,137,"Melbourne",11,9,75,"Football Park",62,2005,"Regular",15,"Home","Port Adelaide","Melbourne",62
12768,2005-07-09,"R15","Brisbane Lions",19,19,133,"Collingwood",7,13,55,"Gabba",78,2005,"Regular",15,"Home","Brisbane Lions","Collingwood",78
12769,2005-07-09,"R15","Sydney",16,9,105,"Geelong",7,9,51,"S.C.G.",54,2005,"Regular",15,"Home","Sydney","Geelong",54
12770,2005-07-10,"R15","Hawthorn",10,8,68,"Adelaide",12,6,78,"York Park",-10,2005,"Regular",15,"Away","Adelaide","Hawthorn",10
12771,2005-07-10,"R15","St Kilda",23,15,153,"Carlton",11,7,73,"Docklands",80,2005,"Regular",15,"Home","St Kilda","Carlton",80
12772,2005-07-10,"R15","Fremantle",22,13,145,"Footscray",13,14,92,"Subiaco",53,2005,"Regular",15,"Home","Fremantle","Footscray",53
12773,2005-07-15,"R16","Collingwood",15,15,105,"Essendon",21,5,131,"M.C.G.",-26,2005,"Regular",16,"Away","Essendon","Collingwood",26
12774,2005-07-16,"R16","Geelong",18,18,126,"Port Adelaide",7,5,47,"Kardinia Park",79,2005,"Regular",16,"Home","Geelong","Port Adelaide",79
12775,2005-07-16,"R16","Richmond",5,7,37,"St Kilda",16,10,106,"M.C.G.",-69,2005,"Regular",16,"Away","St Kilda","Richmond",69
12776,2005-07-16,"R16","Melbourne",11,12,78,"Sydney",16,8,104,"Docklands",-26,2005,"Regular",16,"Away","Sydney","Melbourne",26
12777,2005-07-16,"R16","West Coast",17,9,111,"Brisbane Lions",13,10,88,"Subiaco",23,2005,"Regular",16,"Home","West Coast","Brisbane Lions",23
12778,2005-07-17,"R16","Adelaide",16,13,109,"Footscray",5,5,35,"Football Park",74,2005,"Regular",16,"Home","Adelaide","Footscray",74
12779,2005-07-17,"R16","Carlton",17,15,117,"Fremantle",24,8,152,"M.C.G.",-35,2005,"Regular",16,"Away","Fremantle","Carlton",35
12780,2005-07-17,"R16","Hawthorn",10,8,68,"North Melbourne",16,13,109,"Docklands",-41,2005,"Regular",16,"Away","North Melbourne","Hawthorn",41
12781,2005-07-22,"R17","St Kilda",21,17,143,"Collingwood",10,10,70,"Docklands",73,2005,"Regular",17,"Home","St Kilda","Collingwood",73
12782,2005-07-23,"R17","Hawthorn",19,13,127,"Carlton",15,13,103,"M.C.G.",24,2005,"Regular",17,"Home","Hawthorn","Carlton",24
12783,2005-07-23,"R17","Footscray",20,13,133,"Geelong",14,14,98,"Docklands",35,2005,"Regular",17,"Home","Footscray","Geelong",35
12784,2005-07-23,"R17","Brisbane Lions",17,12,114,"Essendon",14,17,101,"Gabba",13,2005,"Regular",17,"Home","Brisbane Lions","Essendon",13
12785,2005-07-23,"R17","Port Adelaide",14,12,96,"Richmond",12,11,83,"Football Park",13,2005,"Regular",17,"Home","Port Adelaide","Richmond",13
12786,2005-07-24,"R17","Sydney",13,10,88,"West Coast",9,13,67,"S.C.G.",21,2005,"Regular",17,"Home","Sydney","West Coast",21
12787,2005-07-24,"R17","North Melbourne",16,13,109,"Adelaide",19,8,122,"Docklands",-13,2005,"Regular",17,"Away","Adelaide","North Melbourne",13
12788,2005-07-24,"R17","Fremantle",15,11,101,"Melbourne",11,10,76,"Subiaco",25,2005,"Regular",17,"Home","Fremantle","Melbourne",25
12789,2005-07-29,"R18","Essendon",16,11,107,"Geelong",13,16,94,"Docklands",13,2005,"Regular",18,"Home","Essendon","Geelong",13
12790,2005-07-30,"R18","Melbourne",13,10,88,"St Kilda",27,14,176,"M.C.G.",-88,2005,"Regular",18,"Away","St Kilda","Melbourne",88
12791,2005-07-30,"R18","West Coast",12,25,97,"Hawthorn",7,7,49,"Subiaco",48,2005,"Regular",18,"Home","West Coast","Hawthorn",48
12792,2005-07-30,"R18","Footscray",23,13,151,"Brisbane Lions",18,15,123,"Docklands",28,2005,"Regular",18,"Home","Footscray","Brisbane Lions",28
12793,2005-07-30,"R18","Adelaide",8,6,54,"Sydney",6,11,47,"Football Park",7,2005,"Regular",18,"Home","Adelaide","Sydney",7
12794,2005-07-31,"R18","North Melbourne",15,10,100,"Port Adelaide",14,12,96,"Manuka Oval",4,2005,"Regular",18,"Home","North Melbourne","Port Adelaide",4
12795,2005-07-31,"R18","Carlton",22,9,141,"Richmond",16,10,106,"Docklands",35,2005,"Regular",18,"Home","Carlton","Richmond",35
12796,2005-07-31,"R18","Collingwood",12,13,85,"Fremantle",15,8,98,"M.C.G.",-13,2005,"Regular",18,"Away","Fremantle","Collingwood",13
12797,2005-08-05,"R19","St Kilda",13,18,96,"Geelong",8,7,55,"Docklands",41,2005,"Regular",19,"Home","St Kilda","Geelong",41
12798,2005-08-06,"R19","Footscray",21,14,140,"West Coast",14,13,97,"M.C.G.",43,2005,"Regular",19,"Home","Footscray","West Coast",43
12799,2005-08-06,"R19","Adelaide",13,22,100,"Melbourne",7,4,46,"Football Park",54,2005,"Regular",19,"Home","Adelaide","Melbourne",54
12800,2005-08-06,"R19","Essendon",15,8,98,"Sydney",18,10,118,"Docklands",-20,2005,"Regular",19,"Away","Sydney","Essendon",20
12801,2005-08-06,"R19","Fremantle",13,15,93,"Richmond",9,12,66,"Subiaco",27,2005,"Regular",19,"Home","Fremantle","Richmond",27
12802,2005-08-07,"R19","Brisbane Lions",18,13,121,"Hawthorn",11,14,80,"Gabba",41,2005,"Regular",19,"Home","Brisbane Lions","Hawthorn",41
12803,2005-08-07,"R19","Carlton",16,13,109,"Port Adelaide",18,15,123,"M.C.G.",-14,2005,"Regular",19,"Away","Port Adelaide","Carlton",14
12804,2005-08-07,"R19","Collingwood",14,14,98,"North Melbourne",15,14,104,"Docklands",-6,2005,"Regular",19,"Away","North Melbourne","Collingwood",6
12805,2005-08-12,"R20","West Coast",19,14,128,"Fremantle",12,8,80,"Subiaco",48,2005,"Regular",20,"Home","West Coast","Fremantle",48
12806,2005-08-13,"R20","Geelong",15,9,99,"Melbourne",14,16,100,"Kardinia Park",-1,2005,"Regular",20,"Away","Melbourne","Geelong",1
12807,2005-08-13,"R20","North Melbourne",13,7,85,"St Kilda",16,12,108,"Docklands",-23,2005,"Regular",20,"Away","St Kilda","North Melbourne",23
12808,2005-08-13,"R20","Collingwood",14,10,94,"Carlton",19,15,129,"M.C.G.",-35,2005,"Regular",20,"Away","Carlton","Collingwood",35
12809,2005-08-13,"R20","Port Adelaide",12,9,81,"Adelaide",13,10,88,"Football Park",-7,2005,"Regular",20,"Away","Adelaide","Port Adelaide",7
12810,2005-08-14,"R20","Sydney",19,10,124,"Brisbane Lions",6,4,40,"Stadium Australia",84,2005,"Regular",20,"Home","Sydney","Brisbane Lions",84
12811,2005-08-14,"R20","Hawthorn",17,15,117,"Essendon",16,8,104,"M.C.G.",13,2005,"Regular",20,"Home","Hawthorn","Essendon",13
12812,2005-08-14,"R20","Richmond",16,11,107,"Footscray",18,11,119,"Docklands",-12,2005,"Regular",20,"Away","Footscray","Richmond",12
12813,2005-08-19,"R21","Fremantle",12,8,80,"St Kilda",11,9,75,"Subiaco",5,2005,"Regular",21,"Home","Fremantle","St Kilda",5
12814,2005-08-20,"R21","Geelong",16,13,109,"West Coast",5,3,33,"Kardinia Park",76,2005,"Regular",21,"Home","Geelong","West Coast",76
12815,2005-08-20,"R21","Adelaide",22,19,151,"Collingwood",5,11,41,"Football Park",110,2005,"Regular",21,"Home","Adelaide","Collingwood",110
12816,2005-08-20,"R21","Melbourne",16,13,109,"Footscray",16,9,105,"M.C.G.",4,2005,"Regular",21,"Home","Melbourne","Footscray",4
12817,2005-08-20,"R21","Brisbane Lions",7,9,51,"Port Adelaide",11,15,81,"Gabba",-30,2005,"Regular",21,"Away","Port Adelaide","Brisbane Lions",30
12818,2005-08-21,"R21","Sydney",15,11,101,"North Melbourne",9,10,64,"S.C.G.",37,2005,"Regular",21,"Home","Sydney","North Melbourne",37
12819,2005-08-21,"R21","Essendon",28,14,182,"Carlton",11,17,83,"M.C.G.",99,2005,"Regular",21,"Home","Essendon","Carlton",99
12820,2005-08-21,"R21","Richmond",20,17,137,"Hawthorn",21,7,133,"Docklands",4,2005,"Regular",21,"Home","Richmond","Hawthorn",4
12821,2005-08-26,"R22","Footscray",21,15,141,"Collingwood",14,16,100,"Docklands",41,2005,"Regular",22,"Home","Footscray","Collingwood",41
12822,2005-08-27,"R22","Hawthorn",11,9,75,"Sydney",20,9,129,"M.C.G.",-54,2005,"Regular",22,"Away","Sydney","Hawthorn",54
12823,2005-08-27,"R22","West Coast",10,14,74,"Adelaide",12,10,82,"Subiaco",-8,2005,"Regular",22,"Away","Adelaide","West Coast",8
12824,2005-08-27,"R22","St Kilda",28,18,186,"Brisbane Lions",7,5,47,"Docklands",139,2005,"Regular",22,"Home","St Kilda","Brisbane Lions",139
12825,2005-08-27,"R22","Port Adelaide",18,12,120,"Fremantle",11,9,75,"Football Park",45,2005,"Regular",22,"Home","Port Adelaide","Fremantle",45
12826,2005-08-28,"R22","Geelong",10,9,69,"Richmond",10,8,68,"Kardinia Park",1,2005,"Regular",22,"Home","Geelong","Richmond",1
12827,2005-08-28,"R22","Carlton",12,11,83,"North Melbourne",17,11,113,"Docklands",-30,2005,"Regular",22,"Away","North Melbourne","Carlton",30
12828,2005-08-28,"R22","Essendon",12,13,85,"Melbourne",13,17,95,"M.C.G.",-10,2005,"Regular",22,"Away","Melbourne","Essendon",10
12829,2005-09-02,"QF","West Coast",10,9,69,"Sydney",10,5,65,"Subiaco",4,2005,"Finals",23,"Home","West Coast","Sydney",4
12830,2005-09-03,"EF","Geelong",18,8,116,"Melbourne",9,7,61,"M.C.G.",55,2005,"Finals",23,"Home","Geelong","Melbourne",55
12831,2005-09-03,"QF","Adelaide",8,9,57,"St Kilda",10,5,65,"Football Park",-8,2005,"Finals",23,"Away","St Kilda","Adelaide",8
12832,2005-09-04,"EF","North Melbourne",11,11,77,"Port Adelaide",26,8,164,"Docklands",-87,2005,"Finals",23,"Away","Port Adelaide","North Melbourne",87
12833,2005-09-09,"SF","Sydney",7,14,56,"Geelong",7,11,53,"S.C.G.",3,2005,"Finals",24,"Home","Sydney","Geelong",3
12834,2005-09-10,"SF","Adelaide",18,15,123,"Port Adelaide",5,10,40,"Football Park",83,2005,"Finals",24,"Home","Adelaide","Port Adelaide",83
12835,2005-09-16,"PF","St Kilda",9,11,65,"Sydney",15,6,96,"M.C.G.",-31,2005,"Finals",25,"Away","Sydney","St Kilda",31
12836,2005-09-17,"PF","West Coast",14,9,93,"Adelaide",11,11,77,"Subiaco",16,2005,"Finals",25,"Home","West Coast","Adelaide",16
12837,2005-09-24,"GF","West Coast",7,12,54,"Sydney",8,10,58,"M.C.G.",-4,2005,"Finals",26,"Away","Sydney","West Coast",4
12838,2006-03-30,"R1","West Coast",11,18,84,"St Kilda",9,12,66,"Subiaco",18,2006,"Regular",1,"Home","West Coast","St Kilda",18
12839,2006-03-31,"R1","Footscray",25,17,167,"Richmond",7,10,52,"Docklands",115,2006,"Regular",1,"Home","Footscray","Richmond",115
12840,2006-04-01,"R1","Geelong",17,13,115,"Brisbane Lions",5,8,38,"Kardinia Park",77,2006,"Regular",1,"Home","Geelong","Brisbane Lions",77
12841,2006-04-01,"R1","Essendon",17,6,108,"Sydney",12,9,81,"Docklands",27,2006,"Regular",1,"Home","Essendon","Sydney",27
12842,2006-04-01,"R1","Port Adelaide",13,9,87,"North Melbourne",19,14,128,"Football Park",-41,2006,"Regular",1,"Away","North Melbourne","Port Adelaide",41
12843,2006-04-02,"R1","Hawthorn",17,7,109,"Fremantle",13,9,87,"York Park",22,2006,"Regular",1,"Home","Hawthorn","Fremantle",22
12844,2006-04-02,"R1","Melbourne",10,12,72,"Carlton",13,15,93,"Docklands",-21,2006,"Regular",1,"Away","Carlton","Melbourne",21
12845,2006-04-03,"R1","Collingwood",12,5,77,"Adelaide",17,9,111,"Docklands",-34,2006,"Regular",1,"Away","Adelaide","Collingwood",34
12846,2006-04-07,"R2","Richmond",11,11,77,"St Kilda",13,10,88,"Docklands",-11,2006,"Regular",2,"Away","St Kilda","Richmond",11
12847,2006-04-08,"R2","Footscray",20,17,137,"Melbourne",12,18,90,"Docklands",47,2006,"Regular",2,"Home","Footscray","Melbourne",47
12848,2006-04-08,"R2","Geelong",22,6,138,"North Melbourne",10,9,69,"Kardinia Park",69,2006,"Regular",2,"Home","Geelong","North Melbourne",69
12849,2006-04-08,"R2","Brisbane Lions",17,13,115,"Essendon",15,7,97,"Gabba",18,2006,"Regular",2,"Home","Brisbane Lions","Essendon",18
12850,2006-04-08,"R2","Fremantle",15,11,101,"Carlton",13,8,86,"Subiaco",15,2006,"Regular",2,"Home","Fremantle","Carlton",15
12851,2006-04-09,"R2","Sydney",11,14,80,"Port Adelaide",15,16,106,"S.C.G.",-26,2006,"Regular",2,"Away","Port Adelaide","Sydney",26
12852,2006-04-09,"R2","Hawthorn",12,12,84,"Collingwood",18,11,119,"Docklands",-35,2006,"Regular",2,"Away","Collingwood","Hawthorn",35
12853,2006-04-09,"R2","Adelaide",13,10,88,"West Coast",13,12,90,"Football Park",-2,2006,"Regular",2,"Away","West Coast","Adelaide",2
12854,2006-04-13,"R3","St Kilda",19,10,124,"Brisbane Lions",12,15,87,"Docklands",37,2006,"Regular",3,"Home","St Kilda","Brisbane Lions",37
12855,2006-04-15,"R3","Geelong",6,13,49,"Hawthorn",15,11,101,"Kardinia Park",-52,2006,"Regular",3,"Away","Hawthorn","Geelong",52
12856,2006-04-15,"R3","Carlton",11,8,74,"Sydney",12,9,81,"Docklands",-7,2006,"Regular",3,"Away","Sydney","Carlton",7
12857,2006-04-15,"R3","West Coast",20,16,136,"Richmond",14,6,90,"Subiaco",46,2006,"Regular",3,"Home","West Coast","Richmond",46
12858,2006-04-16,"R3","Melbourne",14,13,97,"Adelaide",15,12,102,"Carrara",-5,2006,"Regular",3,"Away","Adelaide","Melbourne",5
12859,2006-04-16,"R3","Essendon",13,15,93,"Footscray",15,14,104,"Docklands",-11,2006,"Regular",3,"Away","Footscray","Essendon",11
12860,2006-04-16,"R3","Port Adelaide",11,13,79,"Fremantle",15,20,110,"Football Park",-31,2006,"Regular",3,"Away","Fremantle","Port Adelaide",31
12861,2006-04-17,"R3","North Melbourne",11,10,76,"Collingwood",23,15,153,"Docklands",-77,2006,"Regular",3,"Away","Collingwood","North Melbourne",77
12862,2006-04-21,"R4","Carlton",9,14,68,"Hawthorn",15,10,100,"Docklands",-32,2006,"Regular",4,"Away","Hawthorn","Carlton",32
12863,2006-04-22,"R4","Footscray",14,14,98,"Geelong",14,13,97,"Docklands",1,2006,"Regular",4,"Home","Footscray","Geelong",1
12864,2006-04-22,"R4","Brisbane Lions",11,16,82,"Richmond",14,12,96,"Gabba",-14,2006,"Regular",4,"Away","Richmond","Brisbane Lions",14
12865,2006-04-22,"R4","Fremantle",9,5,59,"Adelaide",9,16,70,"Subiaco",-11,2006,"Regular",4,"Away","Adelaide","Fremantle",11
12866,2006-04-23,"R4","Sydney",13,14,92,"Melbourne",15,7,97,"S.C.G.",-5,2006,"Regular",4,"Away","Melbourne","Sydney",5
12867,2006-04-23,"R4","North Melbourne",10,11,71,"West Coast",14,11,95,"Manuka Oval",-24,2006,"Regular",4,"Away","West Coast","North Melbourne",24
12868,2006-04-24,"R4","Port Adelaide",19,8,122,"St Kilda",18,10,118,"Football Park",4,2006,"Regular",4,"Home","Port Adelaide","St Kilda",4
12869,2006-04-25,"R4","Collingwood",15,16,106,"Essendon",12,17,89,"M.C.G.",17,2006,"Regular",4,"Home","Collingwood","Essendon",17
12870,2006-04-28,"R5","Richmond",12,20,92,"Carlton",11,18,84,"M.C.G.",8,2006,"Regular",5,"Home","Richmond","Carlton",8
12871,2006-04-29,"R5","Melbourne",13,12,90,"North Melbourne",12,14,86,"M.C.G.",4,2006,"Regular",5,"Home","Melbourne","North Melbourne",4
12872,2006-04-29,"R5","Adelaide",20,12,132,"Footscray",7,13,55,"Football Park",77,2006,"Regular",5,"Home","Adelaide","Footscray",77
12873,2006-04-29,"R5","Sydney",15,17,107,"Geelong",13,7,85,"Stadium Australia",22,2006,"Regular",5,"Home","Sydney","Geelong",22
12874,2006-04-29,"R5","West Coast",18,14,122,"Brisbane Lions",9,9,63,"Subiaco",59,2006,"Regular",5,"Home","West Coast","Brisbane Lions",59
12875,2006-04-30,"R5","St Kilda",13,15,93,"Fremantle",14,10,94,"York Park",-1,2006,"Regular",5,"Away","Fremantle","St Kilda",1
12876,2006-04-30,"R5","Collingwood",18,12,120,"Port Adelaide",11,13,79,"Docklands",41,2006,"Regular",5,"Home","Collingwood","Port Adelaide",41
12877,2006-04-30,"R5","Hawthorn",12,12,84,"Essendon",12,11,83,"M.C.G.",1,2006,"Regular",5,"Home","Hawthorn","Essendon",1
12878,2006-05-05,"R6","Melbourne",13,9,87,"Geelong",11,15,81,"M.C.G.",6,2006,"Regular",6,"Home","Melbourne","Geelong",6
12879,2006-05-06,"R6","St Kilda",14,8,92,"Footscray",12,6,78,"Docklands",14,2006,"Regular",6,"Home","St Kilda","Footscray",14
12880,2006-05-06,"R6","Fremantle",12,16,88,"West Coast",12,11,83,"Subiaco",5,2006,"Regular",6,"Home","Fremantle","West Coast",5
12881,2006-05-06,"R6","Adelaide",15,13,103,"Port Adelaide",8,5,53,"Football Park",50,2006,"Regular",6,"Home","Adelaide","Port Adelaide",50
12882,2006-05-06,"R6","Essendon",13,17,95,"Richmond",13,19,97,"M.C.G.",-2,2006,"Regular",6,"Away","Richmond","Essendon",2
12883,2006-05-07,"R6","Brisbane Lions",10,10,70,"Sydney",15,12,102,"Gabba",-32,2006,"Regular",6,"Away","Sydney","Brisbane Lions",32
12884,2006-05-07,"R6","Carlton",9,12,66,"Collingwood",21,12,138,"M.C.G.",-72,2006,"Regular",6,"Away","Collingwood","Carlton",72
12885,2006-05-07,"R6","North Melbourne",15,12,102,"Hawthorn",11,14,80,"Docklands",22,2006,"Regular",6,"Home","North Melbourne","Hawthorn",22
12886,2006-05-12,"R7","St Kilda",9,10,64,"Geelong",12,10,82,"Docklands",-18,2006,"Regular",7,"Away","Geelong","St Kilda",18
12887,2006-05-13,"R7","Melbourne",17,15,117,"Fremantle",8,10,58,"M.C.G.",59,2006,"Regular",7,"Home","Melbourne","Fremantle",59
12888,2006-05-13,"R7","Richmond",9,8,62,"Sydney",28,12,180,"Docklands",-118,2006,"Regular",7,"Away","Sydney","Richmond",118
12889,2006-05-13,"R7","Hawthorn",9,12,66,"Brisbane Lions",16,10,106,"Carrara",-40,2006,"Regular",7,"Away","Brisbane Lions","Hawthorn",40
12890,2006-05-13,"R7","West Coast",16,16,112,"Collingwood",15,8,98,"Subiaco",14,2006,"Regular",7,"Home","West Coast","Collingwood",14
12891,2006-05-14,"R7","Port Adelaide",13,12,90,"Footscray",25,16,166,"Football Park",-76,2006,"Regular",7,"Away","Footscray","Port Adelaide",76
12892,2006-05-14,"R7","Carlton",17,9,111,"Essendon",11,12,78,"M.C.G.",33,2006,"Regular",7,"Home","Carlton","Essendon",33
12893,2006-05-14,"R7","North Melbourne",9,6,60,"Adelaide",18,8,116,"Docklands",-56,2006,"Regular",7,"Away","Adelaide","North Melbourne",56
12894,2006-05-19,"R8","Hawthorn",9,7,61,"Melbourne",20,16,136,"M.C.G.",-75,2006,"Regular",8,"Away","Melbourne","Hawthorn",75
12895,2006-05-20,"R8","Richmond",10,9,69,"Adelaide",9,12,66,"Docklands",3,2006,"Regular",8,"Home","Richmond","Adelaide",3
12896,2006-05-20,"R8","Fremantle",13,6,84,"North Melbourne",6,13,49,"Subiaco",35,2006,"Regular",8,"Home","Fremantle","North Melbourne",35
12897,2006-05-20,"R8","Collingwood",22,14,146,"Geelong",6,8,44,"M.C.G.",102,2006,"Regular",8,"Home","Collingwood","Geelong",102
12898,2006-05-20,"R8","Footscray",14,6,90,"Sydney",17,14,116,"S.C.G.",-26,2006,"Regular",8,"Away","Sydney","Footscray",26
12899,2006-05-21,"R8","Port Adelaide",10,18,78,"Brisbane Lions",22,15,147,"Football Park",-69,2006,"Regular",8,"Away","Brisbane Lions","Port Adelaide",69
12900,2006-05-21,"R8","Carlton",4,10,34,"St Kilda",18,18,126,"M.C.G.",-92,2006,"Regular",8,"Away","St Kilda","Carlton",92
12901,2006-05-21,"R8","Essendon",14,8,92,"West Coast",16,17,113,"Docklands",-21,2006,"Regular",8,"Away","West Coast","Essendon",21
12902,2006-05-26,"R9","Collingwood",21,13,139,"Footscray",16,9,105,"M.C.G.",34,2006,"Regular",9,"Home","Collingwood","Footscray",34
12903,2006-05-27,"R9","Geelong",12,18,90,"Richmond",17,8,110,"Kardinia Park",-20,2006,"Regular",9,"Away","Richmond","Geelong",20
12904,2006-05-27,"R9","Adelaide",18,16,124,"Carlton",9,6,60,"Football Park",64,2006,"Regular",9,"Home","Adelaide","Carlton",64
12905,2006-05-27,"R9","Essendon",9,15,69,"Port Adelaide",20,9,129,"Docklands",-60,2006,"Regular",9,"Away","Port Adelaide","Essendon",60
12906,2006-05-27,"R9","Hawthorn",7,12,54,"Sydney",19,5,119,"M.C.G.",-65,2006,"Regular",9,"Away","Sydney","Hawthorn",65
12907,2006-05-28,"R9","Brisbane Lions",21,15,141,"Fremantle",10,13,73,"Gabba",68,2006,"Regular",9,"Home","Brisbane Lions","Fremantle",68
12908,2006-05-28,"R9","St Kilda",10,14,74,"North Melbourne",8,9,57,"Docklands",17,2006,"Regular",9,"Home","St Kilda","North Melbourne",17
12909,2006-05-28,"R9","West Coast",13,19,97,"Melbourne",11,9,75,"Subiaco",22,2006,"Regular",9,"Home","West Coast","Melbourne",22
12910,2006-06-02,"R10","Adelaide",30,8,188,"Essendon",6,14,50,"Football Park",138,2006,"Regular",10,"Home","Adelaide","Essendon",138
12911,2006-06-03,"R10","Footscray",16,13,109,"Hawthorn",13,10,88,"Docklands",21,2006,"Regular",10,"Home","Footscray","Hawthorn",21
12912,2006-06-03,"R10","Geelong",15,8,98,"West Coast",16,5,101,"Kardinia Park",-3,2006,"Regular",10,"Away","West Coast","Geelong",3
12913,2006-06-03,"R10","Collingwood",16,13,109,"Brisbane Lions",12,11,83,"M.C.G.",26,2006,"Regular",10,"Home","Collingwood","Brisbane Lions",26
12914,2006-06-03,"R10","Fremantle",15,10,100,"Richmond",13,11,89,"Subiaco",11,2006,"Regular",10,"Home","Fremantle","Richmond",11
12915,2006-06-04,"R10","North Melbourne",14,14,98,"Sydney",16,9,105,"Manuka Oval",-7,2006,"Regular",10,"Away","Sydney","North Melbourne",7
12916,2006-06-04,"R10","Carlton",12,12,84,"Port Adelaide",17,16,118,"Docklands",-34,2006,"Regular",10,"Away","Port Adelaide","Carlton",34
12917,2006-06-04,"R10","Melbourne",15,13,103,"St Kilda",13,12,90,"M.C.G.",13,2006,"Regular",10,"Home","Melbourne","St Kilda",13
12918,2006-06-09,"R11","Geelong",20,10,130,"Essendon",13,10,88,"Docklands",42,2006,"Regular",11,"Home","Geelong","Essendon",42
12919,2006-06-10,"R11","Richmond",15,12,102,"North Melbourne",9,13,67,"M.C.G.",35,2006,"Regular",11,"Home","Richmond","North Melbourne",35
12920,2006-06-10,"R11","Brisbane Lions",8,12,60,"Adelaide",10,15,75,"Gabba",-15,2006,"Regular",11,"Away","Adelaide","Brisbane Lions",15
12921,2006-06-10,"R11","Sydney",7,8,50,"St Kilda",7,10,52,"S.C.G.",-2,2006,"Regular",11,"Away","St Kilda","Sydney",2
12922,2006-06-11,"R11","Port Adelaide",22,13,145,"Hawthorn",7,7,49,"Football Park",96,2006,"Regular",11,"Home","Port Adelaide","Hawthorn",96
12923,2006-06-11,"R11","Footscray",15,10,100,"Fremantle",12,14,86,"Docklands",14,2006,"Regular",11,"Home","Footscray","Fremantle",14
12924,2006-06-11,"R11","West Coast",16,15,111,"Carlton",15,11,101,"Subiaco",10,2006,"Regular",11,"Home","West Coast","Carlton",10
12925,2006-06-12,"R11","Melbourne",22,9,141,"Collingwood",14,10,94,"M.C.G.",47,2006,"Regular",11,"Home","Melbourne","Collingwood",47
12926,2006-06-16,"R12","St Kilda",8,12,60,"Adelaide",18,15,123,"Docklands",-63,2006,"Regular",12,"Away","Adelaide","St Kilda",63
12927,2006-06-17,"R12","Fremantle",6,16,52,"Geelong",18,10,118,"Subiaco",-66,2006,"Regular",12,"Away","Geelong","Fremantle",66
12928,2006-06-17,"R12","Brisbane Lions",14,19,103,"Footscray",22,13,145,"Gabba",-42,2006,"Regular",12,"Away","Footscray","Brisbane Lions",42
12929,2006-06-17,"R12","Port Adelaide",13,19,97,"West Coast",8,12,60,"Football Park",37,2006,"Regular",12,"Home","Port Adelaide","West Coast",37
12930,2006-06-18,"R12","Hawthorn",16,9,105,"Richmond",8,16,64,"York Park",41,2006,"Regular",12,"Home","Hawthorn","Richmond",41
12931,2006-06-18,"R12","Essendon",10,15,75,"Melbourne",16,15,111,"Docklands",-36,2006,"Regular",12,"Away","Melbourne","Essendon",36
12932,2006-06-23,"R12","North Melbourne",18,13,121,"Carlton",15,12,102,"Docklands",19,2006,"Regular",12,"Home","North Melbourne","Carlton",19
12933,2006-06-24,"R12","Sydney",11,16,82,"Collingwood",14,11,95,"Stadium Australia",-13,2006,"Regular",12,"Away","Collingwood","Sydney",13
12934,2006-06-30,"R13","North Melbourne",14,12,96,"Essendon",13,11,89,"Docklands",7,2006,"Regular",13,"Home","North Melbourne","Essendon",7
12935,2006-07-01,"R13","St Kilda",18,17,125,"Hawthorn",8,7,55,"Docklands",70,2006,"Regular",13,"Home","St Kilda","Hawthorn",70
12936,2006-07-01,"R13","Melbourne",18,12,120,"Port Adelaide",12,10,82,"M.C.G.",38,2006,"Regular",13,"Home","Melbourne","Port Adelaide",38
12937,2006-07-01,"R13","Brisbane Lions",8,23,71,"Carlton",7,14,56,"Gabba",15,2006,"Regular",13,"Home","Brisbane Lions","Carlton",15
12938,2006-07-01,"R13","Sydney",12,19,91,"Fremantle",9,4,58,"S.C.G.",33,2006,"Regular",13,"Home","Sydney","Fremantle",33
12939,2006-07-02,"R13","Adelaide",21,21,147,"Geelong",8,7,55,"Football Park",92,2006,"Regular",13,"Home","Adelaide","Geelong",92
12940,2006-07-02,"R13","Richmond",13,14,92,"Collingwood",6,9,45,"M.C.G.",47,2006,"Regular",13,"Home","Richmond","Collingwood",47
12941,2006-07-02,"R13","West Coast",8,16,64,"Footscray",10,13,73,"Subiaco",-9,2006,"Regular",13,"Away","Footscray","West Coast",9
12942,2006-07-07,"R14","Fremantle",19,11,125,"Essendon",12,16,88,"Subiaco",37,2006,"Regular",14,"Home","Fremantle","Essendon",37
12943,2006-07-08,"R14","Carlton",11,11,77,"Geelong",23,4,142,"Docklands",-65,2006,"Regular",14,"Away","Geelong","Carlton",65
12944,2006-07-08,"R14","Hawthorn",16,8,104,"West Coast",17,12,114,"M.C.G.",-10,2006,"Regular",14,"Away","West Coast","Hawthorn",10
12945,2006-07-08,"R14","Melbourne",14,14,98,"Brisbane Lions",13,12,90,"Gabba",8,2006,"Regular",14,"Home","Melbourne","Brisbane Lions",8
12946,2006-07-08,"R14","Port Adelaide",6,18,54,"Richmond",14,8,92,"Football Park",-38,2006,"Regular",14,"Away","Richmond","Port Adelaide",38
12947,2006-07-09,"R14","Sydney",8,14,62,"Adelaide",15,11,101,"S.C.G.",-39,2006,"Regular",14,"Away","Adelaide","Sydney",39
12948,2006-07-09,"R14","St Kilda",19,8,122,"Collingwood",9,9,63,"Docklands",59,2006,"Regular",14,"Home","St Kilda","Collingwood",59
12949,2006-07-09,"R14","Footscray",12,10,82,"North Melbourne",13,16,94,"M.C.G.",-12,2006,"Regular",14,"Away","North Melbourne","Footscray",12
12950,2006-07-14,"R15","Richmond",7,10,52,"Melbourne",9,16,70,"M.C.G.",-18,2006,"Regular",15,"Away","Melbourne","Richmond",18
12951,2006-07-15,"R15","Essendon",10,11,71,"St Kilda",11,8,74,"M.C.G.",-3,2006,"Regular",15,"Away","St Kilda","Essendon",3
12952,2006-07-15,"R15","Adelaide",16,13,109,"Hawthorn",11,7,73,"Football Park",36,2006,"Regular",15,"Home","Adelaide","Hawthorn",36
12953,2006-07-15,"R15","North Melbourne",11,18,84,"Brisbane Lions",12,13,85,"Docklands",-1,2006,"Regular",15,"Away","Brisbane Lions","North Melbourne",1
12954,2006-07-15,"R15","West Coast",9,13,67,"Sydney",9,11,65,"Subiaco",2,2006,"Regular",15,"Home","West Coast","Sydney",2
12955,2006-07-16,"R15","Geelong",9,14,68,"Port Adelaide",8,10,58,"Kardinia Park",10,2006,"Regular",15,"Home","Geelong","Port Adelaide",10
12956,2006-07-16,"R15","Carlton",11,14,80,"Footscray",16,14,110,"Docklands",-30,2006,"Regular",15,"Away","Footscray","Carlton",30
12957,2006-07-16,"R15","Collingwood",15,14,104,"Fremantle",18,11,119,"M.C.G.",-15,2006,"Regular",15,"Away","Fremantle","Collingwood",15
12958,2006-07-21,"R16","Adelaide",19,10,124,"North Melbourne",7,10,52,"Football Park",72,2006,"Regular",16,"Home","Adelaide","North Melbourne",72
12959,2006-07-22,"R16","Essendon",16,9,105,"Carlton",15,15,105,"M.C.G.",0,2006,"Regular",16,"Home","Essendon","Carlton",0
12960,2006-07-22,"R16","Collingwood",19,13,127,"West Coast",13,12,90,"Docklands",37,2006,"Regular",16,"Home","Collingwood","West Coast",37
12961,2006-07-22,"R16","Brisbane Lions",11,18,84,"Hawthorn",11,8,74,"Gabba",10,2006,"Regular",16,"Home","Brisbane Lions","Hawthorn",10
12962,2006-07-22,"R16","Sydney",14,17,101,"Richmond",7,11,53,"S.C.G.",48,2006,"Regular",16,"Home","Sydney","Richmond",48
12963,2006-07-23,"R16","St Kilda",8,16,64,"Port Adelaide",8,12,60,"York Park",4,2006,"Regular",16,"Home","St Kilda","Port Adelaide",4
12964,2006-07-23,"R16","Geelong",13,12,90,"Footscray",13,11,89,"Docklands",1,2006,"Regular",16,"Home","Geelong","Footscray",1
12965,2006-07-23,"R16","Fremantle",15,6,96,"Melbourne",9,13,67,"Subiaco",29,2006,"Regular",16,"Home","Fremantle","Melbourne",29
12966,2006-07-28,"R17","Collingwood",16,17,113,"Hawthorn",11,2,68,"M.C.G.",45,2006,"Regular",17,"Home","Collingwood","Hawthorn",45
12967,2006-07-29,"R17","St Kilda",27,12,174,"Richmond",10,11,71,"M.C.G.",103,2006,"Regular",17,"Home","St Kilda","Richmond",103
12968,2006-07-29,"R17","West Coast",26,9,165,"Adelaide",12,11,83,"Subiaco",82,2006,"Regular",17,"Home","West Coast","Adelaide",82
12969,2006-07-29,"R17","Essendon",25,10,160,"Brisbane Lions",18,15,123,"Docklands",37,2006,"Regular",17,"Home","Essendon","Brisbane Lions",37
12970,2006-07-29,"R17","Port Adelaide",7,8,50,"Sydney",10,17,77,"Football Park",-27,2006,"Regular",17,"Away","Sydney","Port Adelaide",27
12971,2006-07-30,"R17","North Melbourne",13,12,90,"Geelong",8,12,60,"Manuka Oval",30,2006,"Regular",17,"Home","North Melbourne","Geelong",30
12972,2006-07-30,"R17","Carlton",13,11,89,"Fremantle",15,17,107,"Docklands",-18,2006,"Regular",17,"Away","Fremantle","Carlton",18
12973,2006-07-30,"R17","Melbourne",18,11,119,"Footscray",9,14,68,"M.C.G.",51,2006,"Regular",17,"Home","Melbourne","Footscray",51
12974,2006-08-04,"R18","St Kilda",8,11,59,"West Coast",14,14,98,"Docklands",-39,2006,"Regular",18,"Away","West Coast","St Kilda",39
12975,2006-08-05,"R18","Carlton",12,8,80,"Melbourne",10,13,73,"Docklands",7,2006,"Regular",18,"Home","Carlton","Melbourne",7
12976,2006-08-05,"R18","Richmond",10,18,78,"Footscray",15,10,100,"M.C.G.",-22,2006,"Regular",18,"Away","Footscray","Richmond",22
12977,2006-08-05,"R18","Sydney",17,14,116,"Essendon",11,7,73,"S.C.G.",43,2006,"Regular",18,"Home","Sydney","Essendon",43
12978,2006-08-05,"R18","Adelaide",7,16,58,"Collingwood",7,12,54,"Football Park",4,2006,"Regular",18,"Home","Adelaide","Collingwood",4
12979,2006-08-06,"R18","Brisbane Lions",13,9,87,"Geelong",14,20,104,"Gabba",-17,2006,"Regular",18,"Away","Geelong","Brisbane Lions",17
12980,2006-08-06,"R18","North Melbourne",12,12,84,"Port Adelaide",9,11,65,"Docklands",19,2006,"Regular",18,"Home","North Melbourne","Port Adelaide",19
12981,2006-08-06,"R18","Fremantle",14,20,104,"Hawthorn",7,9,51,"Subiaco",53,2006,"Regular",18,"Home","Fremantle","Hawthorn",53
12982,2006-08-11,"R19","Essendon",10,14,74,"Collingwood",9,7,61,"M.C.G.",13,2006,"Regular",19,"Home","Essendon","Collingwood",13
12983,2006-08-12,"R19","Melbourne",10,3,63,"Sydney",14,11,95,"M.C.G.",-32,2006,"Regular",19,"Away","Sydney","Melbourne",32
12984,2006-08-12,"R19","West Coast",14,23,107,"North Melbourne",12,9,81,"Subiaco",26,2006,"Regular",19,"Home","West Coast","North Melbourne",26
12985,2006-08-12,"R19","Richmond",21,16,142,"Brisbane Lions",8,12,60,"Docklands",82,2006,"Regular",19,"Home","Richmond","Brisbane Lions",82
12986,2006-08-12,"R19","Footscray",13,13,91,"Port Adelaide",14,21,105,"Marrara Oval",-14,2006,"Regular",19,"Away","Port Adelaide","Footscray",14
12987,2006-08-13,"R19","Adelaide",10,20,80,"Fremantle",13,17,95,"Football Park",-15,2006,"Regular",19,"Away","Fremantle","Adelaide",15
12988,2006-08-13,"R19","Hawthorn",17,11,113,"Carlton",13,12,90,"M.C.G.",23,2006,"Regular",19,"Home","Hawthorn","Carlton",23
12989,2006-08-13,"R19","Geelong",11,14,80,"St Kilda",15,13,103,"Docklands",-23,2006,"Regular",19,"Away","St Kilda","Geelong",23
12990,2006-08-18,"R20","Port Adelaide",12,15,87,"Collingwood",12,17,89,"Football Park",-2,2006,"Regular",20,"Away","Collingwood","Port Adelaide",2
12991,2006-08-19,"R20","Footscray",16,9,105,"Adelaide",14,14,98,"M.C.G.",7,2006,"Regular",20,"Home","Footscray","Adelaide",7
12992,2006-08-19,"R20","Geelong",14,6,90,"Sydney",9,9,63,"Kardinia Park",27,2006,"Regular",20,"Home","Geelong","Sydney",27
12993,2006-08-19,"R20","Essendon",15,16,106,"Hawthorn",19,10,124,"Docklands",-18,2006,"Regular",20,"Away","Hawthorn","Essendon",18
12994,2006-08-19,"R20","Fremantle",17,12,114,"St Kilda",7,14,56,"Subiaco",58,2006,"Regular",20,"Home","Fremantle","St Kilda",58
12995,2006-08-20,"R20","Brisbane Lions",7,10,52,"West Coast",16,18,114,"Gabba",-62,2006,"Regular",20,"Away","West Coast","Brisbane Lions",62
12996,2006-08-20,"R20","Carlton",14,11,95,"Richmond",21,14,140,"Docklands",-45,2006,"Regular",20,"Away","Richmond","Carlton",45
12997,2006-08-20,"R20","North Melbourne",12,10,82,"Melbourne",20,12,132,"M.C.G.",-50,2006,"Regular",20,"Away","Melbourne","North Melbourne",50
12998,2006-08-25,"R21","Footscray",13,14,92,"St Kilda",22,10,142,"Docklands",-50,2006,"Regular",21,"Away","St Kilda","Footscray",50
12999,2006-08-26,"R21","Geelong",14,10,94,"Melbourne",14,10,94,"Kardinia Park",0,2006,"Regular",21,"Home","Geelong","Melbourne",0
13000,2006-08-26,"R21","Hawthorn",7,16,58,"North Melbourne",4,12,36,"York Park",22,2006,"Regular",21,"Home","Hawthorn","North Melbourne",22
13001,2006-08-26,"R21","Richmond",20,9,129,"Essendon",16,17,113,"M.C.G.",16,2006,"Regular",21,"Home","Richmond","Essendon",16
13002,2006-08-26,"R21","Sydney",14,13,97,"Brisbane Lions",6,4,40,"Stadium Australia",57,2006,"Regular",21,"Home","Sydney","Brisbane Lions",57
13003,2006-08-27,"R21","Port Adelaide",14,11,95,"Adelaide",11,15,81,"Football Park",14,2006,"Regular",21,"Home","Port Adelaide","Adelaide",14
13004,2006-08-27,"R21","Collingwood",24,12,156,"Carlton",17,10,112,"M.C.G.",44,2006,"Regular",21,"Home","Collingwood","Carlton",44
13005,2006-08-27,"R21","West Coast",8,13,61,"Fremantle",18,10,118,"Subiaco",-57,2006,"Regular",21,"Away","Fremantle","West Coast",57
13006,2006-09-01,"R22","Footscray",22,15,147,"Essendon",18,17,125,"Docklands",22,2006,"Regular",22,"Home","Footscray","Essendon",22
13007,2006-09-02,"R22","Richmond",12,13,85,"West Coast",26,17,173,"M.C.G.",-88,2006,"Regular",22,"Away","West Coast","Richmond",88
13008,2006-09-02,"R22","Adelaide",23,14,152,"Melbourne",14,10,94,"Football Park",58,2006,"Regular",22,"Home","Adelaide","Melbourne",58
13009,2006-09-02,"R22","Brisbane Lions",7,15,57,"St Kilda",16,12,108,"Gabba",-51,2006,"Regular",22,"Away","St Kilda","Brisbane Lions",51
13010,2006-09-02,"R22","Fremantle",23,13,151,"Port Adelaide",9,18,72,"Subiaco",79,2006,"Regular",22,"Home","Fremantle","Port Adelaide",79
13011,2006-09-03,"R22","Sydney",21,10,136,"Carlton",6,8,44,"S.C.G.",92,2006,"Regular",22,"Home","Sydney","Carlton",92
13012,2006-09-03,"R22","Collingwood",20,19,139,"North Melbourne",10,11,71,"M.C.G.",68,2006,"Regular",22,"Home","Collingwood","North Melbourne",68
13013,2006-09-03,"R22","Hawthorn",21,7,133,"Geelong",10,12,72,"Docklands",61,2006,"Regular",22,"Home","Hawthorn","Geelong",61
13014,2006-09-08,"EF","St Kilda",10,12,72,"Melbourne",13,12,90,"M.C.G.",-18,2006,"Finals",23,"Away","Melbourne","St Kilda",18
13015,2006-09-09,"QF","Adelaide",10,16,76,"Fremantle",7,4,46,"Football Park",30,2006,"Finals",23,"Home","Adelaide","Fremantle",30
13016,2006-09-09,"QF","West Coast",12,12,84,"Sydney",13,7,85,"Subiaco",-1,2006,"Finals",23,"Away","Sydney","West Coast",1
13017,2006-09-10,"EF","Collingwood",11,14,80,"Footscray",18,13,121,"M.C.G.",-41,2006,"Finals",23,"Away","Footscray","Collingwood",41
13018,2006-09-15,"SF","Fremantle",14,18,102,"Melbourne",11,8,74,"Subiaco",28,2006,"Finals",24,"Home","Fremantle","Melbourne",28
13019,2006-09-16,"SF","West Coast",16,17,113,"Footscray",5,9,39,"Subiaco",74,2006,"Finals",24,"Home","West Coast","Footscray",74
13020,2006-09-22,"PF","Sydney",19,13,127,"Fremantle",14,8,92,"Stadium Australia",35,2006,"Finals",25,"Home","Sydney","Fremantle",35
13021,2006-09-23,"PF","Adelaide",11,9,75,"West Coast",11,19,85,"Football Park",-10,2006,"Finals",25,"Away","West Coast","Adelaide",10
13022,2006-09-30,"GF","West Coast",12,13,85,"Sydney",12,12,84,"M.C.G.",1,2006,"Finals",26,"Home","West Coast","Sydney",1
13023,2007-03-30,"R1","Melbourne",9,8,62,"St Kilda",13,15,93,"M.C.G.",-31,2007,"Regular",1,"Away","St Kilda","Melbourne",31
13024,2007-03-31,"R1","North Melbourne",10,19,79,"Collingwood",12,10,82,"M.C.G.",-3,2007,"Regular",1,"Away","Collingwood","North Melbourne",3
13025,2007-03-31,"R1","Fremantle",16,9,105,"Port Adelaide",19,7,121,"Subiaco",-16,2007,"Regular",1,"Away","Port Adelaide","Fremantle",16
13026,2007-03-31,"R1","Brisbane Lions",9,15,69,"Hawthorn",6,8,44,"Gabba",25,2007,"Regular",1,"Home","Brisbane Lions","Hawthorn",25
13027,2007-03-31,"R1","Sydney",10,13,73,"West Coast",11,8,74,"Stadium Australia",-1,2007,"Regular",1,"Away","West Coast","Sydney",1
13028,2007-04-01,"R1","Adelaide",10,14,74,"Essendon",16,9,105,"Football Park",-31,2007,"Regular",1,"Away","Essendon","Adelaide",31
13029,2007-04-01,"R1","Footscray",17,11,113,"Geelong",13,15,93,"Docklands",20,2007,"Regular",1,"Home","Footscray","Geelong",20
13030,2007-04-01,"R1","Carlton",15,25,115,"Richmond",15,8,98,"M.C.G.",17,2007,"Regular",1,"Home","Carlton","Richmond",17
13031,2007-04-05,"R2","Brisbane Lions",15,12,102,"St Kilda",7,8,50,"Gabba",52,2007,"Regular",2,"Home","Brisbane Lions","St Kilda",52
13032,2007-04-07,"R2","Richmond",11,6,72,"Sydney",13,10,88,"M.C.G.",-16,2007,"Regular",2,"Away","Sydney","Richmond",16
13033,2007-04-07,"R2","Geelong",24,18,162,"Carlton",12,12,84,"Docklands",78,2007,"Regular",2,"Home","Geelong","Carlton",78
13034,2007-04-07,"R2","West Coast",12,15,87,"Collingwood",11,9,75,"Subiaco",12,2007,"Regular",2,"Home","West Coast","Collingwood",12
13035,2007-04-08,"R2","Port Adelaide",17,20,122,"North Melbourne",15,14,104,"Football Park",18,2007,"Regular",2,"Home","Port Adelaide","North Melbourne",18
13036,2007-04-08,"R2","Essendon",19,8,122,"Fremantle",17,10,112,"Docklands",10,2007,"Regular",2,"Home","Essendon","Fremantle",10
13037,2007-04-08,"R2","Footscray",11,6,72,"Adelaide",16,14,110,"M.C.G.",-38,2007,"Regular",2,"Away","Adelaide","Footscray",38
13038,2007-04-09,"R2","Hawthorn",17,14,116,"Melbourne",14,10,94,"M.C.G.",22,2007,"Regular",2,"Home","Hawthorn","Melbourne",22
13039,2007-04-13,"R3","Collingwood",17,13,115,"Richmond",13,12,90,"M.C.G.",25,2007,"Regular",3,"Home","Collingwood","Richmond",25
13040,2007-04-14,"R3","Carlton",18,17,125,"Essendon",17,20,122,"M.C.G.",3,2007,"Regular",3,"Home","Carlton","Essendon",3
13041,2007-04-14,"R3","Port Adelaide",8,15,63,"Adelaide",13,9,87,"Football Park",-24,2007,"Regular",3,"Away","Adelaide","Port Adelaide",24
13042,2007-04-14,"R3","St Kilda",17,14,116,"Footscray",9,12,66,"Docklands",50,2007,"Regular",3,"Home","St Kilda","Footscray",50
13043,2007-04-14,"R3","Fremantle",11,4,70,"West Coast",14,17,101,"Subiaco",-31,2007,"Regular",3,"Away","West Coast","Fremantle",31
13044,2007-04-15,"R3","Sydney",13,18,96,"Brisbane Lions",10,9,69,"S.C.G.",27,2007,"Regular",3,"Home","Sydney","Brisbane Lions",27
13045,2007-04-15,"R3","Melbourne",8,9,57,"Geelong",15,19,109,"M.C.G.",-52,2007,"Regular",3,"Away","Geelong","Melbourne",52
13046,2007-04-15,"R3","North Melbourne",10,10,70,"Hawthorn",13,13,91,"Docklands",-21,2007,"Regular",3,"Away","Hawthorn","North Melbourne",21
13047,2007-04-20,"R4","Richmond",14,16,100,"Footscray",20,12,132,"M.C.G.",-32,2007,"Regular",4,"Away","Footscray","Richmond",32
13048,2007-04-21,"R4","Collingwood",9,12,66,"Port Adelaide",12,12,84,"M.C.G.",-18,2007,"Regular",4,"Away","Port Adelaide","Collingwood",18
13049,2007-04-21,"R4","St Kilda",9,14,68,"Essendon",15,9,99,"Docklands",-31,2007,"Regular",4,"Away","Essendon","St Kilda",31
13050,2007-04-21,"R4","North Melbourne",12,15,87,"Brisbane Lions",8,15,63,"Carrara",24,2007,"Regular",4,"Home","North Melbourne","Brisbane Lions",24
13051,2007-04-21,"R4","Adelaide",9,7,61,"Sydney",5,14,44,"Football Park",17,2007,"Regular",4,"Home","Adelaide","Sydney",17
13052,2007-04-22,"R4","Hawthorn",10,16,76,"Geelong",9,18,72,"York Park",4,2007,"Regular",4,"Home","Hawthorn","Geelong",4
13053,2007-04-22,"R4","Melbourne",13,14,92,"Fremantle",21,11,137,"M.C.G.",-45,2007,"Regular",4,"Away","Fremantle","Melbourne",45
13054,2007-04-22,"R4","West Coast",14,16,100,"Carlton",4,15,39,"Subiaco",61,2007,"Regular",4,"Home","West Coast","Carlton",61
13055,2007-04-25,"R5","Essendon",11,13,79,"Collingwood",12,23,95,"M.C.G.",-16,2007,"Regular",5,"Away","Collingwood","Essendon",16
13056,2007-04-27,"R5","Port Adelaide",14,12,96,"St Kilda",6,7,43,"Football Park",53,2007,"Regular",5,"Home","Port Adelaide","St Kilda",53
13057,2007-04-28,"R5","Richmond",11,10,76,"West Coast",14,15,99,"M.C.G.",-23,2007,"Regular",5,"Away","West Coast","Richmond",23
13058,2007-04-28,"R5","Carlton",18,16,124,"Brisbane Lions",21,10,136,"Docklands",-12,2007,"Regular",5,"Away","Brisbane Lions","Carlton",12
13059,2007-04-28,"R5","Sydney",17,7,109,"Melbourne",8,12,60,"S.C.G.",49,2007,"Regular",5,"Home","Sydney","Melbourne",49
13060,2007-04-29,"R5","Hawthorn",13,15,93,"Footscray",16,14,110,"M.C.G.",-17,2007,"Regular",5,"Away","Footscray","Hawthorn",17
13061,2007-04-29,"R5","Geelong",15,12,102,"North Melbourne",18,10,118,"Kardinia Park",-16,2007,"Regular",5,"Away","North Melbourne","Geelong",16
13062,2007-04-29,"R5","Fremantle",7,16,58,"Adelaide",8,9,57,"Subiaco",1,2007,"Regular",5,"Home","Fremantle","Adelaide",1
13063,2007-05-04,"R6","St Kilda",18,17,125,"Carlton",11,16,82,"Docklands",43,2007,"Regular",6,"Home","St Kilda","Carlton",43
13064,2007-05-05,"R6","Essendon",15,6,96,"Hawthorn",20,11,131,"M.C.G.",-35,2007,"Regular",6,"Away","Hawthorn","Essendon",35
13065,2007-05-05,"R6","West Coast",10,17,77,"Footscray",9,8,62,"Subiaco",15,2007,"Regular",6,"Home","West Coast","Footscray",15
13066,2007-05-05,"R6","North Melbourne",16,15,111,"Sydney",14,11,95,"Docklands",16,2007,"Regular",6,"Home","North Melbourne","Sydney",16
13067,2007-05-05,"R6","Adelaide",9,8,62,"Collingwood",11,20,86,"Football Park",-24,2007,"Regular",6,"Away","Collingwood","Adelaide",24
13068,2007-05-06,"R6","Brisbane Lions",17,18,120,"Fremantle",10,15,75,"Gabba",45,2007,"Regular",6,"Home","Brisbane Lions","Fremantle",45
13069,2007-05-06,"R6","Melbourne",9,17,71,"Port Adelaide",10,16,76,"M.C.G.",-5,2007,"Regular",6,"Away","Port Adelaide","Melbourne",5
13070,2007-05-06,"R6","Richmond",9,11,65,"Geelong",35,12,222,"Docklands",-157,2007,"Regular",6,"Away","Geelong","Richmond",157
13071,2007-05-11,"R7","North Melbourne",18,9,117,"Essendon",13,17,95,"Docklands",22,2007,"Regular",7,"Home","North Melbourne","Essendon",22
13072,2007-05-12,"R7","Collingwood",17,17,119,"Carlton",14,11,95,"M.C.G.",24,2007,"Regular",7,"Home","Collingwood","Carlton",24
13073,2007-05-12,"R7","Port Adelaide",16,19,115,"Richmond",10,15,75,"Football Park",40,2007,"Regular",7,"Home","Port Adelaide","Richmond",40
13074,2007-05-12,"R7","Brisbane Lions",9,15,69,"Adelaide",14,16,100,"Gabba",-31,2007,"Regular",7,"Away","Adelaide","Brisbane Lions",31
13075,2007-05-12,"R7","St Kilda",15,7,97,"Sydney",11,5,71,"Docklands",26,2007,"Regular",7,"Home","St Kilda","Sydney",26
13076,2007-05-13,"R7","Geelong",16,13,109,"West Coast",10,10,70,"Kardinia Park",39,2007,"Regular",7,"Home","Geelong","West Coast",39
13077,2007-05-13,"R7","Footscray",16,16,112,"Melbourne",16,10,106,"Docklands",6,2007,"Regular",7,"Home","Footscray","Melbourne",6
13078,2007-05-13,"R7","Fremantle",14,12,96,"Hawthorn",11,14,80,"Subiaco",16,2007,"Regular",7,"Home","Fremantle","Hawthorn",16
13079,2007-05-18,"R8","Adelaide",14,15,99,"Richmond",14,6,90,"Football Park",9,2007,"Regular",8,"Home","Adelaide","Richmond",9
13080,2007-05-19,"R8","Essendon",18,19,127,"Brisbane Lions",8,15,63,"Docklands",64,2007,"Regular",8,"Home","Essendon","Brisbane Lions",64
13081,2007-05-19,"R8","Geelong",14,10,94,"Fremantle",10,9,69,"Kardinia Park",25,2007,"Regular",8,"Home","Geelong","Fremantle",25
13082,2007-05-19,"R8","North Melbourne",22,15,147,"Carlton",20,10,130,"Carrara",17,2007,"Regular",8,"Home","North Melbourne","Carlton",17
13083,2007-05-19,"R8","Hawthorn",10,12,72,"St Kilda",6,8,44,"M.C.G.",28,2007,"Regular",8,"Home","Hawthorn","St Kilda",28
13084,2007-05-20,"R8","Sydney",17,16,118,"Port Adelaide",13,9,87,"S.C.G.",31,2007,"Regular",8,"Home","Sydney","Port Adelaide",31
13085,2007-05-20,"R8","Footscray",20,15,135,"Collingwood",14,18,102,"Docklands",33,2007,"Regular",8,"Home","Footscray","Collingwood",33
13086,2007-05-20,"R8","West Coast",19,23,137,"Melbourne",9,6,60,"Subiaco",77,2007,"Regular",8,"Home","West Coast","Melbourne",77
13087,2007-05-25,"R9","Fremantle",15,11,101,"St Kilda",6,19,55,"Subiaco",46,2007,"Regular",9,"Home","Fremantle","St Kilda",46
13088,2007-05-26,"R9","Carlton",12,14,86,"Adelaide",15,15,105,"Docklands",-19,2007,"Regular",9,"Away","Adelaide","Carlton",19
13089,2007-05-26,"R9","Hawthorn",15,9,99,"West Coast",8,16,64,"York Park",35,2007,"Regular",9,"Home","Hawthorn","West Coast",35
13090,2007-05-26,"R9","Brisbane Lions",13,9,87,"Collingwood",18,12,120,"Gabba",-33,2007,"Regular",9,"Away","Collingwood","Brisbane Lions",33
13091,2007-05-26,"R9","Richmond",12,12,84,"Essendon",12,20,92,"M.C.G.",-8,2007,"Regular",9,"Away","Essendon","Richmond",8
13092,2007-05-27,"R9","Footscray",8,9,57,"Sydney",15,10,100,"Manuka Oval",-43,2007,"Regular",9,"Away","Sydney","Footscray",43
13093,2007-05-27,"R9","Melbourne",11,12,78,"North Melbourne",10,19,79,"M.C.G.",-1,2007,"Regular",9,"Away","North Melbourne","Melbourne",1
13094,2007-05-27,"R9","Port Adelaide",8,12,60,"Geelong",16,20,116,"Football Park",-56,2007,"Regular",9,"Away","Geelong","Port Adelaide",56
13095,2007-06-01,"R10","Collingwood",15,13,103,"Fremantle",13,16,94,"M.C.G.",9,2007,"Regular",10,"Home","Collingwood","Fremantle",9
13096,2007-06-02,"R10","Melbourne",13,11,89,"Adelaide",10,12,72,"M.C.G.",17,2007,"Regular",10,"Home","Melbourne","Adelaide",17
13097,2007-06-02,"R10","West Coast",18,13,121,"North Melbourne",7,13,55,"Subiaco",66,2007,"Regular",10,"Home","West Coast","North Melbourne",66
13098,2007-06-02,"R10","Sydney",11,7,73,"Essendon",11,8,74,"S.C.G.",-1,2007,"Regular",10,"Away","Essendon","Sydney",1
13099,2007-06-02,"R10","Richmond",10,13,73,"Brisbane Lions",10,13,73,"Docklands",0,2007,"Regular",10,"Home","Richmond","Brisbane Lions",0
13100,2007-06-03,"R10","Port Adelaide",10,15,75,"Hawthorn",17,7,109,"Football Park",-34,2007,"Regular",10,"Away","Hawthorn","Port Adelaide",34
13101,2007-06-03,"R10","Carlton",21,12,138,"Footscray",19,14,128,"M.C.G.",10,2007,"Regular",10,"Home","Carlton","Footscray",10
13102,2007-06-03,"R10","St Kilda",9,11,65,"Geelong",19,11,125,"Docklands",-60,2007,"Regular",10,"Away","Geelong","St Kilda",60
13103,2007-06-08,"R11","Essendon",15,5,95,"West Coast",14,10,94,"Docklands",1,2007,"Regular",11,"Home","Essendon","West Coast",1
13104,2007-06-09,"R11","Hawthorn",9,12,66,"Sydney",11,9,75,"M.C.G.",-9,2007,"Regular",11,"Away","Sydney","Hawthorn",9
13105,2007-06-09,"R11","Carlton",22,9,141,"Port Adelaide",14,18,102,"Docklands",39,2007,"Regular",11,"Home","Carlton","Port Adelaide",39
13106,2007-06-09,"R11","Brisbane Lions",10,12,72,"Footscray",13,17,95,"Gabba",-23,2007,"Regular",11,"Away","Footscray","Brisbane Lions",23
13107,2007-06-10,"R11","Adelaide",9,8,62,"Geelong",9,15,69,"Football Park",-7,2007,"Regular",11,"Away","Geelong","Adelaide",7
13108,2007-06-10,"R11","St Kilda",8,10,58,"North Melbourne",11,14,80,"Docklands",-22,2007,"Regular",11,"Away","North Melbourne","St Kilda",22
13109,2007-06-10,"R11","Fremantle",18,15,123,"Richmond",15,12,102,"Subiaco",21,2007,"Regular",11,"Home","Fremantle","Richmond",21
13110,2007-06-11,"R11","Melbourne",13,16,94,"Collingwood",11,15,81,"M.C.G.",13,2007,"Regular",11,"Home","Melbourne","Collingwood",13
13111,2007-06-15,"R12","Carlton",12,8,80,"Hawthorn",27,18,180,"Docklands",-100,2007,"Regular",12,"Away","Hawthorn","Carlton",100
13112,2007-06-16,"R12","North Melbourne",7,12,54,"Adelaide",15,10,100,"Carrara",-46,2007,"Regular",12,"Away","Adelaide","North Melbourne",46
13113,2007-06-16,"R12","Footscray",22,9,141,"Fremantle",16,19,115,"Marrara Oval",26,2007,"Regular",12,"Home","Footscray","Fremantle",26
13114,2007-06-17,"R12","Geelong",12,13,85,"Brisbane Lions",5,5,35,"Kardinia Park",50,2007,"Regular",12,"Home","Geelong","Brisbane Lions",50
13115,2007-06-17,"R12","Port Adelaide",19,12,126,"Essendon",13,17,95,"Football Park",31,2007,"Regular",12,"Home","Port Adelaide","Essendon",31
13116,2007-06-22,"R12","Richmond",18,16,124,"Melbourne",11,9,75,"M.C.G.",49,2007,"Regular",12,"Home","Richmond","Melbourne",49
13117,2007-06-23,"R12","Sydney",8,9,57,"Collingwood",10,16,76,"Stadium Australia",-19,2007,"Regular",12,"Away","Collingwood","Sydney",19
13118,2007-06-24,"R12","West Coast",11,10,76,"St Kilda",15,9,99,"Subiaco",-23,2007,"Regular",12,"Away","St Kilda","West Coast",23
13119,2007-06-29,"R13","Essendon",19,11,125,"Melbourne",18,15,123,"Docklands",2,2007,"Regular",13,"Home","Essendon","Melbourne",2
13120,2007-06-30,"R13","Geelong",13,9,87,"Sydney",10,9,69,"Kardinia Park",18,2007,"Regular",13,"Home","Geelong","Sydney",18
13121,2007-06-30,"R13","Fremantle",27,11,173,"Carlton",13,18,96,"Subiaco",77,2007,"Regular",13,"Home","Fremantle","Carlton",77
13122,2007-06-30,"R13","Brisbane Lions",15,15,105,"Port Adelaide",17,10,112,"Gabba",-7,2007,"Regular",13,"Away","Port Adelaide","Brisbane Lions",7
13123,2007-06-30,"R13","St Kilda",17,15,117,"Richmond",15,10,100,"Docklands",17,2007,"Regular",13,"Home","St Kilda","Richmond",17
13124,2007-07-01,"R13","Adelaide",10,14,74,"West Coast",14,11,95,"Football Park",-21,2007,"Regular",13,"Away","West Coast","Adelaide",21
13125,2007-07-01,"R13","North Melbourne",17,9,111,"Footscray",11,19,85,"M.C.G.",26,2007,"Regular",13,"Home","North Melbourne","Footscray",26
13126,2007-07-01,"R13","Collingwood",12,15,87,"Hawthorn",15,5,95,"Docklands",-8,2007,"Regular",13,"Away","Hawthorn","Collingwood",8
13127,2007-07-06,"R14","Essendon",12,11,83,"Geelong",19,19,133,"Docklands",-50,2007,"Regular",14,"Away","Geelong","Essendon",50
13128,2007-07-07,"R14","Collingwood",12,17,89,"St Kilda",12,8,80,"M.C.G.",9,2007,"Regular",14,"Home","Collingwood","St Kilda",9
13129,2007-07-07,"R14","Footscray",20,13,133,"Port Adelaide",17,11,113,"Docklands",20,2007,"Regular",14,"Home","Footscray","Port Adelaide",20
13130,2007-07-07,"R14","Adelaide",15,12,102,"Hawthorn",4,7,31,"Football Park",71,2007,"Regular",14,"Home","Adelaide","Hawthorn",71
13131,2007-07-07,"R14","West Coast",9,10,64,"Brisbane Lions",13,13,91,"Subiaco",-27,2007,"Regular",14,"Away","Brisbane Lions","West Coast",27
13132,2007-07-08,"R14","Sydney",11,23,89,"Fremantle",9,7,61,"S.C.G.",28,2007,"Regular",14,"Home","Sydney","Fremantle",28
13133,2007-07-08,"R14","Carlton",14,17,101,"Melbourne",19,10,124,"M.C.G.",-23,2007,"Regular",14,"Away","Melbourne","Carlton",23
13134,2007-07-08,"R14","Richmond",11,13,79,"North Melbourne",14,20,104,"Docklands",-25,2007,"Regular",14,"Away","North Melbourne","Richmond",25
13135,2007-07-13,"R15","St Kilda",11,16,82,"Adelaide",12,8,80,"Docklands",2,2007,"Regular",15,"Home","St Kilda","Adelaide",2
13136,2007-07-14,"R15","Geelong",11,14,80,"Collingwood",9,10,64,"M.C.G.",16,2007,"Regular",15,"Home","Geelong","Collingwood",16
13137,2007-07-14,"R15","Port Adelaide",22,21,153,"West Coast",9,8,62,"Football Park",91,2007,"Regular",15,"Home","Port Adelaide","West Coast",91
13138,2007-07-14,"R15","Essendon",14,14,98,"Footscray",20,11,131,"Docklands",-33,2007,"Regular",15,"Away","Footscray","Essendon",33
13139,2007-07-14,"R15","Melbourne",12,10,82,"Brisbane Lions",18,18,126,"Gabba",-44,2007,"Regular",15,"Away","Brisbane Lions","Melbourne",44
13140,2007-07-15,"R15","Sydney",25,12,162,"Carlton",15,10,100,"S.C.G.",62,2007,"Regular",15,"Home","Sydney","Carlton",62
13141,2007-07-15,"R15","Hawthorn",19,15,129,"Richmond",11,10,76,"M.C.G.",53,2007,"Regular",15,"Home","Hawthorn","Richmond",53
13142,2007-07-15,"R15","Fremantle",11,12,78,"North Melbourne",12,10,82,"Subiaco",-4,2007,"Regular",15,"Away","North Melbourne","Fremantle",4
13143,2007-07-20,"R16","Geelong",20,18,138,"Footscray",9,9,63,"Docklands",75,2007,"Regular",16,"Home","Geelong","Footscray",75
13144,2007-07-21,"R16","Collingwood",18,14,122,"Essendon",14,9,93,"M.C.G.",29,2007,"Regular",16,"Home","Collingwood","Essendon",29
13145,2007-07-21,"R16","Adelaide",15,11,101,"Fremantle",20,6,126,"Football Park",-25,2007,"Regular",16,"Away","Fremantle","Adelaide",25
13146,2007-07-21,"R16","St Kilda",14,11,95,"Hawthorn",11,12,78,"Docklands",17,2007,"Regular",16,"Home","St Kilda","Hawthorn",17
13147,2007-07-21,"R16","West Coast",16,16,112,"Sydney",15,10,100,"Subiaco",12,2007,"Regular",16,"Home","West Coast","Sydney",12
13148,2007-07-22,"R16","Brisbane Lions",25,13,163,"Carlton",6,10,46,"Gabba",117,2007,"Regular",16,"Home","Brisbane Lions","Carlton",117
13149,2007-07-22,"R16","Richmond",15,10,100,"Port Adelaide",24,11,155,"M.C.G.",-55,2007,"Regular",16,"Away","Port Adelaide","Richmond",55
13150,2007-07-22,"R16","North Melbourne",19,12,126,"Melbourne",9,8,62,"Docklands",64,2007,"Regular",16,"Home","North Melbourne","Melbourne",64
13151,2007-07-27,"R17","Footscray",9,17,71,"West Coast",24,14,158,"Docklands",-87,2007,"Regular",17,"Away","West Coast","Footscray",87
13152,2007-07-28,"R17","Carlton",15,11,101,"St Kilda",16,15,111,"Docklands",-10,2007,"Regular",17,"Away","St Kilda","Carlton",10
13153,2007-07-28,"R17","Fremantle",10,12,72,"Geelong",20,20,140,"Subiaco",-68,2007,"Regular",17,"Away","Geelong","Fremantle",68
13154,2007-07-28,"R17","Collingwood",7,14,56,"Brisbane Lions",22,17,149,"M.C.G.",-93,2007,"Regular",17,"Away","Brisbane Lions","Collingwood",93
13155,2007-07-28,"R17","Sydney",21,12,138,"Richmond",10,12,72,"S.C.G.",66,2007,"Regular",17,"Home","Sydney","Richmond",66
13156,2007-07-29,"R17","Hawthorn",10,11,71,"North Melbourne",16,12,108,"York Park",-37,2007,"Regular",17,"Away","North Melbourne","Hawthorn",37
13157,2007-07-29,"R17","Essendon",18,9,117,"Adelaide",16,9,105,"Docklands",12,2007,"Regular",17,"Home","Essendon","Adelaide",12
13158,2007-07-29,"R17","Port Adelaide",25,13,163,"Melbourne",11,8,74,"Football Park",89,2007,"Regular",17,"Home","Port Adelaide","Melbourne",89
13159,2007-08-03,"R18","Footscray",12,13,85,"St Kilda",12,13,85,"Docklands",0,2007,"Regular",18,"Home","Footscray","St Kilda",0
13160,2007-08-04,"R18","Carlton",14,12,96,"Collingwood",18,12,120,"M.C.G.",-24,2007,"Regular",18,"Away","Collingwood","Carlton",24
13161,2007-08-04,"R18","Geelong",21,13,139,"Richmond",11,3,69,"Kardinia Park",70,2007,"Regular",18,"Home","Geelong","Richmond",70
13162,2007-08-04,"R18","Brisbane Lions",10,17,77,"North Melbourne",5,10,40,"Gabba",37,2007,"Regular",18,"Home","Brisbane Lions","North Melbourne",37
13163,2007-08-04,"R18","Adelaide",9,19,73,"Port Adelaide",10,5,65,"Football Park",8,2007,"Regular",18,"Home","Adelaide","Port Adelaide",8
13164,2007-08-05,"R18","Melbourne",9,10,64,"Sydney",17,10,112,"Manuka Oval",-48,2007,"Regular",18,"Away","Sydney","Melbourne",48
13165,2007-08-05,"R18","Hawthorn",17,17,119,"Essendon",7,14,56,"M.C.G.",63,2007,"Regular",18,"Home","Hawthorn","Essendon",63
13166,2007-08-05,"R18","West Coast",14,13,97,"Fremantle",19,10,124,"Subiaco",-27,2007,"Regular",18,"Away","Fremantle","West Coast",27
13167,2007-08-10,"R19","Richmond",18,8,116,"Collingwood",14,12,96,"M.C.G.",20,2007,"Regular",19,"Home","Richmond","Collingwood",20
13168,2007-08-11,"R19","Hawthorn",17,13,115,"Brisbane Lions",13,13,91,"M.C.G.",24,2007,"Regular",19,"Home","Hawthorn","Brisbane Lions",24
13169,2007-08-11,"R19","Port Adelaide",17,14,116,"Carlton",14,9,93,"Football Park",23,2007,"Regular",19,"Home","Port Adelaide","Carlton",23
13170,2007-08-11,"R19","Melbourne",19,15,129,"Footscray",12,15,87,"Docklands",42,2007,"Regular",19,"Home","Melbourne","Footscray",42
13171,2007-08-11,"R19","Sydney",12,10,82,"St Kilda",9,11,65,"Stadium Australia",17,2007,"Regular",19,"Home","Sydney","St Kilda",17
13172,2007-08-12,"R19","North Melbourne",15,12,102,"West Coast",17,17,119,"Docklands",-17,2007,"Regular",19,"Away","West Coast","North Melbourne",17
13173,2007-08-12,"R19","Geelong",15,13,103,"Adelaide",10,10,70,"Kardinia Park",33,2007,"Regular",19,"Home","Geelong","Adelaide",33
13174,2007-08-12,"R19","Fremantle",21,14,140,"Essendon",11,11,77,"Subiaco",63,2007,"Regular",19,"Home","Fremantle","Essendon",63
13175,2007-08-17,"R20","Collingwood",11,15,81,"Melbourne",9,16,70,"M.C.G.",11,2007,"Regular",20,"Home","Collingwood","Melbourne",11
13176,2007-08-18,"R20","Essendon",18,10,118,"Carlton",16,12,108,"M.C.G.",10,2007,"Regular",20,"Home","Essendon","Carlton",10
13177,2007-08-18,"R20","St Kilda",19,12,126,"Fremantle",14,12,96,"Docklands",30,2007,"Regular",20,"Home","St Kilda","Fremantle",30
13178,2007-08-18,"R20","Brisbane Lions",9,9,63,"Sydney",8,15,63,"Gabba",0,2007,"Regular",20,"Home","Brisbane Lions","Sydney",0
13179,2007-08-18,"R20","West Coast",18,9,117,"Richmond",12,14,86,"Subiaco",31,2007,"Regular",20,"Home","West Coast","Richmond",31
13180,2007-08-19,"R20","Hawthorn",12,10,82,"Port Adelaide",12,15,87,"York Park",-5,2007,"Regular",20,"Away","Port Adelaide","Hawthorn",5
13181,2007-08-19,"R20","North Melbourne",13,13,91,"Geelong",17,16,118,"Docklands",-27,2007,"Regular",20,"Away","Geelong","North Melbourne",27
13182,2007-08-19,"R20","Adelaide",15,17,107,"Footscray",11,7,73,"Football Park",34,2007,"Regular",20,"Home","Adelaide","Footscray",34
13183,2007-08-24,"R21","St Kilda",14,14,98,"West Coast",16,10,106,"Docklands",-8,2007,"Regular",21,"Away","West Coast","St Kilda",8
13184,2007-08-25,"R21","Carlton",11,13,79,"North Melbourne",24,17,161,"Docklands",-82,2007,"Regular",21,"Away","North Melbourne","Carlton",82
13185,2007-08-25,"R21","Fremantle",22,12,144,"Melbourne",12,13,85,"Subiaco",59,2007,"Regular",21,"Home","Fremantle","Melbourne",59
13186,2007-08-25,"R21","Collingwood",15,11,101,"Sydney",11,10,76,"M.C.G.",25,2007,"Regular",21,"Home","Collingwood","Sydney",25
13187,2007-08-25,"R21","Adelaide",12,14,86,"Brisbane Lions",8,12,60,"Football Park",26,2007,"Regular",21,"Home","Adelaide","Brisbane Lions",26
13188,2007-08-26,"R21","Footscray",10,7,67,"Hawthorn",22,19,151,"Docklands",-84,2007,"Regular",21,"Away","Hawthorn","Footscray",84
13189,2007-08-26,"R21","Geelong",15,11,101,"Port Adelaide",16,10,106,"Kardinia Park",-5,2007,"Regular",21,"Away","Port Adelaide","Geelong",5
13190,2007-08-26,"R21","Essendon",13,14,92,"Richmond",17,17,119,"M.C.G.",-27,2007,"Regular",21,"Away","Richmond","Essendon",27
13191,2007-08-31,"R22","Collingwood",11,9,75,"Adelaide",14,10,94,"Docklands",-19,2007,"Regular",22,"Away","Adelaide","Collingwood",19
13192,2007-09-01,"R22","Richmond",13,14,92,"St Kilda",14,18,102,"M.C.G.",-10,2007,"Regular",22,"Away","St Kilda","Richmond",10
13193,2007-09-01,"R22","West Coast",21,6,132,"Essendon",19,10,124,"Subiaco",8,2007,"Regular",22,"Home","West Coast","Essendon",8
13194,2007-09-01,"R22","Brisbane Lions",15,13,103,"Geelong",22,13,145,"Gabba",-42,2007,"Regular",22,"Away","Geelong","Brisbane Lions",42
13195,2007-09-01,"R22","Port Adelaide",17,15,117,"Fremantle",12,13,85,"Football Park",32,2007,"Regular",22,"Home","Port Adelaide","Fremantle",32
13196,2007-09-02,"R22","Sydney",22,9,141,"Hawthorn",10,9,69,"S.C.G.",72,2007,"Regular",22,"Home","Sydney","Hawthorn",72
13197,2007-09-02,"R22","Footscray",14,9,93,"North Melbourne",23,19,157,"Docklands",-64,2007,"Regular",22,"Away","North Melbourne","Footscray",64
13198,2007-09-02,"R22","Melbourne",21,13,139,"Carlton",15,18,108,"M.C.G.",31,2007,"Regular",22,"Home","Melbourne","Carlton",31
13199,2007-09-07,"QF","Port Adelaide",9,14,68,"West Coast",9,11,65,"Football Park",3,2007,"Finals",23,"Home","Port Adelaide","West Coast",3
13200,2007-09-08,"EF","Hawthorn",15,15,105,"Adelaide",15,12,102,"Docklands",3,2007,"Finals",23,"Home","Hawthorn","Adelaide",3
13201,2007-09-08,"EF","Collingwood",18,17,125,"Sydney",13,9,87,"M.C.G.",38,2007,"Finals",23,"Home","Collingwood","Sydney",38
13202,2007-09-09,"QF","Geelong",23,18,156,"North Melbourne",8,2,50,"M.C.G.",106,2007,"Finals",23,"Home","Geelong","North Melbourne",106
13203,2007-09-14,"SF","West Coast",10,14,74,"Collingwood",13,15,93,"Subiaco",-19,2007,"Finals",24,"Away","Collingwood","West Coast",19
13204,2007-09-15,"SF","North Melbourne",14,9,93,"Hawthorn",8,12,60,"M.C.G.",33,2007,"Finals",24,"Home","North Melbourne","Hawthorn",33
13205,2007-09-21,"PF","Geelong",13,14,92,"Collingwood",13,9,87,"M.C.G.",5,2007,"Finals",25,"Home","Geelong","Collingwood",5
13206,2007-09-22,"PF","Port Adelaide",20,13,133,"North Melbourne",5,16,46,"Football Park",87,2007,"Finals",25,"Home","Port Adelaide","North Melbourne",87
13207,2007-09-29,"GF","Geelong",24,19,163,"Port Adelaide",6,8,44,"M.C.G.",119,2007,"Finals",26,"Home","Geelong","Port Adelaide",119
13208,2008-03-20,"R1","Carlton",11,13,79,"Richmond",17,7,109,"M.C.G.",-30,2008,"Regular",1,"Away","Richmond","Carlton",30
13209,2008-03-20,"R1","Port Adelaide",14,12,96,"Geelong",15,15,105,"Football Park",-9,2008,"Regular",1,"Away","Geelong","Port Adelaide",9
13210,2008-03-22,"R1","Collingwood",16,15,111,"Fremantle",13,7,85,"M.C.G.",26,2008,"Regular",1,"Home","Collingwood","Fremantle",26
13211,2008-03-22,"R1","West Coast",14,8,92,"Brisbane Lions",11,10,76,"Subiaco",16,2008,"Regular",1,"Home","West Coast","Brisbane Lions",16
13212,2008-03-22,"R1","St Kilda",6,15,51,"Sydney",6,13,49,"Docklands",2,2008,"Regular",1,"Home","St Kilda","Sydney",2
13213,2008-03-23,"R1","Footscray",19,12,126,"Adelaide",18,15,123,"Docklands",3,2008,"Regular",1,"Home","Footscray","Adelaide",3
13214,2008-03-23,"R1","Hawthorn",23,16,154,"Melbourne",6,14,50,"M.C.G.",104,2008,"Regular",1,"Home","Hawthorn","Melbourne",104
13215,2008-03-24,"R1","North Melbourne",9,13,67,"Essendon",19,8,122,"Docklands",-55,2008,"Regular",1,"Away","Essendon","North Melbourne",55
13216,2008-03-28,"R2","Brisbane Lions",13,18,96,"Collingwood",13,16,94,"Gabba",2,2008,"Regular",2,"Home","Brisbane Lions","Collingwood",2
13217,2008-03-29,"R2","Adelaide",21,7,133,"West Coast",8,9,57,"Football Park",76,2008,"Regular",2,"Home","Adelaide","West Coast",76
13218,2008-03-29,"R2","Melbourne",9,12,66,"Footscray",24,17,161,"M.C.G.",-95,2008,"Regular",2,"Away","Footscray","Melbourne",95
13219,2008-03-29,"R2","Fremantle",14,13,97,"Hawthorn",16,16,112,"Subiaco",-15,2008,"Regular",2,"Away","Hawthorn","Fremantle",15
13220,2008-03-29,"R2","St Kilda",19,11,125,"Carlton",12,13,85,"Docklands",40,2008,"Regular",2,"Home","St Kilda","Carlton",40
13221,2008-03-30,"R2","Sydney",22,14,146,"Port Adelaide",11,12,78,"S.C.G.",68,2008,"Regular",2,"Home","Sydney","Port Adelaide",68
13222,2008-03-30,"R2","Geelong",22,18,150,"Essendon",6,15,51,"Docklands",99,2008,"Regular",2,"Home","Geelong","Essendon",99
13223,2008-03-30,"R2","Richmond",13,8,86,"North Melbourne",20,7,127,"M.C.G.",-41,2008,"Regular",2,"Away","North Melbourne","Richmond",41
13224,2008-04-04,"R3","Footscray",19,11,125,"St Kilda",13,9,87,"Docklands",38,2008,"Regular",3,"Home","Footscray","St Kilda",38
13225,2008-04-05,"R3","North Melbourne",13,8,86,"Hawthorn",15,12,102,"Docklands",-16,2008,"Regular",3,"Away","Hawthorn","North Melbourne",16
13226,2008-04-05,"R3","West Coast",10,13,73,"Fremantle",12,15,87,"Subiaco",-14,2008,"Regular",3,"Away","Fremantle","West Coast",14
13227,2008-04-05,"R3","Essendon",23,12,150,"Carlton",21,8,134,"M.C.G.",16,2008,"Regular",3,"Home","Essendon","Carlton",16
13228,2008-04-05,"R3","Brisbane Lions",10,11,71,"Sydney",13,10,88,"Gabba",-17,2008,"Regular",3,"Away","Sydney","Brisbane Lions",17
13229,2008-04-06,"R3","Geelong",16,16,112,"Melbourne",12,10,82,"Kardinia Park",30,2008,"Regular",3,"Home","Geelong","Melbourne",30
13230,2008-04-06,"R3","Richmond",11,12,78,"Collingwood",18,14,122,"M.C.G.",-44,2008,"Regular",3,"Away","Collingwood","Richmond",44
13231,2008-04-06,"R3","Adelaide",12,13,85,"Port Adelaide",11,13,79,"Football Park",6,2008,"Regular",3,"Home","Adelaide","Port Adelaide",6
13232,2008-04-11,"R4","Essendon",14,14,98,"Footscray",19,14,128,"Docklands",-30,2008,"Regular",4,"Away","Footscray","Essendon",30
13233,2008-04-12,"R4","St Kilda",13,16,94,"Geelong",21,10,136,"Docklands",-42,2008,"Regular",4,"Away","Geelong","St Kilda",42
13234,2008-04-12,"R4","North Melbourne",18,19,127,"Melbourne",11,13,79,"M.C.G.",48,2008,"Regular",4,"Home","North Melbourne","Melbourne",48
13235,2008-04-12,"R4","Sydney",16,11,107,"West Coast",5,15,45,"Stadium Australia",62,2008,"Regular",4,"Home","Sydney","West Coast",62
13236,2008-04-12,"R4","Port Adelaide",16,8,104,"Brisbane Lions",18,16,124,"Football Park",-20,2008,"Regular",4,"Away","Brisbane Lions","Port Adelaide",20
13237,2008-04-13,"R4","Hawthorn",17,12,114,"Adelaide",10,10,70,"York Park",44,2008,"Regular",4,"Home","Hawthorn","Adelaide",44
13238,2008-04-13,"R4","Carlton",17,9,111,"Collingwood",13,10,88,"M.C.G.",23,2008,"Regular",4,"Home","Carlton","Collingwood",23
13239,2008-04-13,"R4","Fremantle",10,13,73,"Richmond",20,17,137,"Subiaco",-64,2008,"Regular",4,"Away","Richmond","Fremantle",64
13240,2008-04-18,"R5","St Kilda",18,15,123,"Essendon",14,3,87,"Docklands",36,2008,"Regular",5,"Home","St Kilda","Essendon",36
13241,2008-04-19,"R5","Geelong",16,18,114,"Sydney",10,12,72,"Kardinia Park",42,2008,"Regular",5,"Home","Geelong","Sydney",42
13242,2008-04-19,"R5","Adelaide",12,16,88,"Fremantle",10,11,71,"Football Park",17,2008,"Regular",5,"Home","Adelaide","Fremantle",17
13243,2008-04-19,"R5","Collingwood",15,15,105,"North Melbourne",16,16,112,"M.C.G.",-7,2008,"Regular",5,"Away","North Melbourne","Collingwood",7
13244,2008-04-19,"R5","Brisbane Lions",17,16,118,"Hawthorn",19,16,130,"Gabba",-12,2008,"Regular",5,"Away","Hawthorn","Brisbane Lions",12
13245,2008-04-20,"R5","Melbourne",9,14,68,"Carlton",15,11,101,"M.C.G.",-33,2008,"Regular",5,"Away","Carlton","Melbourne",33
13246,2008-04-20,"R5","Footscray",19,16,130,"Richmond",20,10,130,"Docklands",0,2008,"Regular",5,"Home","Footscray","Richmond",0
13247,2008-04-20,"R5","West Coast",16,8,104,"Port Adelaide",19,14,128,"Subiaco",-24,2008,"Regular",5,"Away","Port Adelaide","West Coast",24
13248,2008-04-25,"R6","Collingwood",23,16,154,"Essendon",12,9,81,"M.C.G.",73,2008,"Regular",6,"Home","Collingwood","Essendon",73
13249,2008-04-25,"R6","Fremantle",13,10,88,"Geelong",13,11,89,"Subiaco",-1,2008,"Regular",6,"Away","Geelong","Fremantle",1
13250,2008-04-26,"R6","Carlton",11,15,81,"Adelaide",16,15,111,"M.C.G.",-30,2008,"Regular",6,"Away","Adelaide","Carlton",30
13251,2008-04-26,"R6","Footscray",20,14,134,"West Coast",11,8,74,"Docklands",60,2008,"Regular",6,"Home","Footscray","West Coast",60
13252,2008-04-26,"R6","Port Adelaide",12,10,82,"St Kilda",9,7,61,"Football Park",21,2008,"Regular",6,"Home","Port Adelaide","St Kilda",21
13253,2008-04-27,"R6","Brisbane Lions",19,23,137,"Melbourne",13,7,85,"Gabba",52,2008,"Regular",6,"Home","Brisbane Lions","Melbourne",52
13254,2008-04-27,"R6","North Melbourne",9,10,64,"Sydney",8,16,64,"Docklands",0,2008,"Regular",6,"Home","North Melbourne","Sydney",0
13255,2008-04-27,"R6","Hawthorn",14,22,106,"Richmond",15,4,94,"M.C.G.",12,2008,"Regular",6,"Home","Hawthorn","Richmond",12
13256,2008-05-02,"R7","West Coast",10,14,74,"Carlton",17,9,111,"Subiaco",-37,2008,"Regular",7,"Away","Carlton","West Coast",37
13257,2008-05-03,"R7","Hawthorn",24,10,154,"Collingwood",13,11,89,"M.C.G.",65,2008,"Regular",7,"Home","Hawthorn","Collingwood",65
13258,2008-05-03,"R7","Geelong",15,15,105,"Brisbane Lions",11,12,78,"Kardinia Park",27,2008,"Regular",7,"Home","Geelong","Brisbane Lions",27
13259,2008-05-03,"R7","Richmond",16,11,107,"St Kilda",17,8,110,"Docklands",-3,2008,"Regular",7,"Away","St Kilda","Richmond",3
13260,2008-05-03,"R7","Adelaide",15,17,107,"North Melbourne",11,8,74,"Football Park",33,2008,"Regular",7,"Home","Adelaide","North Melbourne",33
13261,2008-05-04,"R7","Sydney",14,10,94,"Footscray",18,4,112,"S.C.G.",-18,2008,"Regular",7,"Away","Footscray","Sydney",18
13262,2008-05-04,"R7","Melbourne",17,17,119,"Fremantle",15,23,113,"M.C.G.",6,2008,"Regular",7,"Home","Melbourne","Fremantle",6
13263,2008-05-04,"R7","Essendon",15,4,94,"Port Adelaide",24,14,158,"Docklands",-64,2008,"Regular",7,"Away","Port Adelaide","Essendon",64
13264,2008-05-16,"R8","St Kilda",14,10,94,"Collingwood",16,7,103,"Docklands",-9,2008,"Regular",8,"Away","Collingwood","St Kilda",9
13265,2008-05-17,"R8","Richmond",10,9,69,"Geelong",14,15,99,"M.C.G.",-30,2008,"Regular",8,"Away","Geelong","Richmond",30
13266,2008-05-17,"R8","Hawthorn",17,15,117,"Port Adelaide",15,12,102,"York Park",15,2008,"Regular",8,"Home","Hawthorn","Port Adelaide",15
13267,2008-05-17,"R8","Carlton",12,20,92,"Brisbane Lions",18,17,125,"Docklands",-33,2008,"Regular",8,"Away","Brisbane Lions","Carlton",33
13268,2008-05-17,"R8","North Melbourne",13,11,89,"West Coast",12,11,83,"Carrara",6,2008,"Regular",8,"Home","North Melbourne","West Coast",6
13269,2008-05-18,"R8","Adelaide",22,18,150,"Melbourne",11,8,74,"Football Park",76,2008,"Regular",8,"Home","Adelaide","Melbourne",76
13270,2008-05-18,"R8","Sydney",21,17,143,"Essendon",7,10,52,"Stadium Australia",91,2008,"Regular",8,"Home","Sydney","Essendon",91
13271,2008-05-18,"R8","Fremantle",17,9,111,"Footscray",17,12,114,"Subiaco",-3,2008,"Regular",8,"Away","Footscray","Fremantle",3
13272,2008-05-23,"R9","Collingwood",20,14,134,"Geelong",7,6,48,"M.C.G.",86,2008,"Regular",9,"Home","Collingwood","Geelong",86
13273,2008-05-24,"R9","Carlton",14,13,97,"Fremantle",14,4,88,"Docklands",9,2008,"Regular",9,"Home","Carlton","Fremantle",9
13274,2008-05-24,"R9","Port Adelaide",14,10,94,"Sydney",16,9,105,"Football Park",-11,2008,"Regular",9,"Away","Sydney","Port Adelaide",11
13275,2008-05-24,"R9","West Coast",14,13,97,"Adelaide",5,17,47,"Subiaco",50,2008,"Regular",9,"Home","West Coast","Adelaide",50
13276,2008-05-24,"R9","Essendon",10,12,72,"Richmond",16,14,110,"M.C.G.",-38,2008,"Regular",9,"Away","Richmond","Essendon",38
13277,2008-05-25,"R9","Brisbane Lions",21,15,141,"St Kilda",14,11,95,"Gabba",46,2008,"Regular",9,"Home","Brisbane Lions","St Kilda",46
13278,2008-05-25,"R9","Melbourne",12,6,78,"Hawthorn",14,13,97,"M.C.G.",-19,2008,"Regular",9,"Away","Hawthorn","Melbourne",19
13279,2008-05-25,"R9","Footscray",16,14,110,"North Melbourne",16,17,113,"Docklands",-3,2008,"Regular",9,"Away","North Melbourne","Footscray",3
13280,2008-05-30,"R10","Adelaide",9,20,74,"Essendon",10,9,69,"Football Park",5,2008,"Regular",10,"Home","Adelaide","Essendon",5
13281,2008-05-31,"R10","Collingwood",27,11,173,"West Coast",10,13,73,"M.C.G.",100,2008,"Regular",10,"Home","Collingwood","West Coast",100
13282,2008-05-31,"R10","Hawthorn",12,2,74,"Footscray",15,16,106,"York Park",-32,2008,"Regular",10,"Away","Footscray","Hawthorn",32
13283,2008-05-31,"R10","Geelong",19,19,133,"Carlton",12,5,77,"Docklands",56,2008,"Regular",10,"Home","Geelong","Carlton",56
13284,2008-05-31,"R10","Brisbane Lions",18,21,129,"North Melbourne",15,8,98,"Gabba",31,2008,"Regular",10,"Home","Brisbane Lions","North Melbourne",31
13285,2008-06-01,"R10","Sydney",21,13,139,"Richmond",8,9,57,"S.C.G.",82,2008,"Regular",10,"Home","Sydney","Richmond",82
13286,2008-06-01,"R10","St Kilda",19,15,129,"Melbourne",7,8,50,"Docklands",79,2008,"Regular",10,"Home","St Kilda","Melbourne",79
13287,2008-06-01,"R10","Fremantle",10,15,75,"Port Adelaide",16,7,103,"Subiaco",-28,2008,"Regular",10,"Away","Port Adelaide","Fremantle",28
13288,2008-06-06,"R11","North Melbourne",17,12,114,"Geelong",19,13,127,"Docklands",-13,2008,"Regular",11,"Away","Geelong","North Melbourne",13
13289,2008-06-07,"R11","Richmond",14,12,96,"Adelaide",22,14,146,"M.C.G.",-50,2008,"Regular",11,"Away","Adelaide","Richmond",50
13290,2008-06-07,"R11","Essendon",12,7,79,"Hawthorn",19,16,130,"Docklands",-51,2008,"Regular",11,"Away","Hawthorn","Essendon",51
13291,2008-06-07,"R11","West Coast",11,12,78,"Sydney",12,11,83,"Subiaco",-5,2008,"Regular",11,"Away","Sydney","West Coast",5
13292,2008-06-08,"R11","Brisbane Lions",14,12,96,"Fremantle",10,14,74,"Gabba",22,2008,"Regular",11,"Home","Brisbane Lions","Fremantle",22
13293,2008-06-08,"R11","St Kilda",11,13,79,"Footscray",15,16,106,"Docklands",-27,2008,"Regular",11,"Away","Footscray","St Kilda",27
13294,2008-06-08,"R11","Port Adelaide",8,15,63,"Carlton",10,15,75,"Football Park",-12,2008,"Regular",11,"Away","Carlton","Port Adelaide",12
13295,2008-06-09,"R11","Melbourne",13,17,95,"Collingwood",17,14,116,"M.C.G.",-21,2008,"Regular",11,"Away","Collingwood","Melbourne",21
13296,2008-06-13,"R12","Essendon",16,17,113,"West Coast",13,13,91,"Docklands",22,2008,"Regular",12,"Home","Essendon","West Coast",22
13297,2008-06-14,"R12","Footscray",19,17,131,"Brisbane Lions",10,8,68,"M.C.G.",63,2008,"Regular",12,"Home","Footscray","Brisbane Lions",63
13298,2008-06-14,"R12","Fremantle",18,12,120,"North Melbourne",9,13,67,"Subiaco",53,2008,"Regular",12,"Home","Fremantle","North Melbourne",53
13299,2008-06-14,"R12","Sydney",14,18,102,"St Kilda",9,13,67,"S.C.G.",35,2008,"Regular",12,"Home","Sydney","St Kilda",35
13300,2008-06-14,"R12","Adelaide",10,12,72,"Hawthorn",11,10,76,"Football Park",-4,2008,"Regular",12,"Away","Hawthorn","Adelaide",4
13301,2008-06-15,"R12","Geelong",15,18,108,"Port Adelaide",7,7,49,"Kardinia Park",59,2008,"Regular",12,"Home","Geelong","Port Adelaide",59
13302,2008-06-15,"R12","Collingwood",12,17,89,"Carlton",17,17,119,"M.C.G.",-30,2008,"Regular",12,"Away","Carlton","Collingwood",30
13303,2008-06-15,"R12","Richmond",16,20,116,"Melbourne",14,10,94,"Docklands",22,2008,"Regular",12,"Home","Richmond","Melbourne",22
13304,2008-06-20,"R13","St Kilda",10,5,65,"Fremantle",8,9,57,"Docklands",8,2008,"Regular",13,"Home","St Kilda","Fremantle",8
13305,2008-06-21,"R13","Hawthorn",10,16,76,"North Melbourne",15,13,103,"M.C.G.",-27,2008,"Regular",13,"Away","North Melbourne","Hawthorn",27
13306,2008-06-21,"R13","Port Adelaide",19,9,123,"Richmond",20,7,127,"Football Park",-4,2008,"Regular",13,"Away","Richmond","Port Adelaide",4
13307,2008-06-21,"R13","Brisbane Lions",11,17,83,"Adelaide",10,10,70,"Gabba",13,2008,"Regular",13,"Home","Brisbane Lions","Adelaide",13
13308,2008-06-21,"R13","West Coast",5,17,47,"Geelong",28,14,182,"Subiaco",-135,2008,"Regular",13,"Away","Geelong","West Coast",135
13309,2008-06-22,"R13","Melbourne",11,8,74,"Sydney",17,12,114,"Manuka Oval",-40,2008,"Regular",13,"Away","Sydney","Melbourne",40
13310,2008-06-22,"R13","Carlton",15,11,101,"Essendon",20,16,136,"M.C.G.",-35,2008,"Regular",13,"Away","Essendon","Carlton",35
13311,2008-06-22,"R13","Collingwood",13,11,89,"Footscray",15,9,99,"Docklands",-10,2008,"Regular",13,"Away","Footscray","Collingwood",10
13312,2008-06-27,"R14","Hawthorn",18,18,126,"West Coast",9,15,69,"M.C.G.",57,2008,"Regular",14,"Home","Hawthorn","West Coast",57
13313,2008-06-28,"R14","Richmond",12,16,88,"Carlton",17,16,118,"M.C.G.",-30,2008,"Regular",14,"Away","Carlton","Richmond",30
13314,2008-06-28,"R14","North Melbourne",9,15,69,"St Kilda",12,12,84,"Carrara",-15,2008,"Regular",14,"Away","St Kilda","North Melbourne",15
13315,2008-06-28,"R14","Footscray",20,15,135,"Port Adelaide",11,15,81,"Marrara Oval",54,2008,"Regular",14,"Home","Footscray","Port Adelaide",54
13316,2008-06-29,"R14","Melbourne",14,9,93,"Brisbane Lions",13,14,92,"M.C.G.",1,2008,"Regular",14,"Home","Melbourne","Brisbane Lions",1
13317,2008-06-29,"R14","Fremantle",13,13,91,"Essendon",14,11,95,"Subiaco",-4,2008,"Regular",14,"Away","Essendon","Fremantle",4
13318,2008-07-04,"R14","Adelaide",8,8,56,"Geelong",18,16,124,"Football Park",-68,2008,"Regular",14,"Away","Geelong","Adelaide",68
13319,2008-07-05,"R14","Sydney",6,14,50,"Collingwood",11,13,79,"Stadium Australia",-29,2008,"Regular",14,"Away","Collingwood","Sydney",29
13320,2008-07-11,"R15","Carlton",12,15,87,"St Kilda",18,11,119,"M.C.G.",-32,2008,"Regular",15,"Away","St Kilda","Carlton",32
13321,2008-07-12,"R15","Collingwood",15,16,106,"Adelaide",11,8,74,"M.C.G.",32,2008,"Regular",15,"Home","Collingwood","Adelaide",32
13322,2008-07-12,"R15","Geelong",18,10,118,"Fremantle",6,8,44,"Kardinia Park",74,2008,"Regular",15,"Home","Geelong","Fremantle",74
13323,2008-07-12,"R15","Essendon",24,11,155,"Brisbane Lions",18,10,118,"Docklands",37,2008,"Regular",15,"Home","Essendon","Brisbane Lions",37
13324,2008-07-12,"R15","Port Adelaide",10,14,74,"North Melbourne",10,16,76,"Football Park",-2,2008,"Regular",15,"Away","North Melbourne","Port Adelaide",2
13325,2008-07-13,"R15","Hawthorn",15,16,106,"Sydney",10,15,75,"M.C.G.",31,2008,"Regular",15,"Home","Hawthorn","Sydney",31
13326,2008-07-13,"R15","Footscray",14,11,95,"Melbourne",9,10,64,"Docklands",31,2008,"Regular",15,"Home","Footscray","Melbourne",31
13327,2008-07-13,"R15","West Coast",11,9,75,"Richmond",24,8,152,"Subiaco",-77,2008,"Regular",15,"Away","Richmond","West Coast",77
13328,2008-07-18,"R16","North Melbourne",17,12,114,"Collingwood",14,12,96,"Docklands",18,2008,"Regular",16,"Home","North Melbourne","Collingwood",18
13329,2008-07-19,"R16","Richmond",16,12,108,"Essendon",15,14,104,"M.C.G.",4,2008,"Regular",16,"Home","Richmond","Essendon",4
13330,2008-07-19,"R16","Geelong",19,17,131,"Footscray",10,10,70,"Kardinia Park",61,2008,"Regular",16,"Home","Geelong","Footscray",61
13331,2008-07-19,"R16","St Kilda",18,11,119,"Hawthorn",13,11,89,"Docklands",30,2008,"Regular",16,"Home","St Kilda","Hawthorn",30
13332,2008-07-19,"R16","Brisbane Lions",17,11,113,"West Coast",9,13,67,"Gabba",46,2008,"Regular",16,"Home","Brisbane Lions","West Coast",46
13333,2008-07-20,"R16","Carlton",18,11,119,"Sydney",18,13,121,"Docklands",-2,2008,"Regular",16,"Away","Sydney","Carlton",2
13334,2008-07-20,"R16","Port Adelaide",13,14,92,"Adelaide",11,14,80,"Football Park",12,2008,"Regular",16,"Home","Port Adelaide","Adelaide",12
13335,2008-07-20,"R16","Fremantle",16,18,114,"Melbourne",10,8,68,"Subiaco",46,2008,"Regular",16,"Home","Fremantle","Melbourne",46
13336,2008-07-25,"R17","Hawthorn",11,11,77,"Geelong",12,16,88,"M.C.G.",-11,2008,"Regular",17,"Away","Geelong","Hawthorn",11
13337,2008-07-26,"R17","Essendon",19,14,128,"Collingwood",11,14,80,"M.C.G.",48,2008,"Regular",17,"Home","Essendon","Collingwood",48
13338,2008-07-26,"R17","West Coast",15,13,103,"St Kilda",12,14,86,"Subiaco",17,2008,"Regular",17,"Home","West Coast","St Kilda",17
13339,2008-07-26,"R17","Sydney",6,17,53,"Adelaide",11,11,77,"S.C.G.",-24,2008,"Regular",17,"Away","Adelaide","Sydney",24
13340,2008-07-26,"R17","Richmond",18,9,117,"Brisbane Lions",16,18,114,"Docklands",3,2008,"Regular",17,"Home","Richmond","Brisbane Lions",3
13341,2008-07-27,"R17","Port Adelaide",15,11,101,"Fremantle",20,9,129,"Football Park",-28,2008,"Regular",17,"Away","Fremantle","Port Adelaide",28
13342,2008-07-27,"R17","Melbourne",10,10,70,"North Melbourne",14,14,98,"M.C.G.",-28,2008,"Regular",17,"Away","North Melbourne","Melbourne",28
13343,2008-07-27,"R17","Footscray",15,8,98,"Carlton",18,18,126,"Docklands",-28,2008,"Regular",17,"Away","Carlton","Footscray",28
13344,2008-08-01,"R18","Collingwood",8,14,62,"Hawthorn",17,14,116,"M.C.G.",-54,2008,"Regular",18,"Away","Hawthorn","Collingwood",54
13345,2008-08-02,"R18","Essendon",19,10,124,"Melbourne",17,6,108,"M.C.G.",16,2008,"Regular",18,"Home","Essendon","Melbourne",16
13346,2008-08-02,"R18","Adelaide",13,16,94,"Carlton",12,14,86,"Football Park",8,2008,"Regular",18,"Home","Adelaide","Carlton",8
13347,2008-08-02,"R18","Geelong",20,14,134,"Richmond",10,11,71,"Docklands",63,2008,"Regular",18,"Home","Geelong","Richmond",63
13348,2008-08-02,"R18","North Melbourne",13,14,92,"Brisbane Lions",11,18,84,"Carrara",8,2008,"Regular",18,"Home","North Melbourne","Brisbane Lions",8
13349,2008-08-03,"R18","Footscray",17,11,113,"Sydney",14,13,97,"Manuka Oval",16,2008,"Regular",18,"Home","Footscray","Sydney",16
13350,2008-08-03,"R18","St Kilda",14,17,101,"Port Adelaide",14,9,93,"Docklands",8,2008,"Regular",18,"Home","St Kilda","Port Adelaide",8
13351,2008-08-03,"R18","Fremantle",17,14,116,"West Coast",12,11,83,"Subiaco",33,2008,"Regular",18,"Home","Fremantle","West Coast",33
13352,2008-08-08,"R19","Melbourne",5,11,41,"Geelong",24,13,157,"M.C.G.",-116,2008,"Regular",19,"Away","Geelong","Melbourne",116
13353,2008-08-09,"R19","Carlton",18,24,132,"Port Adelaide",9,12,66,"Docklands",66,2008,"Regular",19,"Home","Carlton","Port Adelaide",66
13354,2008-08-09,"R19","Hawthorn",16,14,110,"Brisbane Lions",5,11,41,"York Park",69,2008,"Regular",19,"Home","Hawthorn","Brisbane Lions",69
13355,2008-08-09,"R19","Collingwood",14,13,97,"St Kilda",12,11,83,"M.C.G.",14,2008,"Regular",19,"Home","Collingwood","St Kilda",14
13356,2008-08-09,"R19","Sydney",17,10,112,"Fremantle",15,18,108,"S.C.G.",4,2008,"Regular",19,"Home","Sydney","Fremantle",4
13357,2008-08-10,"R19","North Melbourne",21,10,136,"Footscray",18,8,116,"Docklands",20,2008,"Regular",19,"Home","North Melbourne","Footscray",20
13358,2008-08-10,"R19","Adelaide",16,12,108,"Richmond",6,9,45,"Football Park",63,2008,"Regular",19,"Home","Adelaide","Richmond",63
13359,2008-08-10,"R19","West Coast",17,11,113,"Essendon",16,7,103,"Subiaco",10,2008,"Regular",19,"Home","West Coast","Essendon",10
13360,2008-08-15,"R20","Port Adelaide",10,15,75,"Collingwood",16,10,106,"Football Park",-31,2008,"Regular",20,"Away","Collingwood","Port Adelaide",31
13361,2008-08-16,"R20","Essendon",10,13,73,"Adelaide",19,15,129,"Docklands",-56,2008,"Regular",20,"Away","Adelaide","Essendon",56
13362,2008-08-16,"R20","Melbourne",11,13,79,"West Coast",5,15,45,"M.C.G.",34,2008,"Regular",20,"Home","Melbourne","West Coast",34
13363,2008-08-16,"R20","Brisbane Lions",13,12,90,"Footscray",10,19,79,"Gabba",11,2008,"Regular",20,"Home","Brisbane Lions","Footscray",11
13364,2008-08-16,"R20","Sydney",14,10,94,"Geelong",20,13,133,"Stadium Australia",-39,2008,"Regular",20,"Away","Geelong","Sydney",39
13365,2008-08-17,"R20","Richmond",16,9,105,"Hawthorn",10,16,76,"M.C.G.",29,2008,"Regular",20,"Home","Richmond","Hawthorn",29
13366,2008-08-17,"R20","Carlton",14,6,90,"North Melbourne",22,9,141,"Docklands",-51,2008,"Regular",20,"Away","North Melbourne","Carlton",51
13367,2008-08-17,"R20","Fremantle",9,15,69,"St Kilda",17,10,112,"Subiaco",-43,2008,"Regular",20,"Away","St Kilda","Fremantle",43
13368,2008-08-22,"R21","Footscray",23,13,151,"Essendon",15,15,105,"Docklands",46,2008,"Regular",21,"Home","Footscray","Essendon",46
13369,2008-08-23,"R21","Richmond",15,15,105,"Fremantle",15,8,98,"M.C.G.",7,2008,"Regular",21,"Home","Richmond","Fremantle",7
13370,2008-08-23,"R21","Port Adelaide",18,21,129,"Melbourne",7,9,51,"Football Park",78,2008,"Regular",21,"Home","Port Adelaide","Melbourne",78
13371,2008-08-23,"R21","Brisbane Lions",16,13,109,"Carlton",18,7,115,"Gabba",-6,2008,"Regular",21,"Away","Carlton","Brisbane Lions",6
13372,2008-08-23,"R21","Collingwood",18,10,118,"Sydney",10,13,73,"Docklands",45,2008,"Regular",21,"Home","Collingwood","Sydney",45
13373,2008-08-24,"R21","Geelong",17,13,115,"North Melbourne",13,4,82,"Kardinia Park",33,2008,"Regular",21,"Home","Geelong","North Melbourne",33
13374,2008-08-24,"R21","St Kilda",13,17,95,"Adelaide",6,11,47,"Docklands",48,2008,"Regular",21,"Home","St Kilda","Adelaide",48
13375,2008-08-24,"R21","West Coast",9,8,62,"Hawthorn",19,19,133,"Subiaco",-71,2008,"Regular",21,"Away","Hawthorn","West Coast",71
13376,2008-08-29,"R22","Fremantle",12,8,80,"Collingwood",8,8,56,"Subiaco",24,2008,"Regular",22,"Home","Fremantle","Collingwood",24
13377,2008-08-30,"R22","North Melbourne",10,12,72,"Port Adelaide",23,10,148,"M.C.G.",-76,2008,"Regular",22,"Away","Port Adelaide","North Melbourne",76
13378,2008-08-30,"R22","Geelong",24,20,164,"West Coast",10,5,65,"Kardinia Park",99,2008,"Regular",22,"Home","Geelong","West Coast",99
13379,2008-08-30,"R22","Adelaide",10,16,76,"Footscray",9,13,67,"Football Park",9,2008,"Regular",22,"Home","Adelaide","Footscray",9
13380,2008-08-30,"R22","Carlton",12,9,81,"Hawthorn",24,15,159,"Docklands",-78,2008,"Regular",22,"Away","Hawthorn","Carlton",78
13381,2008-08-30,"R22","Sydney",17,12,114,"Brisbane Lions",6,17,53,"S.C.G.",61,2008,"Regular",22,"Home","Sydney","Brisbane Lions",61
13382,2008-08-31,"R22","Melbourne",6,5,41,"Richmond",18,13,121,"M.C.G.",-80,2008,"Regular",22,"Away","Richmond","Melbourne",80
13383,2008-08-31,"R22","Essendon",5,9,39,"St Kilda",21,21,147,"Docklands",-108,2008,"Regular",22,"Away","St Kilda","Essendon",108
13384,2008-09-05,"QF","Hawthorn",18,19,127,"Footscray",11,10,76,"M.C.G.",51,2008,"Finals",23,"Home","Hawthorn","Footscray",51
13385,2008-09-06,"EF","Adelaide",14,10,94,"Collingwood",19,11,125,"Football Park",-31,2008,"Finals",23,"Away","Collingwood","Adelaide",31
13386,2008-09-06,"EF","Sydney",17,8,110,"North Melbourne",11,9,75,"Stadium Australia",35,2008,"Finals",23,"Home","Sydney","North Melbourne",35
13387,2008-09-07,"QF","Geelong",17,17,119,"St Kilda",8,13,61,"M.C.G.",58,2008,"Finals",23,"Home","Geelong","St Kilda",58
13388,2008-09-12,"SF","Footscray",16,10,106,"Sydney",9,15,69,"M.C.G.",37,2008,"Finals",24,"Home","Footscray","Sydney",37
13389,2008-09-13,"SF","St Kilda",17,4,106,"Collingwood",9,18,72,"M.C.G.",34,2008,"Finals",24,"Home","St Kilda","Collingwood",34
13390,2008-09-19,"PF","Geelong",12,11,83,"Footscray",7,12,54,"M.C.G.",29,2008,"Finals",25,"Home","Geelong","Footscray",29
13391,2008-09-20,"PF","Hawthorn",18,10,118,"St Kilda",9,10,64,"M.C.G.",54,2008,"Finals",25,"Home","Hawthorn","St Kilda",54
13392,2008-09-27,"GF","Geelong",11,23,89,"Hawthorn",18,7,115,"M.C.G.",-26,2008,"Finals",26,"Away","Hawthorn","Geelong",26
13393,2009-03-26,"R1","Richmond",9,13,67,"Carlton",23,12,150,"M.C.G.",-83,2009,"Regular",1,"Away","Carlton","Richmond",83
13394,2009-03-27,"R1","Hawthorn",16,7,103,"Geelong",15,21,111,"M.C.G.",-8,2009,"Regular",1,"Away","Geelong","Hawthorn",8
13395,2009-03-28,"R1","Collingwood",13,8,86,"Adelaide",13,12,90,"M.C.G.",-4,2009,"Regular",1,"Away","Adelaide","Collingwood",4
13396,2009-03-28,"R1","St Kilda",12,8,80,"Sydney",9,11,65,"Docklands",15,2009,"Regular",1,"Home","St Kilda","Sydney",15
13397,2009-03-28,"R1","Brisbane Lions",14,11,95,"West Coast",13,8,86,"Gabba",9,2009,"Regular",1,"Home","Brisbane Lions","West Coast",9
13398,2009-03-29,"R1","Melbourne",10,7,67,"North Melbourne",15,11,101,"M.C.G.",-34,2009,"Regular",1,"Away","North Melbourne","Melbourne",34
13399,2009-03-29,"R1","Port Adelaide",15,17,107,"Essendon",9,12,66,"Football Park",41,2009,"Regular",1,"Home","Port Adelaide","Essendon",41
13400,2009-03-29,"R1","Fremantle",13,16,94,"Footscray",25,7,157,"Subiaco",-63,2009,"Regular",1,"Away","Footscray","Fremantle",63
13401,2009-04-03,"R2","Adelaide",10,9,69,"St Kilda",15,11,101,"Football Park",-32,2009,"Regular",2,"Away","St Kilda","Adelaide",32
13402,2009-04-04,"R2","Collingwood",17,15,117,"Melbourne",10,4,64,"M.C.G.",53,2009,"Regular",2,"Home","Collingwood","Melbourne",53
13403,2009-04-04,"R2","Geelong",15,15,105,"Richmond",13,7,85,"Kardinia Park",20,2009,"Regular",2,"Home","Geelong","Richmond",20
13404,2009-04-04,"R2","Carlton",18,11,119,"Brisbane Lions",15,10,100,"Docklands",19,2009,"Regular",2,"Home","Carlton","Brisbane Lions",19
13405,2009-04-04,"R2","Sydney",22,11,143,"Hawthorn",15,15,105,"Stadium Australia",38,2009,"Regular",2,"Home","Sydney","Hawthorn",38
13406,2009-04-05,"R2","Essendon",16,13,109,"Fremantle",10,11,71,"Docklands",38,2009,"Regular",2,"Home","Essendon","Fremantle",38
13407,2009-04-05,"R2","Footscray",11,14,80,"North Melbourne",9,11,65,"M.C.G.",15,2009,"Regular",2,"Home","Footscray","North Melbourne",15
13408,2009-04-05,"R2","West Coast",19,11,125,"Port Adelaide",10,15,75,"Subiaco",50,2009,"Regular",2,"Home","West Coast","Port Adelaide",50
13409,2009-04-09,"R3","Geelong",18,14,122,"Collingwood",13,17,95,"M.C.G.",27,2009,"Regular",3,"Home","Geelong","Collingwood",27
13410,2009-04-11,"R3","St Kilda",25,11,161,"West Coast",9,10,64,"Docklands",97,2009,"Regular",3,"Home","St Kilda","West Coast",97
13411,2009-04-11,"R3","Carlton",16,16,112,"Essendon",17,14,116,"M.C.G.",-4,2009,"Regular",3,"Away","Essendon","Carlton",4
13412,2009-04-11,"R3","Brisbane Lions",15,10,100,"Sydney",9,13,67,"Gabba",33,2009,"Regular",3,"Home","Brisbane Lions","Sydney",33
13413,2009-04-12,"R3","Port Adelaide",22,15,147,"Melbourne",14,6,90,"Football Park",57,2009,"Regular",3,"Home","Port Adelaide","Melbourne",57
13414,2009-04-12,"R3","North Melbourne",10,9,69,"Hawthorn",19,9,123,"Docklands",-54,2009,"Regular",3,"Away","Hawthorn","North Melbourne",54
13415,2009-04-12,"R3","Fremantle",11,14,80,"Adelaide",15,14,104,"Subiaco",-24,2009,"Regular",3,"Away","Adelaide","Fremantle",24
13416,2009-04-13,"R3","Footscray",16,14,110,"Richmond",8,15,63,"Docklands",47,2009,"Regular",3,"Home","Footscray","Richmond",47
13417,2009-04-17,"R4","Brisbane Lions",10,13,73,"Collingwood",13,12,90,"Gabba",-17,2009,"Regular",4,"Away","Collingwood","Brisbane Lions",17
13418,2009-04-18,"R4","Sydney",12,12,84,"Carlton",9,13,67,"S.C.G.",17,2009,"Regular",4,"Home","Sydney","Carlton",17
13419,2009-04-18,"R4","Hawthorn",12,13,85,"Port Adelaide",17,13,115,"M.C.G.",-30,2009,"Regular",4,"Away","Port Adelaide","Hawthorn",30
13420,2009-04-18,"R4","St Kilda",17,9,111,"Fremantle",4,4,28,"Docklands",83,2009,"Regular",4,"Home","St Kilda","Fremantle",83
13421,2009-04-18,"R4","Adelaide",13,8,86,"Geelong",21,8,134,"Football Park",-48,2009,"Regular",4,"Away","Geelong","Adelaide",48
13422,2009-04-19,"R4","North Melbourne",10,9,69,"Essendon",7,15,57,"Docklands",12,2009,"Regular",4,"Home","North Melbourne","Essendon",12
13423,2009-04-19,"R4","Richmond",13,14,92,"Melbourne",14,16,100,"M.C.G.",-8,2009,"Regular",4,"Away","Melbourne","Richmond",8
13424,2009-04-19,"R4","West Coast",17,14,116,"Footscray",12,11,83,"Subiaco",33,2009,"Regular",4,"Home","West Coast","Footscray",33
13425,2009-04-24,"R5","Port Adelaide",5,6,36,"St Kilda",15,12,102,"Football Park",-66,2009,"Regular",5,"Away","St Kilda","Port Adelaide",66
13426,2009-04-25,"R5","Essendon",13,15,93,"Collingwood",12,16,88,"M.C.G.",5,2009,"Regular",5,"Home","Essendon","Collingwood",5
13427,2009-04-25,"R5","Hawthorn",11,8,74,"West Coast",7,14,56,"York Park",18,2009,"Regular",5,"Home","Hawthorn","West Coast",18
13428,2009-04-25,"R5","North Melbourne",7,16,58,"Richmond",13,16,94,"Docklands",-36,2009,"Regular",5,"Away","Richmond","North Melbourne",36
13429,2009-04-25,"R5","Fremantle",18,13,121,"Sydney",16,4,100,"Subiaco",21,2009,"Regular",5,"Home","Fremantle","Sydney",21
13430,2009-04-26,"R5","Geelong",18,18,126,"Brisbane Lions",5,3,33,"Kardinia Park",93,2009,"Regular",5,"Home","Geelong","Brisbane Lions",93
13431,2009-04-26,"R5","Footscray",13,12,90,"Carlton",21,7,133,"Docklands",-43,2009,"Regular",5,"Away","Carlton","Footscray",43
13432,2009-04-26,"R5","Melbourne",4,10,34,"Adelaide",7,9,51,"M.C.G.",-17,2009,"Regular",5,"Away","Adelaide","Melbourne",17
13433,2009-05-01,"R6","North Melbourne",11,9,75,"Collingwood",19,13,127,"Docklands",-52,2009,"Regular",6,"Away","Collingwood","North Melbourne",52
13434,2009-05-02,"R6","Hawthorn",16,10,106,"Carlton",15,12,102,"M.C.G.",4,2009,"Regular",6,"Home","Hawthorn","Carlton",4
13435,2009-05-02,"R6","West Coast",9,20,74,"Fremantle",13,9,87,"Subiaco",-13,2009,"Regular",6,"Away","Fremantle","West Coast",13
13436,2009-05-02,"R6","Brisbane Lions",17,9,111,"Essendon",9,14,68,"Gabba",43,2009,"Regular",6,"Home","Brisbane Lions","Essendon",43
13437,2009-05-02,"R6","Port Adelaide",15,15,105,"Adelaide",12,7,79,"Football Park",26,2009,"Regular",6,"Home","Port Adelaide","Adelaide",26
13438,2009-05-03,"R6","Sydney",14,10,94,"Richmond",11,9,75,"S.C.G.",19,2009,"Regular",6,"Home","Sydney","Richmond",19
13439,2009-05-03,"R6","Melbourne",10,8,68,"Geelong",15,21,111,"M.C.G.",-43,2009,"Regular",6,"Away","Geelong","Melbourne",43
13440,2009-05-03,"R6","Footscray",11,10,76,"St Kilda",14,20,104,"Docklands",-28,2009,"Regular",6,"Away","St Kilda","Footscray",28
13441,2009-05-08,"R7","Essendon",17,14,116,"Hawthorn",10,12,72,"Docklands",44,2009,"Regular",7,"Home","Essendon","Hawthorn",44
13442,2009-05-09,"R7","Geelong",17,14,116,"Sydney",10,5,65,"Kardinia Park",51,2009,"Regular",7,"Home","Geelong","Sydney",51
13443,2009-05-09,"R7","Richmond",10,11,71,"Brisbane Lions",15,7,97,"M.C.G.",-26,2009,"Regular",7,"Away","Brisbane Lions","Richmond",26
13444,2009-05-09,"R7","Carlton",11,15,81,"Fremantle",13,10,88,"Carrara",-7,2009,"Regular",7,"Away","Fremantle","Carlton",7
13445,2009-05-09,"R7","North Melbourne",20,5,125,"Port Adelaide",18,12,120,"Docklands",5,2009,"Regular",7,"Home","North Melbourne","Port Adelaide",5
13446,2009-05-10,"R7","Adelaide",12,14,86,"Footscray",17,16,118,"Football Park",-32,2009,"Regular",7,"Away","Footscray","Adelaide",32
13447,2009-05-10,"R7","West Coast",12,18,90,"Melbourne",13,4,82,"Subiaco",8,2009,"Regular",7,"Home","West Coast","Melbourne",8
13448,2009-05-11,"R7","Collingwood",5,10,40,"St Kilda",20,8,128,"Docklands",-88,2009,"Regular",7,"Away","St Kilda","Collingwood",88
13449,2009-05-15,"R8","Fremantle",9,11,65,"Hawthorn",13,9,87,"Subiaco",-22,2009,"Regular",8,"Away","Hawthorn","Fremantle",22
13450,2009-05-16,"R8","Melbourne",15,7,97,"Footscray",15,14,104,"M.C.G.",-7,2009,"Regular",8,"Away","Footscray","Melbourne",7
13451,2009-05-16,"R8","Geelong",18,11,119,"North Melbourne",7,7,49,"Kardinia Park",70,2009,"Regular",8,"Home","Geelong","North Melbourne",70
13452,2009-05-16,"R8","Brisbane Lions",18,11,119,"Adelaide",12,11,83,"Gabba",36,2009,"Regular",8,"Home","Brisbane Lions","Adelaide",36
13453,2009-05-16,"R8","Sydney",16,10,106,"West Coast",15,11,101,"Stadium Australia",5,2009,"Regular",8,"Home","Sydney","West Coast",5
13454,2009-05-17,"R8","Port Adelaide",14,18,102,"Richmond",15,9,99,"Football Park",3,2009,"Regular",8,"Home","Port Adelaide","Richmond",3
13455,2009-05-17,"R8","Collingwood",7,11,53,"Carlton",16,8,104,"M.C.G.",-51,2009,"Regular",8,"Away","Carlton","Collingwood",51
13456,2009-05-17,"R8","St Kilda",13,12,90,"Essendon",10,11,71,"Docklands",19,2009,"Regular",8,"Home","St Kilda","Essendon",19
13457,2009-05-22,"R9","Geelong",17,14,116,"Footscray",17,12,114,"Docklands",2,2009,"Regular",9,"Home","Geelong","Footscray",2
13458,2009-05-23,"R9","North Melbourne",14,14,98,"Fremantle",12,13,85,"Docklands",13,2009,"Regular",9,"Home","North Melbourne","Fremantle",13
13459,2009-05-23,"R9","Adelaide",15,14,104,"Carlton",8,12,60,"Football Park",44,2009,"Regular",9,"Home","Adelaide","Carlton",44
13460,2009-05-23,"R9","West Coast",9,12,66,"Collingwood",12,16,88,"Subiaco",-22,2009,"Regular",9,"Away","Collingwood","West Coast",22
13461,2009-05-23,"R9","Richmond",12,13,85,"Essendon",19,11,125,"M.C.G.",-40,2009,"Regular",9,"Away","Essendon","Richmond",40
13462,2009-05-24,"R9","Sydney",18,15,123,"Port Adelaide",10,8,68,"S.C.G.",55,2009,"Regular",9,"Home","Sydney","Port Adelaide",55
13463,2009-05-24,"R9","St Kilda",14,13,97,"Brisbane Lions",13,3,81,"Docklands",16,2009,"Regular",9,"Home","St Kilda","Brisbane Lions",16
13464,2009-05-24,"R9","Hawthorn",17,12,114,"Melbourne",13,14,92,"M.C.G.",22,2009,"Regular",9,"Home","Hawthorn","Melbourne",22
13465,2009-05-29,"R10","Carlton",16,15,111,"West Coast",10,10,70,"Docklands",41,2009,"Regular",10,"Home","Carlton","West Coast",41
13466,2009-05-30,"R10","Footscray",18,9,117,"Sydney",12,5,77,"Manuka Oval",40,2009,"Regular",10,"Home","Footscray","Sydney",40
13467,2009-05-30,"R10","North Melbourne",12,9,81,"Brisbane Lions",15,9,99,"Docklands",-18,2009,"Regular",10,"Away","Brisbane Lions","North Melbourne",18
13468,2009-05-30,"R10","St Kilda",11,17,83,"Melbourne",6,10,46,"Carrara",37,2009,"Regular",10,"Home","St Kilda","Melbourne",37
13469,2009-05-30,"R10","Fremantle",17,10,112,"Richmond",17,13,115,"Subiaco",-3,2009,"Regular",10,"Away","Richmond","Fremantle",3
13470,2009-05-31,"R10","Adelaide",16,10,106,"Hawthorn",12,7,79,"Football Park",27,2009,"Regular",10,"Home","Adelaide","Hawthorn",27
13471,2009-05-31,"R10","Essendon",11,4,70,"Geelong",20,14,134,"Docklands",-64,2009,"Regular",10,"Away","Geelong","Essendon",64
13472,2009-05-31,"R10","Collingwood",17,12,114,"Port Adelaide",11,10,76,"M.C.G.",38,2009,"Regular",10,"Home","Collingwood","Port Adelaide",38
13473,2009-06-05,"R11","Richmond",14,5,89,"Footscray",24,13,157,"Docklands",-68,2009,"Regular",11,"Away","Footscray","Richmond",68
13474,2009-06-06,"R11","North Melbourne",9,3,57,"St Kilda",15,13,103,"Docklands",-46,2009,"Regular",11,"Away","St Kilda","North Melbourne",46
13475,2009-06-06,"R11","Brisbane Lions",16,10,106,"Carlton",16,16,112,"Gabba",-6,2009,"Regular",11,"Away","Carlton","Brisbane Lions",6
13476,2009-06-06,"R11","Port Adelaide",14,10,94,"Fremantle",11,4,70,"Football Park",24,2009,"Regular",11,"Home","Port Adelaide","Fremantle",24
13477,2009-06-07,"R11","Essendon",18,6,114,"Adelaide",21,4,130,"Docklands",-16,2009,"Regular",11,"Away","Adelaide","Essendon",16
13478,2009-06-07,"R11","Hawthorn",12,14,86,"Sydney",11,9,75,"M.C.G.",11,2009,"Regular",11,"Home","Hawthorn","Sydney",11
13479,2009-06-07,"R11","West Coast",11,11,77,"Geelong",15,9,99,"Subiaco",-22,2009,"Regular",11,"Away","Geelong","West Coast",22
13480,2009-06-08,"R11","Melbourne",8,12,60,"Collingwood",19,12,126,"M.C.G.",-66,2009,"Regular",11,"Away","Collingwood","Melbourne",66
13481,2009-06-12,"R12","Carlton",14,11,95,"St Kilda",16,8,104,"Docklands",-9,2009,"Regular",12,"Away","St Kilda","Carlton",9
13482,2009-06-13,"R12","Footscray",21,11,137,"Port Adelaide",7,2,44,"Marrara Oval",93,2009,"Regular",12,"Home","Footscray","Port Adelaide",93
13483,2009-06-13,"R12","Richmond",13,14,92,"West Coast",11,11,77,"Docklands",15,2009,"Regular",12,"Home","Richmond","West Coast",15
13484,2009-06-14,"R12","Hawthorn",7,9,51,"Brisbane Lions",13,15,93,"York Park",-42,2009,"Regular",12,"Away","Brisbane Lions","Hawthorn",42
13485,2009-06-14,"R12","Adelaide",9,14,68,"North Melbourne",3,6,24,"Football Park",44,2009,"Regular",12,"Home","Adelaide","North Melbourne",44
13486,2009-06-19,"R12","Essendon",19,17,131,"Melbourne",13,5,83,"Docklands",48,2009,"Regular",12,"Home","Essendon","Melbourne",48
13487,2009-06-20,"R12","Sydney",9,12,66,"Collingwood",13,11,89,"Stadium Australia",-23,2009,"Regular",12,"Away","Collingwood","Sydney",23
13488,2009-06-21,"R12","Fremantle",11,9,75,"Geelong",13,16,94,"Subiaco",-19,2009,"Regular",12,"Away","Geelong","Fremantle",19
13489,2009-06-26,"R13","Essendon",21,10,136,"Carlton",9,13,67,"M.C.G.",69,2009,"Regular",13,"Home","Essendon","Carlton",69
13490,2009-06-27,"R13","Collingwood",26,13,169,"Fremantle",13,7,85,"M.C.G.",84,2009,"Regular",13,"Home","Collingwood","Fremantle",84
13491,2009-06-27,"R13","Adelaide",12,13,85,"Sydney",10,9,69,"Football Park",16,2009,"Regular",13,"Home","Adelaide","Sydney",16
13492,2009-06-27,"R13","Brisbane Lions",16,15,111,"Melbourne",8,8,56,"Gabba",55,2009,"Regular",13,"Home","Brisbane Lions","Melbourne",55
13493,2009-06-27,"R13","West Coast",16,11,107,"Hawthorn",13,9,87,"Subiaco",20,2009,"Regular",13,"Home","West Coast","Hawthorn",20
13494,2009-06-28,"R13","Geelong",18,14,122,"Port Adelaide",13,10,88,"Kardinia Park",34,2009,"Regular",13,"Home","Geelong","Port Adelaide",34
13495,2009-06-28,"R13","North Melbourne",12,14,86,"Footscray",17,6,108,"M.C.G.",-22,2009,"Regular",13,"Away","Footscray","North Melbourne",22
13496,2009-06-28,"R13","St Kilda",13,14,92,"Richmond",5,6,36,"Docklands",56,2009,"Regular",13,"Home","St Kilda","Richmond",56
13497,2009-07-03,"R14","Collingwood",15,12,102,"Essendon",9,13,67,"M.C.G.",35,2009,"Regular",14,"Home","Collingwood","Essendon",35
13498,2009-07-04,"R14","Melbourne",17,10,112,"West Coast",13,14,92,"M.C.G.",20,2009,"Regular",14,"Home","Melbourne","West Coast",20
13499,2009-07-04,"R14","Port Adelaide",19,14,128,"Brisbane Lions",11,14,80,"Football Park",48,2009,"Regular",14,"Home","Port Adelaide","Brisbane Lions",48
13500,2009-07-04,"R14","Richmond",13,7,85,"Adelaide",15,12,102,"Carrara",-17,2009,"Regular",14,"Away","Adelaide","Richmond",17
13501,2009-07-04,"R14","Footscray",19,19,133,"Hawthorn",6,9,45,"Docklands",88,2009,"Regular",14,"Home","Footscray","Hawthorn",88
13502,2009-07-05,"R14","Sydney",15,10,100,"North Melbourne",13,7,85,"S.C.G.",15,2009,"Regular",14,"Home","Sydney","North Melbourne",15
13503,2009-07-05,"R14","St Kilda",14,7,91,"Geelong",13,7,85,"Docklands",6,2009,"Regular",14,"Home","St Kilda","Geelong",6
13504,2009-07-05,"R14","Fremantle",15,10,100,"Carlton",16,19,115,"Subiaco",-15,2009,"Regular",14,"Away","Carlton","Fremantle",15
13505,2009-07-10,"R15","Footscray",16,14,110,"Collingwood",17,9,111,"Docklands",-1,2009,"Regular",15,"Away","Collingwood","Footscray",1
13506,2009-07-11,"R15","Carlton",16,13,109,"Richmond",12,17,89,"M.C.G.",20,2009,"Regular",15,"Home","Carlton","Richmond",20
13507,2009-07-11,"R15","Sydney",10,12,72,"Essendon",15,17,107,"S.C.G.",-35,2009,"Regular",15,"Away","Essendon","Sydney",35
13508,2009-07-11,"R15","Brisbane Lions",16,12,108,"Geelong",9,11,65,"Gabba",43,2009,"Regular",15,"Home","Brisbane Lions","Geelong",43
13509,2009-07-11,"R15","Adelaide",19,16,130,"Fremantle",1,7,13,"Football Park",117,2009,"Regular",15,"Home","Adelaide","Fremantle",117
13510,2009-07-12,"R15","Hawthorn",10,13,73,"North Melbourne",9,10,64,"York Park",9,2009,"Regular",15,"Home","Hawthorn","North Melbourne",9
13511,2009-07-12,"R15","Melbourne",15,11,101,"Port Adelaide",13,12,90,"M.C.G.",11,2009,"Regular",15,"Home","Melbourne","Port Adelaide",11
13512,2009-07-12,"R15","West Coast",11,4,70,"St Kilda",13,12,90,"Subiaco",-20,2009,"Regular",15,"Away","St Kilda","West Coast",20
13513,2009-07-17,"R16","Essendon",11,4,70,"Footscray",15,13,103,"Docklands",-33,2009,"Regular",16,"Away","Footscray","Essendon",33
13514,2009-07-18,"R16","Carlton",19,10,124,"Sydney",9,9,63,"Docklands",61,2009,"Regular",16,"Home","Carlton","Sydney",61
13515,2009-07-18,"R16","Geelong",17,15,117,"Melbourne",11,5,71,"Kardinia Park",46,2009,"Regular",16,"Home","Geelong","Melbourne",46
13516,2009-07-18,"R16","Collingwood",11,10,76,"Hawthorn",18,13,121,"M.C.G.",-45,2009,"Regular",16,"Away","Hawthorn","Collingwood",45
13517,2009-07-18,"R16","Fremantle",7,5,47,"Brisbane Lions",9,8,62,"Subiaco",-15,2009,"Regular",16,"Away","Brisbane Lions","Fremantle",15
13518,2009-07-19,"R16","Port Adelaide",17,10,112,"West Coast",11,10,76,"Football Park",36,2009,"Regular",16,"Home","Port Adelaide","West Coast",36
13519,2009-07-19,"R16","Richmond",12,13,85,"North Melbourne",12,13,85,"M.C.G.",0,2009,"Regular",16,"Home","Richmond","North Melbourne",0
13520,2009-07-19,"R16","St Kilda",15,15,105,"Adelaide",7,6,48,"Docklands",57,2009,"Regular",16,"Home","St Kilda","Adelaide",57
13521,2009-07-24,"R17","Carlton",4,16,40,"Collingwood",14,10,94,"M.C.G.",-54,2009,"Regular",17,"Away","Collingwood","Carlton",54
13522,2009-07-25,"R17","Geelong",15,9,99,"Hawthorn",14,14,98,"M.C.G.",1,2009,"Regular",17,"Home","Geelong","Hawthorn",1
13523,2009-07-25,"R17","Fremantle",10,11,71,"West Coast",8,18,66,"Subiaco",5,2009,"Regular",17,"Home","Fremantle","West Coast",5
13524,2009-07-25,"R17","St Kilda",16,10,106,"Footscray",9,7,61,"Docklands",45,2009,"Regular",17,"Home","St Kilda","Footscray",45
13525,2009-07-25,"R17","Brisbane Lions",17,14,116,"North Melbourne",11,9,75,"Gabba",41,2009,"Regular",17,"Home","Brisbane Lions","North Melbourne",41
13526,2009-07-26,"R17","Melbourne",6,14,50,"Sydney",10,8,68,"Manuka Oval",-18,2009,"Regular",17,"Away","Sydney","Melbourne",18
13527,2009-07-26,"R17","Essendon",14,12,96,"Richmond",15,11,101,"M.C.G.",-5,2009,"Regular",17,"Away","Richmond","Essendon",5
13528,2009-07-26,"R17","Adelaide",19,18,132,"Port Adelaide",9,8,62,"Football Park",70,2009,"Regular",17,"Home","Adelaide","Port Adelaide",70
13529,2009-07-31,"R18","North Melbourne",11,18,84,"Carlton",14,10,94,"Docklands",-10,2009,"Regular",18,"Away","Carlton","North Melbourne",10
13530,2009-08-01,"R18","Geelong",14,9,93,"Adelaide",13,13,91,"Kardinia Park",2,2009,"Regular",18,"Home","Geelong","Adelaide",2
13531,2009-08-01,"R18","Footscray",17,9,111,"Fremantle",11,14,80,"Docklands",31,2009,"Regular",18,"Home","Footscray","Fremantle",31
13532,2009-08-01,"R18","Collingwood",12,23,95,"Brisbane Lions",8,7,55,"M.C.G.",40,2009,"Regular",18,"Home","Collingwood","Brisbane Lions",40
13533,2009-08-01,"R18","Sydney",13,15,93,"St Kilda",13,16,94,"S.C.G.",-1,2009,"Regular",18,"Away","St Kilda","Sydney",1
13534,2009-08-02,"R18","Melbourne",12,10,82,"Richmond",12,14,86,"M.C.G.",-4,2009,"Regular",18,"Away","Richmond","Melbourne",4
13535,2009-08-02,"R18","Port Adelaide",18,13,121,"Hawthorn",14,19,103,"Football Park",18,2009,"Regular",18,"Home","Port Adelaide","Hawthorn",18
13536,2009-08-02,"R18","West Coast",14,11,95,"Essendon",10,8,68,"Subiaco",27,2009,"Regular",18,"Home","West Coast","Essendon",27
13537,2009-08-07,"R19","Carlton",14,13,97,"Geelong",8,14,62,"M.C.G.",35,2009,"Regular",19,"Home","Carlton","Geelong",35
13538,2009-08-08,"R19","Footscray",13,19,97,"West Coast",16,6,102,"Docklands",-5,2009,"Regular",19,"Away","West Coast","Footscray",5
13539,2009-08-08,"R19","Hawthorn",7,7,49,"St Kilda",10,14,74,"York Park",-25,2009,"Regular",19,"Away","St Kilda","Hawthorn",25
13540,2009-08-08,"R19","Essendon",13,9,87,"Brisbane Lions",12,15,87,"M.C.G.",0,2009,"Regular",19,"Home","Essendon","Brisbane Lions",0
13541,2009-08-08,"R19","Adelaide",9,14,68,"Collingwood",13,11,89,"Football Park",-21,2009,"Regular",19,"Away","Collingwood","Adelaide",21
13542,2009-08-09,"R19","North Melbourne",19,9,123,"Melbourne",8,13,61,"Docklands",62,2009,"Regular",19,"Home","North Melbourne","Melbourne",62
13543,2009-08-09,"R19","Richmond",10,8,68,"Sydney",18,15,123,"M.C.G.",-55,2009,"Regular",19,"Away","Sydney","Richmond",55
13544,2009-08-09,"R19","Fremantle",17,14,116,"Port Adelaide",11,8,74,"Subiaco",42,2009,"Regular",19,"Home","Fremantle","Port Adelaide",42
13545,2009-08-14,"R20","Hawthorn",9,13,67,"Adelaide",13,16,94,"M.C.G.",-27,2009,"Regular",20,"Away","Adelaide","Hawthorn",27
13546,2009-08-15,"R20","Richmond",8,11,59,"Collingwood",22,20,152,"M.C.G.",-93,2009,"Regular",20,"Away","Collingwood","Richmond",93
13547,2009-08-15,"R20","West Coast",17,8,110,"North Melbourne",10,12,72,"Subiaco",38,2009,"Regular",20,"Home","West Coast","North Melbourne",38
13548,2009-08-15,"R20","Brisbane Lions",12,12,84,"Footscray",15,12,102,"Gabba",-18,2009,"Regular",20,"Away","Footscray","Brisbane Lions",18
13549,2009-08-15,"R20","Sydney",13,9,87,"Geelong",13,14,92,"Stadium Australia",-5,2009,"Regular",20,"Away","Geelong","Sydney",5
13550,2009-08-16,"R20","Melbourne",20,7,127,"Fremantle",9,10,64,"M.C.G.",63,2009,"Regular",20,"Home","Melbourne","Fremantle",63
13551,2009-08-16,"R20","Port Adelaide",9,13,67,"Carlton",18,13,121,"Football Park",-54,2009,"Regular",20,"Away","Carlton","Port Adelaide",54
13552,2009-08-16,"R20","Essendon",16,14,110,"St Kilda",16,12,108,"Docklands",2,2009,"Regular",20,"Home","Essendon","St Kilda",2
13553,2009-08-21,"R21","Footscray",16,14,110,"Geelong",14,12,96,"Docklands",14,2009,"Regular",21,"Home","Footscray","Geelong",14
13554,2009-08-22,"R21","Carlton",24,9,153,"Melbourne",15,6,96,"Docklands",57,2009,"Regular",21,"Home","Carlton","Melbourne",57
13555,2009-08-22,"R21","Adelaide",18,14,122,"West Coast",7,6,48,"Football Park",74,2009,"Regular",21,"Home","Adelaide","West Coast",74
13556,2009-08-22,"R21","Richmond",14,9,93,"Hawthorn",20,15,135,"M.C.G.",-42,2009,"Regular",21,"Away","Hawthorn","Richmond",42
13557,2009-08-22,"R21","Brisbane Lions",16,11,107,"Port Adelaide",14,8,92,"Gabba",15,2009,"Regular",21,"Home","Brisbane Lions","Port Adelaide",15
13558,2009-08-23,"R21","St Kilda",8,11,59,"North Melbourne",10,4,64,"Docklands",-5,2009,"Regular",21,"Away","North Melbourne","St Kilda",5
13559,2009-08-23,"R21","Collingwood",13,19,97,"Sydney",8,8,56,"M.C.G.",41,2009,"Regular",21,"Home","Collingwood","Sydney",41
13560,2009-08-23,"R21","Fremantle",21,15,141,"Essendon",13,9,87,"Subiaco",54,2009,"Regular",21,"Home","Fremantle","Essendon",54
13561,2009-08-28,"R22","West Coast",17,23,125,"Richmond",6,9,45,"Subiaco",80,2009,"Regular",22,"Home","West Coast","Richmond",80
13562,2009-08-29,"R22","Geelong",14,10,94,"Fremantle",8,6,54,"Kardinia Park",40,2009,"Regular",22,"Home","Geelong","Fremantle",40
13563,2009-08-29,"R22","Hawthorn",14,15,99,"Essendon",16,20,116,"M.C.G.",-17,2009,"Regular",22,"Away","Essendon","Hawthorn",17
13564,2009-08-29,"R22","Carlton",16,8,104,"Adelaide",27,14,176,"Docklands",-72,2009,"Regular",22,"Away","Adelaide","Carlton",72
13565,2009-08-29,"R22","Sydney",14,8,92,"Brisbane Lions",15,10,100,"S.C.G.",-8,2009,"Regular",22,"Away","Brisbane Lions","Sydney",8
13566,2009-08-29,"R22","Port Adelaide",9,13,67,"North Melbourne",10,11,71,"Football Park",-4,2009,"Regular",22,"Away","North Melbourne","Port Adelaide",4
13567,2009-08-30,"R22","Melbourne",10,7,67,"St Kilda",17,12,114,"M.C.G.",-47,2009,"Regular",22,"Away","St Kilda","Melbourne",47
13568,2009-08-30,"R22","Collingwood",10,16,76,"Footscray",14,16,100,"Docklands",-24,2009,"Regular",22,"Away","Footscray","Collingwood",24
13569,2009-09-04,"EF","Adelaide",26,10,166,"Essendon",10,10,70,"Football Park",96,2009,"Finals",23,"Home","Adelaide","Essendon",96
13570,2009-09-05,"QF","Geelong",14,12,96,"Footscray",12,10,82,"M.C.G.",14,2009,"Finals",23,"Home","Geelong","Footscray",14
13571,2009-09-05,"EF","Brisbane Lions",16,15,111,"Carlton",15,14,104,"Gabba",7,2009,"Finals",23,"Home","Brisbane Lions","Carlton",7
13572,2009-09-06,"QF","St Kilda",12,8,80,"Collingwood",7,10,52,"M.C.G.",28,2009,"Finals",23,"Home","St Kilda","Collingwood",28
13573,2009-09-11,"SF","Footscray",16,11,107,"Brisbane Lions",8,8,56,"M.C.G.",51,2009,"Finals",24,"Home","Footscray","Brisbane Lions",51
13574,2009-09-12,"SF","Collingwood",12,11,83,"Adelaide",11,12,78,"M.C.G.",5,2009,"Finals",24,"Home","Collingwood","Adelaide",5
13575,2009-09-18,"PF","St Kilda",9,6,60,"Footscray",7,11,53,"M.C.G.",7,2009,"Finals",25,"Home","St Kilda","Footscray",7
13576,2009-09-19,"PF","Geelong",17,18,120,"Collingwood",6,11,47,"M.C.G.",73,2009,"Finals",25,"Home","Geelong","Collingwood",73
13577,2009-09-26,"GF","St Kilda",9,14,68,"Geelong",12,8,80,"M.C.G.",-12,2009,"Finals",26,"Away","Geelong","St Kilda",12
13578,2010-03-25,"R1","Richmond",9,10,64,"Carlton",18,12,120,"M.C.G.",-56,2010,"Regular",1,"Away","Carlton","Richmond",56
13579,2010-03-26,"R1","Geelong",19,11,125,"Essendon",13,16,94,"M.C.G.",31,2010,"Regular",1,"Home","Geelong","Essendon",31
13580,2010-03-27,"R1","Melbourne",8,13,61,"Hawthorn",17,15,117,"M.C.G.",-56,2010,"Regular",1,"Away","Hawthorn","Melbourne",56
13581,2010-03-27,"R1","Sydney",13,10,88,"St Kilda",15,6,96,"Stadium Australia",-8,2010,"Regular",1,"Away","St Kilda","Sydney",8
13582,2010-03-27,"R1","Brisbane Lions",16,18,114,"West Coast",12,10,82,"Gabba",32,2010,"Regular",1,"Home","Brisbane Lions","West Coast",32
13583,2010-03-28,"R1","Port Adelaide",13,18,96,"North Melbourne",12,10,82,"Football Park",14,2010,"Regular",1,"Home","Port Adelaide","North Melbourne",14
13584,2010-03-28,"R1","Footscray",13,15,93,"Collingwood",19,15,129,"Docklands",-36,2010,"Regular",1,"Away","Collingwood","Footscray",36
13585,2010-03-28,"R1","Fremantle",17,16,118,"Adelaide",9,8,62,"Subiaco",56,2010,"Regular",1,"Home","Fremantle","Adelaide",56
13586,2010-04-01,"R2","Brisbane Lions",16,11,107,"Carlton",12,16,88,"Gabba",19,2010,"Regular",2,"Home","Brisbane Lions","Carlton",19
13587,2010-04-03,"R2","Collingwood",12,14,86,"Melbourne",12,13,85,"M.C.G.",1,2010,"Regular",2,"Home","Collingwood","Melbourne",1
13588,2010-04-03,"R2","St Kilda",23,5,143,"North Melbourne",6,3,39,"Docklands",104,2010,"Regular",2,"Home","St Kilda","North Melbourne",104
13589,2010-04-03,"R2","West Coast",12,14,86,"Port Adelaide",13,11,89,"Subiaco",-3,2010,"Regular",2,"Away","Port Adelaide","West Coast",3
13590,2010-04-04,"R2","Adelaide",11,9,75,"Sydney",18,10,118,"Football Park",-43,2010,"Regular",2,"Away","Sydney","Adelaide",43
13591,2010-04-04,"R2","Essendon",9,15,69,"Fremantle",17,11,113,"Docklands",-44,2010,"Regular",2,"Away","Fremantle","Essendon",44
13592,2010-04-04,"R2","Richmond",7,6,48,"Footscray",17,18,120,"M.C.G.",-72,2010,"Regular",2,"Away","Footscray","Richmond",72
13593,2010-04-05,"R2","Hawthorn",13,13,91,"Geelong",14,16,100,"M.C.G.",-9,2010,"Regular",2,"Away","Geelong","Hawthorn",9
13594,2010-04-09,"R3","St Kilda",10,9,69,"Collingwood",4,17,41,"Docklands",28,2010,"Regular",3,"Home","St Kilda","Collingwood",28
13595,2010-04-10,"R3","North Melbourne",17,14,116,"West Coast",13,13,91,"Docklands",25,2010,"Regular",3,"Home","North Melbourne","West Coast",25
13596,2010-04-10,"R3","Port Adelaide",11,15,81,"Brisbane Lions",16,12,108,"Football Park",-27,2010,"Regular",3,"Away","Brisbane Lions","Port Adelaide",27
13597,2010-04-10,"R3","Carlton",10,15,75,"Essendon",13,17,95,"M.C.G.",-20,2010,"Regular",3,"Away","Essendon","Carlton",20
13598,2010-04-10,"R3","Sydney",16,15,111,"Richmond",7,14,56,"S.C.G.",55,2010,"Regular",3,"Home","Sydney","Richmond",55
13599,2010-04-11,"R3","Melbourne",7,15,57,"Adelaide",5,11,41,"M.C.G.",16,2010,"Regular",3,"Home","Melbourne","Adelaide",16
13600,2010-04-11,"R3","Footscray",14,16,100,"Hawthorn",12,12,84,"Docklands",16,2010,"Regular",3,"Home","Footscray","Hawthorn",16
13601,2010-04-11,"R3","Fremantle",18,17,125,"Geelong",17,16,118,"Subiaco",7,2010,"Regular",3,"Home","Fremantle","Geelong",7
13602,2010-04-16,"R4","West Coast",15,11,101,"Essendon",11,12,78,"Subiaco",23,2010,"Regular",4,"Home","West Coast","Essendon",23
13603,2010-04-17,"R4","North Melbourne",8,12,60,"Sydney",14,16,100,"Docklands",-40,2010,"Regular",4,"Away","Sydney","North Melbourne",40
13604,2010-04-17,"R4","Adelaide",6,19,55,"Carlton",16,7,103,"Football Park",-48,2010,"Regular",4,"Away","Carlton","Adelaide",48
13605,2010-04-17,"R4","Collingwood",17,21,123,"Hawthorn",8,11,59,"M.C.G.",64,2010,"Regular",4,"Home","Collingwood","Hawthorn",64
13606,2010-04-17,"R4","Brisbane Lions",13,23,101,"Footscray",12,7,79,"Gabba",22,2010,"Regular",4,"Home","Brisbane Lions","Footscray",22
13607,2010-04-18,"R4","Richmond",11,12,78,"Melbourne",20,13,133,"M.C.G.",-55,2010,"Regular",4,"Away","Melbourne","Richmond",55
13608,2010-04-18,"R4","Geelong",23,21,159,"Port Adelaide",10,4,64,"Kardinia Park",95,2010,"Regular",4,"Home","Geelong","Port Adelaide",95
13609,2010-04-18,"R4","St Kilda",16,12,108,"Fremantle",14,9,93,"Docklands",15,2010,"Regular",4,"Home","St Kilda","Fremantle",15
13610,2010-04-23,"R5","Footscray",18,13,121,"Adelaide",10,12,72,"Docklands",49,2010,"Regular",5,"Home","Footscray","Adelaide",49
13611,2010-04-24,"R5","Sydney",17,13,115,"West Coast",9,9,63,"S.C.G.",52,2010,"Regular",5,"Home","Sydney","West Coast",52
13612,2010-04-24,"R5","Melbourne",15,13,103,"Brisbane Lions",7,11,53,"M.C.G.",50,2010,"Regular",5,"Home","Melbourne","Brisbane Lions",50
13613,2010-04-24,"R5","Port Adelaide",7,12,54,"St Kilda",6,8,44,"Football Park",10,2010,"Regular",5,"Home","Port Adelaide","St Kilda",10
13614,2010-04-25,"R5","Collingwood",18,12,120,"Essendon",8,7,55,"M.C.G.",65,2010,"Regular",5,"Home","Collingwood","Essendon",65
13615,2010-04-25,"R5","Hawthorn",10,10,70,"North Melbourne",12,10,82,"York Park",-12,2010,"Regular",5,"Away","North Melbourne","Hawthorn",12
13616,2010-04-25,"R5","Fremantle",15,22,112,"Richmond",11,7,73,"Subiaco",39,2010,"Regular",5,"Home","Fremantle","Richmond",39
13617,2010-04-26,"R5","Carlton",15,14,104,"Geelong",9,14,68,"M.C.G.",36,2010,"Regular",5,"Home","Carlton","Geelong",36
13618,2010-04-30,"R6","Footscray",6,10,46,"St Kilda",7,7,49,"Docklands",-3,2010,"Regular",6,"Away","St Kilda","Footscray",3
13619,2010-05-01,"R6","North Melbourne",15,14,104,"Melbourne",12,6,78,"Docklands",26,2010,"Regular",6,"Home","North Melbourne","Melbourne",26
13620,2010-05-01,"R6","Adelaide",10,14,74,"Port Adelaide",14,13,97,"Football Park",-23,2010,"Regular",6,"Away","Port Adelaide","Adelaide",23
13621,2010-05-01,"R6","Essendon",15,16,106,"Hawthorn",9,9,63,"M.C.G.",43,2010,"Regular",6,"Home","Essendon","Hawthorn",43
13622,2010-05-01,"R6","Sydney",16,11,107,"Brisbane Lions",13,9,87,"S.C.G.",20,2010,"Regular",6,"Home","Sydney","Brisbane Lions",20
13623,2010-05-02,"R6","Geelong",24,17,161,"Richmond",7,11,53,"Kardinia Park",108,2010,"Regular",6,"Home","Geelong","Richmond",108
13624,2010-05-02,"R6","Carlton",16,6,102,"Collingwood",24,11,155,"M.C.G.",-53,2010,"Regular",6,"Away","Collingwood","Carlton",53
13625,2010-05-02,"R6","West Coast",10,13,73,"Fremantle",17,9,111,"Subiaco",-38,2010,"Regular",6,"Away","Fremantle","West Coast",38
13626,2010-05-07,"R7","Melbourne",9,12,66,"Footscray",10,10,70,"M.C.G.",-4,2010,"Regular",7,"Away","Footscray","Melbourne",4
13627,2010-05-08,"R7","Essendon",16,10,106,"Port Adelaide",17,7,109,"Docklands",-3,2010,"Regular",7,"Away","Port Adelaide","Essendon",3
13628,2010-05-08,"R7","West Coast",15,12,102,"Hawthorn",14,10,94,"Subiaco",8,2010,"Regular",7,"Home","West Coast","Hawthorn",8
13629,2010-05-08,"R7","Collingwood",23,19,157,"North Melbourne",14,7,91,"M.C.G.",66,2010,"Regular",7,"Home","Collingwood","North Melbourne",66
13630,2010-05-08,"R7","Brisbane Lions",15,10,100,"Fremantle",15,23,113,"Gabba",-13,2010,"Regular",7,"Away","Fremantle","Brisbane Lions",13
13631,2010-05-09,"R7","Geelong",19,12,126,"Sydney",9,5,59,"Kardinia Park",67,2010,"Regular",7,"Home","Geelong","Sydney",67
13632,2010-05-09,"R7","Adelaide",15,14,104,"Richmond",7,12,54,"Football Park",50,2010,"Regular",7,"Home","Adelaide","Richmond",50
13633,2010-05-10,"R7","St Kilda",9,14,68,"Carlton",20,9,129,"Docklands",-61,2010,"Regular",7,"Away","Carlton","St Kilda",61
13634,2010-05-14,"R8","Fremantle",15,7,97,"Collingwood",20,13,133,"Subiaco",-36,2010,"Regular",8,"Away","Collingwood","Fremantle",36
13635,2010-05-15,"R8","Footscray",14,17,101,"Sydney",9,9,63,"Manuka Oval",38,2010,"Regular",8,"Home","Footscray","Sydney",38
13636,2010-05-15,"R8","Melbourne",6,10,46,"West Coast",10,15,75,"M.C.G.",-29,2010,"Regular",8,"Away","West Coast","Melbourne",29
13637,2010-05-15,"R8","North Melbourne",12,12,84,"Adelaide",11,9,75,"Docklands",9,2010,"Regular",8,"Home","North Melbourne","Adelaide",9
13638,2010-05-15,"R8","Brisbane Lions",10,14,74,"Geelong",24,11,155,"Gabba",-81,2010,"Regular",8,"Away","Geelong","Brisbane Lions",81
13639,2010-05-16,"R8","Richmond",13,8,86,"Hawthorn",13,11,89,"M.C.G.",-3,2010,"Regular",8,"Away","Hawthorn","Richmond",3
13640,2010-05-16,"R8","Port Adelaide",14,8,92,"Carlton",17,16,118,"Football Park",-26,2010,"Regular",8,"Away","Carlton","Port Adelaide",26
13641,2010-05-16,"R8","St Kilda",11,15,81,"Essendon",14,9,93,"Docklands",-12,2010,"Regular",8,"Away","Essendon","St Kilda",12
13642,2010-05-21,"R9","Collingwood",6,14,50,"Geelong",12,14,86,"M.C.G.",-36,2010,"Regular",9,"Away","Geelong","Collingwood",36
13643,2010-05-22,"R9","North Melbourne",7,15,57,"Footscray",20,7,127,"Docklands",-70,2010,"Regular",9,"Away","Footscray","North Melbourne",70
13644,2010-05-22,"R9","Sydney",9,9,63,"Fremantle",14,16,100,"S.C.G.",-37,2010,"Regular",9,"Away","Fremantle","Sydney",37
13645,2010-05-22,"R9","Melbourne",17,9,111,"Port Adelaide",16,14,110,"Marrara Oval",1,2010,"Regular",9,"Home","Melbourne","Port Adelaide",1
13646,2010-05-22,"R9","Essendon",19,16,130,"Richmond",14,11,95,"M.C.G.",35,2010,"Regular",9,"Home","Essendon","Richmond",35
13647,2010-05-23,"R9","Adelaide",13,15,93,"Brisbane Lions",11,15,81,"Football Park",12,2010,"Regular",9,"Home","Adelaide","Brisbane Lions",12
13648,2010-05-23,"R9","Carlton",8,12,60,"Hawthorn",16,14,110,"Docklands",-50,2010,"Regular",9,"Away","Hawthorn","Carlton",50
13649,2010-05-23,"R9","West Coast",8,8,56,"St Kilda",13,13,91,"Subiaco",-35,2010,"Regular",9,"Away","St Kilda","West Coast",35
13650,2010-05-28,"R10","Essendon",15,9,99,"Footscray",14,6,90,"Docklands",9,2010,"Regular",10,"Home","Essendon","Footscray",9
13651,2010-05-29,"R10","Geelong",18,13,121,"Melbourne",10,7,67,"Kardinia Park",54,2010,"Regular",10,"Home","Geelong","Melbourne",54
13652,2010-05-29,"R10","Port Adelaide",3,12,30,"Richmond",10,17,77,"Football Park",-47,2010,"Regular",10,"Away","Richmond","Port Adelaide",47
13653,2010-05-29,"R10","St Kilda",19,9,123,"Adelaide",12,4,76,"Docklands",47,2010,"Regular",10,"Home","St Kilda","Adelaide",47
13654,2010-05-29,"R10","Brisbane Lions",13,10,88,"Collingwood",11,14,80,"Gabba",8,2010,"Regular",10,"Home","Brisbane Lions","Collingwood",8
13655,2010-05-30,"R10","Hawthorn",10,19,79,"Sydney",11,11,77,"M.C.G.",2,2010,"Regular",10,"Home","Hawthorn","Sydney",2
13656,2010-05-30,"R10","Carlton",15,15,105,"West Coast",11,10,76,"Docklands",29,2010,"Regular",10,"Home","Carlton","West Coast",29
13657,2010-05-30,"R10","Fremantle",21,13,139,"North Melbourne",11,12,78,"Subiaco",61,2010,"Regular",10,"Home","Fremantle","North Melbourne",61
13658,2010-06-04,"R11","Richmond",8,11,59,"St Kilda",14,13,97,"Docklands",-38,2010,"Regular",11,"Away","St Kilda","Richmond",38
13659,2010-06-05,"R11","Carlton",15,11,101,"Melbourne",9,6,60,"M.C.G.",41,2010,"Regular",11,"Home","Carlton","Melbourne",41
13660,2010-06-05,"R11","Adelaide",16,9,105,"Fremantle",12,10,82,"Football Park",23,2010,"Regular",11,"Home","Adelaide","Fremantle",23
13661,2010-06-05,"R11","North Melbourne",12,18,90,"Brisbane Lions",13,11,89,"Docklands",1,2010,"Regular",11,"Home","North Melbourne","Brisbane Lions",1
13662,2010-06-05,"R11","West Coast",14,14,98,"Geelong",18,14,122,"Subiaco",-24,2010,"Regular",11,"Away","Geelong","West Coast",24
13663,2010-06-06,"R11","Sydney",12,17,89,"Essendon",12,8,80,"S.C.G.",9,2010,"Regular",11,"Home","Sydney","Essendon",9
13664,2010-06-06,"R11","Hawthorn",10,14,74,"Port Adelaide",8,15,63,"M.C.G.",11,2010,"Regular",11,"Home","Hawthorn","Port Adelaide",11
13665,2010-06-06,"R11","Collingwood",17,11,113,"Footscray",16,7,103,"Docklands",10,2010,"Regular",11,"Home","Collingwood","Footscray",10
13666,2010-06-11,"R12","North Melbourne",14,13,97,"Carlton",10,8,68,"Docklands",29,2010,"Regular",12,"Home","North Melbourne","Carlton",29
13667,2010-06-12,"R12","Hawthorn",19,10,124,"Adelaide",11,11,77,"York Park",47,2010,"Regular",12,"Home","Hawthorn","Adelaide",47
13668,2010-06-12,"R12","Essendon",12,11,83,"Geelong",23,16,154,"Docklands",-71,2010,"Regular",12,"Away","Geelong","Essendon",71
13669,2010-06-12,"R12","Port Adelaide",8,7,55,"Sydney",14,9,93,"Football Park",-38,2010,"Regular",12,"Away","Sydney","Port Adelaide",38
13670,2010-06-13,"R12","Richmond",19,12,126,"West Coast",11,11,77,"M.C.G.",49,2010,"Regular",12,"Home","Richmond","West Coast",49
13671,2010-06-13,"R12","Footscray",17,19,121,"Brisbane Lions",8,8,56,"Docklands",65,2010,"Regular",12,"Home","Footscray","Brisbane Lions",65
13672,2010-06-13,"R12","Fremantle",10,7,67,"St Kilda",12,13,85,"Subiaco",-18,2010,"Regular",12,"Away","St Kilda","Fremantle",18
13673,2010-06-14,"R12","Melbourne",11,10,76,"Collingwood",9,22,76,"M.C.G.",0,2010,"Regular",12,"Home","Melbourne","Collingwood",0
13674,2010-06-18,"R13","Hawthorn",14,18,102,"Essendon",13,8,86,"M.C.G.",16,2010,"Regular",13,"Home","Hawthorn","Essendon",16
13675,2010-06-19,"R13","Carlton",12,15,87,"Fremantle",14,12,96,"Docklands",-9,2010,"Regular",13,"Away","Fremantle","Carlton",9
13676,2010-06-19,"R13","Brisbane Lions",12,14,86,"Richmond",15,15,105,"Gabba",-19,2010,"Regular",13,"Away","Richmond","Brisbane Lions",19
13677,2010-06-20,"R13","North Melbourne",19,15,129,"Port Adelaide",14,9,93,"Docklands",36,2010,"Regular",13,"Home","North Melbourne","Port Adelaide",36
13678,2010-06-20,"R13","West Coast",9,5,59,"Footscray",17,17,119,"Subiaco",-60,2010,"Regular",13,"Away","Footscray","West Coast",60
13679,2010-06-25,"R13","St Kilda",10,10,70,"Geelong",6,10,46,"M.C.G.",24,2010,"Regular",13,"Home","St Kilda","Geelong",24
13680,2010-06-26,"R13","Sydney",10,11,71,"Collingwood",13,18,96,"Stadium Australia",-25,2010,"Regular",13,"Away","Collingwood","Sydney",25
13681,2010-06-27,"R13","Adelaide",16,21,117,"Melbourne",11,7,73,"Football Park",44,2010,"Regular",13,"Home","Adelaide","Melbourne",44
13682,2010-07-01,"R14","Carlton",18,12,120,"Brisbane Lions",9,11,65,"Docklands",55,2010,"Regular",14,"Home","Carlton","Brisbane Lions",55
13683,2010-07-02,"R14","Hawthorn",12,7,79,"Footscray",11,10,76,"M.C.G.",3,2010,"Regular",14,"Home","Hawthorn","Footscray",3
13684,2010-07-03,"R14","Fremantle",17,13,115,"Port Adelaide",8,10,58,"Subiaco",57,2010,"Regular",14,"Home","Fremantle","Port Adelaide",57
13685,2010-07-03,"R14","Collingwood",20,15,135,"West Coast",7,10,52,"Docklands",83,2010,"Regular",14,"Home","Collingwood","West Coast",83
13686,2010-07-03,"R14","Adelaide",19,10,124,"Essendon",5,10,40,"Football Park",84,2010,"Regular",14,"Home","Adelaide","Essendon",84
13687,2010-07-04,"R14","Geelong",14,14,98,"North Melbourne",9,9,63,"Kardinia Park",35,2010,"Regular",14,"Home","Geelong","North Melbourne",35
13688,2010-07-04,"R14","Richmond",14,5,89,"Sydney",12,13,85,"M.C.G.",4,2010,"Regular",14,"Home","Richmond","Sydney",4
13689,2010-07-04,"R14","St Kilda",15,10,100,"Melbourne",9,11,65,"Docklands",35,2010,"Regular",14,"Home","St Kilda","Melbourne",35
13690,2010-07-09,"R15","Port Adelaide",12,7,79,"Collingwood",16,9,105,"Football Park",-26,2010,"Regular",15,"Away","Collingwood","Port Adelaide",26
13691,2010-07-10,"R15","Geelong",12,13,85,"Hawthorn",11,17,83,"M.C.G.",2,2010,"Regular",15,"Home","Geelong","Hawthorn",2
13692,2010-07-10,"R15","West Coast",14,11,95,"Adelaide",17,15,117,"Subiaco",-22,2010,"Regular",15,"Away","Adelaide","West Coast",22
13693,2010-07-10,"R15","Richmond",15,10,100,"Fremantle",11,15,81,"Docklands",19,2010,"Regular",15,"Home","Richmond","Fremantle",19
13694,2010-07-10,"R15","Brisbane Lions",10,5,65,"St Kilda",11,13,79,"Gabba",-14,2010,"Regular",15,"Away","St Kilda","Brisbane Lions",14
13695,2010-07-11,"R15","Sydney",12,13,85,"North Melbourne",7,13,55,"S.C.G.",30,2010,"Regular",15,"Home","Sydney","North Melbourne",30
13696,2010-07-11,"R15","Melbourne",19,8,122,"Essendon",14,19,103,"M.C.G.",19,2010,"Regular",15,"Home","Melbourne","Essendon",19
13697,2010-07-11,"R15","Carlton",8,10,58,"Footscray",20,6,126,"Docklands",-68,2010,"Regular",15,"Away","Footscray","Carlton",68
13698,2010-07-16,"R16","Adelaide",11,8,74,"Geelong",9,9,63,"Football Park",11,2010,"Regular",16,"Home","Adelaide","Geelong",11
13699,2010-07-17,"R16","Collingwood",15,10,100,"St Kilda",6,16,52,"M.C.G.",48,2010,"Regular",16,"Home","Collingwood","St Kilda",48
13700,2010-07-17,"R16","Hawthorn",17,16,118,"Brisbane Lions",7,1,43,"York Park",75,2010,"Regular",16,"Home","Hawthorn","Brisbane Lions",75
13701,2010-07-17,"R16","Essendon",14,16,100,"West Coast",20,12,132,"Docklands",-32,2010,"Regular",16,"Away","West Coast","Essendon",32
13702,2010-07-17,"R16","Footscray",12,11,83,"Port Adelaide",7,5,47,"Marrara Oval",36,2010,"Regular",16,"Home","Footscray","Port Adelaide",36
13703,2010-07-18,"R16","Carlton",10,8,68,"Sydney",16,11,107,"Docklands",-39,2010,"Regular",16,"Away","Sydney","Carlton",39
13704,2010-07-18,"R16","Richmond",7,11,53,"North Melbourne",15,13,103,"M.C.G.",-50,2010,"Regular",16,"Away","North Melbourne","Richmond",50
13705,2010-07-18,"R16","Fremantle",11,16,82,"Melbourne",10,11,71,"Subiaco",11,2010,"Regular",16,"Home","Fremantle","Melbourne",11
13706,2010-07-23,"R17","St Kilda",14,3,87,"Hawthorn",13,9,87,"Docklands",0,2010,"Regular",17,"Home","St Kilda","Hawthorn",0
13707,2010-07-24,"R17","Collingwood",19,13,127,"Richmond",6,9,45,"M.C.G.",82,2010,"Regular",17,"Home","Collingwood","Richmond",82
13708,2010-07-24,"R17","Geelong",19,13,127,"Brisbane Lions",9,10,64,"Kardinia Park",63,2010,"Regular",17,"Home","Geelong","Brisbane Lions",63
13709,2010-07-24,"R17","North Melbourne",18,11,119,"Essendon",18,14,122,"Docklands",-3,2010,"Regular",17,"Away","Essendon","North Melbourne",3
13710,2010-07-24,"R17","West Coast",11,17,83,"Carlton",15,19,109,"Subiaco",-26,2010,"Regular",17,"Away","Carlton","West Coast",26
13711,2010-07-25,"R17","Footscray",24,14,158,"Fremantle",12,4,76,"Docklands",82,2010,"Regular",17,"Home","Footscray","Fremantle",82
13712,2010-07-25,"R17","Melbourne",22,10,142,"Sydney",10,9,69,"M.C.G.",73,2010,"Regular",17,"Home","Melbourne","Sydney",73
13713,2010-07-25,"R17","Port Adelaide",13,10,88,"Adelaide",9,15,69,"Football Park",19,2010,"Regular",17,"Home","Port Adelaide","Adelaide",19
13714,2010-07-30,"R18","Essendon",16,12,108,"St Kilda",11,9,75,"Docklands",33,2010,"Regular",18,"Home","Essendon","St Kilda",33
13715,2010-07-31,"R18","Collingwood",15,15,105,"Carlton",9,3,57,"M.C.G.",48,2010,"Regular",18,"Home","Collingwood","Carlton",48
13716,2010-07-31,"R18","Port Adelaide",13,14,92,"Hawthorn",12,12,84,"Football Park",8,2010,"Regular",18,"Home","Port Adelaide","Hawthorn",8
13717,2010-07-31,"R18","Sydney",9,18,72,"Geelong",20,5,125,"Stadium Australia",-53,2010,"Regular",18,"Away","Geelong","Sydney",53
13718,2010-07-31,"R18","Brisbane Lions",9,10,64,"Melbourne",11,8,74,"Gabba",-10,2010,"Regular",18,"Away","Melbourne","Brisbane Lions",10
13719,2010-08-01,"R18","Richmond",15,10,100,"Adelaide",11,14,80,"M.C.G.",20,2010,"Regular",18,"Home","Richmond","Adelaide",20
13720,2010-08-01,"R18","Footscray",22,11,143,"North Melbourne",10,12,72,"Docklands",71,2010,"Regular",18,"Home","Footscray","North Melbourne",71
13721,2010-08-01,"R18","Fremantle",24,16,160,"West Coast",13,7,85,"Subiaco",75,2010,"Regular",18,"Home","Fremantle","West Coast",75
13722,2010-08-06,"R19","Essendon",9,19,73,"Carlton",23,11,149,"M.C.G.",-76,2010,"Regular",19,"Away","Carlton","Essendon",76
13723,2010-08-07,"R19","North Melbourne",19,9,123,"Fremantle",10,9,69,"Docklands",54,2010,"Regular",19,"Home","North Melbourne","Fremantle",54
13724,2010-08-07,"R19","Sydney",19,15,129,"Hawthorn",13,7,85,"S.C.G.",44,2010,"Regular",19,"Home","Sydney","Hawthorn",44
13725,2010-08-07,"R19","Geelong",12,13,85,"Collingwood",14,23,107,"M.C.G.",-22,2010,"Regular",19,"Away","Collingwood","Geelong",22
13726,2010-08-07,"R19","West Coast",9,11,65,"Brisbane Lions",10,10,70,"Subiaco",-5,2010,"Regular",19,"Away","Brisbane Lions","West Coast",5
13727,2010-08-08,"R19","St Kilda",23,13,151,"Port Adelaide",8,9,57,"Docklands",94,2010,"Regular",19,"Home","St Kilda","Port Adelaide",94
13728,2010-08-08,"R19","Melbourne",16,13,109,"Richmond",11,14,80,"M.C.G.",29,2010,"Regular",19,"Home","Melbourne","Richmond",29
13729,2010-08-08,"R19","Adelaide",7,11,53,"Footscray",8,13,61,"Football Park",-8,2010,"Regular",19,"Away","Footscray","Adelaide",8
13730,2010-08-13,"R20","Essendon",10,4,64,"Collingwood",24,18,162,"M.C.G.",-98,2010,"Regular",20,"Away","Collingwood","Essendon",98
13731,2010-08-14,"R20","Carlton",23,18,156,"Richmond",10,7,67,"M.C.G.",89,2010,"Regular",20,"Home","Carlton","Richmond",89
13732,2010-08-14,"R20","Fremantle",13,9,87,"Sydney",14,12,96,"Subiaco",-9,2010,"Regular",20,"Away","Sydney","Fremantle",9
13733,2010-08-14,"R20","Footscray",9,6,60,"Geelong",25,11,161,"Docklands",-101,2010,"Regular",20,"Away","Geelong","Footscray",101
13734,2010-08-14,"R20","Port Adelaide",8,13,61,"West Coast",8,12,60,"Football Park",1,2010,"Regular",20,"Home","Port Adelaide","West Coast",1
13735,2010-08-15,"R20","Brisbane Lions",13,19,97,"Adelaide",15,14,104,"Gabba",-7,2010,"Regular",20,"Away","Adelaide","Brisbane Lions",7
13736,2010-08-15,"R20","Hawthorn",15,9,99,"Melbourne",12,6,78,"M.C.G.",21,2010,"Regular",20,"Home","Hawthorn","Melbourne",21
13737,2010-08-15,"R20","North Melbourne",9,9,63,"St Kilda",17,13,115,"Docklands",-52,2010,"Regular",20,"Away","St Kilda","North Melbourne",52
13738,2010-08-20,"R21","Geelong",18,13,121,"Carlton",12,7,79,"Docklands",42,2010,"Regular",21,"Home","Geelong","Carlton",42
13739,2010-08-21,"R21","Hawthorn",24,11,155,"Fremantle",5,9,39,"York Park",116,2010,"Regular",21,"Home","Hawthorn","Fremantle",116
13740,2010-08-21,"R21","St Kilda",17,13,115,"Richmond",14,10,94,"Docklands",21,2010,"Regular",21,"Home","St Kilda","Richmond",21
13741,2010-08-21,"R21","Collingwood",6,18,54,"Adelaide",7,9,51,"M.C.G.",3,2010,"Regular",21,"Home","Collingwood","Adelaide",3
13742,2010-08-21,"R21","Sydney",17,12,114,"Footscray",10,10,70,"S.C.G.",44,2010,"Regular",21,"Home","Sydney","Footscray",44
13743,2010-08-22,"R21","Port Adelaide",17,10,112,"Melbourne",11,17,83,"Football Park",29,2010,"Regular",21,"Home","Port Adelaide","Melbourne",29
13744,2010-08-22,"R21","Essendon",10,8,68,"Brisbane Lions",14,11,95,"Docklands",-27,2010,"Regular",21,"Away","Brisbane Lions","Essendon",27
13745,2010-08-22,"R21","West Coast",14,10,94,"North Melbourne",16,14,110,"Subiaco",-16,2010,"Regular",21,"Away","North Melbourne","West Coast",16
13746,2010-08-27,"R22","Fremantle",13,15,93,"Carlton",13,9,87,"Subiaco",6,2010,"Regular",22,"Home","Fremantle","Carlton",6
13747,2010-08-28,"R22","Geelong",16,16,112,"West Coast",10,8,68,"Kardinia Park",44,2010,"Regular",22,"Home","Geelong","West Coast",44
13748,2010-08-28,"R22","Hawthorn",15,8,98,"Collingwood",13,17,95,"M.C.G.",3,2010,"Regular",22,"Home","Hawthorn","Collingwood",3
13749,2010-08-28,"R22","Adelaide",9,11,65,"St Kilda",5,7,37,"Football Park",28,2010,"Regular",22,"Home","Adelaide","St Kilda",28
13750,2010-08-28,"R22","Footscray",17,5,107,"Essendon",11,12,78,"Docklands",29,2010,"Regular",22,"Home","Footscray","Essendon",29
13751,2010-08-28,"R22","Brisbane Lions",10,8,68,"Sydney",16,10,106,"Gabba",-38,2010,"Regular",22,"Away","Sydney","Brisbane Lions",38
13752,2010-08-29,"R22","Richmond",16,16,112,"Port Adelaide",18,14,122,"Docklands",-10,2010,"Regular",22,"Away","Port Adelaide","Richmond",10
13753,2010-08-29,"R22","Melbourne",15,13,103,"North Melbourne",17,11,113,"M.C.G.",-10,2010,"Regular",22,"Away","North Melbourne","Melbourne",10
13754,2010-09-03,"QF","Geelong",11,13,79,"St Kilda",12,11,83,"M.C.G.",-4,2010,"Finals",23,"Away","St Kilda","Geelong",4
13755,2010-09-04,"EF","Fremantle",14,10,94,"Hawthorn",8,16,64,"Subiaco",30,2010,"Finals",23,"Home","Fremantle","Hawthorn",30
13756,2010-09-04,"QF","Collingwood",17,22,124,"Footscray",8,14,62,"M.C.G.",62,2010,"Finals",23,"Home","Collingwood","Footscray",62
13757,2010-09-05,"EF","Sydney",14,15,99,"Carlton",13,16,94,"Stadium Australia",5,2010,"Finals",23,"Home","Sydney","Carlton",5
13758,2010-09-10,"SF","Geelong",20,15,135,"Fremantle",10,6,66,"M.C.G.",69,2010,"Finals",24,"Home","Geelong","Fremantle",69
13759,2010-09-11,"SF","Footscray",11,11,77,"Sydney",10,12,72,"M.C.G.",5,2010,"Finals",24,"Home","Footscray","Sydney",5
13760,2010-09-17,"PF","Collingwood",18,12,120,"Geelong",11,13,79,"M.C.G.",41,2010,"Finals",25,"Home","Collingwood","Geelong",41
13761,2010-09-18,"PF","St Kilda",13,10,88,"Footscray",8,16,64,"M.C.G.",24,2010,"Finals",25,"Home","St Kilda","Footscray",24
13762,2010-09-25,"GF","Collingwood",9,14,68,"St Kilda",10,8,68,"M.C.G.",0,2010,"Finals",26,"Home","Collingwood","St Kilda",0
13763,2010-10-02,"GF","Collingwood",16,12,108,"St Kilda",7,10,52,"M.C.G.",56,2010,"Finals",26,"Home","Collingwood","St Kilda",56
13764,2011-03-24,"R1","Carlton",14,20,104,"Richmond",13,6,84,"M.C.G.",20,2011,"Regular",1,"Home","Carlton","Richmond",20
13765,2011-03-25,"R1","Geelong",6,12,48,"St Kilda",6,11,47,"M.C.G.",1,2011,"Regular",1,"Home","Geelong","St Kilda",1
13766,2011-03-26,"R1","Collingwood",24,11,155,"Port Adelaide",12,8,80,"Docklands",75,2011,"Regular",1,"Home","Collingwood","Port Adelaide",75
13767,2011-03-26,"R1","Adelaide",16,9,105,"Hawthorn",12,13,85,"Football Park",20,2011,"Regular",1,"Home","Adelaide","Hawthorn",20
13768,2011-03-26,"R1","Brisbane Lions",14,8,92,"Fremantle",13,16,94,"Gabba",-2,2011,"Regular",1,"Away","Fremantle","Brisbane Lions",2
13769,2011-03-27,"R1","Essendon",16,17,113,"Footscray",8,10,58,"Docklands",55,2011,"Regular",1,"Home","Essendon","Footscray",55
13770,2011-03-27,"R1","Melbourne",11,18,84,"Sydney",11,18,84,"M.C.G.",0,2011,"Regular",1,"Home","Melbourne","Sydney",0
13771,2011-03-27,"R1","West Coast",13,14,92,"North Melbourne",13,10,88,"Subiaco",4,2011,"Regular",1,"Home","West Coast","North Melbourne",4
13772,2011-04-01,"R2","St Kilda",13,17,95,"Richmond",14,11,95,"M.C.G.",0,2011,"Regular",2,"Home","St Kilda","Richmond",0
13773,2011-04-02,"R2","North Melbourne",7,14,56,"Collingwood",21,17,143,"Docklands",-87,2011,"Regular",2,"Away","Collingwood","North Melbourne",87
13774,2011-04-02,"R2","Port Adelaide",15,8,98,"West Coast",16,20,116,"Football Park",-18,2011,"Regular",2,"Away","West Coast","Port Adelaide",18
13775,2011-04-02,"R2","Gold Coast",7,10,52,"Carlton",26,15,171,"Gabba",-119,2011,"Regular",2,"Away","Carlton","Gold Coast",119
13776,2011-04-02,"R2","Fremantle",10,18,78,"Geelong",13,11,89,"Subiaco",-11,2011,"Regular",2,"Away","Geelong","Fremantle",11
13777,2011-04-03,"R2","Footscray",19,9,123,"Brisbane Lions",6,9,45,"Docklands",78,2011,"Regular",2,"Home","Footscray","Brisbane Lions",78
13778,2011-04-03,"R2","Sydney",14,14,98,"Essendon",13,15,93,"Stadium Australia",5,2011,"Regular",2,"Home","Sydney","Essendon",5
13779,2011-04-03,"R2","Hawthorn",16,26,122,"Melbourne",12,5,77,"M.C.G.",45,2011,"Regular",2,"Home","Hawthorn","Melbourne",45
13780,2011-04-08,"R3","Collingwood",15,12,102,"Carlton",11,8,74,"M.C.G.",28,2011,"Regular",3,"Home","Collingwood","Carlton",28
13781,2011-04-09,"R3","Footscray",18,14,122,"Gold Coast",7,9,51,"Docklands",71,2011,"Regular",3,"Home","Footscray","Gold Coast",71
13782,2011-04-09,"R3","Adelaide",7,12,54,"Fremantle",11,13,79,"Football Park",-25,2011,"Regular",3,"Away","Fremantle","Adelaide",25
13783,2011-04-09,"R3","Richmond",6,16,52,"Hawthorn",17,13,115,"M.C.G.",-63,2011,"Regular",3,"Away","Hawthorn","Richmond",63
13784,2011-04-09,"R3","West Coast",13,10,88,"Sydney",15,11,101,"Subiaco",-13,2011,"Regular",3,"Away","Sydney","West Coast",13
13785,2011-04-10,"R3","Melbourne",12,10,82,"Brisbane Lions",11,5,71,"M.C.G.",11,2011,"Regular",3,"Home","Melbourne","Brisbane Lions",11
13786,2011-04-10,"R3","Geelong",17,20,122,"Port Adelaide",6,7,43,"Kardinia Park",79,2011,"Regular",3,"Home","Geelong","Port Adelaide",79
13787,2011-04-10,"R3","St Kilda",12,12,84,"Essendon",21,10,136,"Docklands",-52,2011,"Regular",3,"Away","Essendon","St Kilda",52
13788,2011-04-15,"R4","Richmond",13,12,90,"Collingwood",24,17,161,"M.C.G.",-71,2011,"Regular",4,"Away","Collingwood","Richmond",71
13789,2011-04-16,"R4","Carlton",11,13,79,"Essendon",11,13,79,"M.C.G.",0,2011,"Regular",4,"Home","Carlton","Essendon",0
13790,2011-04-16,"R4","Hawthorn",10,12,72,"West Coast",9,11,65,"York Park",7,2011,"Regular",4,"Home","Hawthorn","West Coast",7
13791,2011-04-16,"R4","Sydney",7,12,54,"Geelong",11,15,81,"S.C.G.",-27,2011,"Regular",4,"Away","Geelong","Sydney",27
13792,2011-04-16,"R4","Port Adelaide",14,14,98,"Adelaide",9,12,66,"Football Park",32,2011,"Regular",4,"Home","Port Adelaide","Adelaide",32
13793,2011-04-17,"R4","Gold Coast",9,15,69,"Melbourne",23,21,159,"Gabba",-90,2011,"Regular",4,"Away","Melbourne","Gold Coast",90
13794,2011-04-17,"R4","Fremantle",18,19,127,"North Melbourne",14,14,98,"Subiaco",29,2011,"Regular",4,"Home","Fremantle","North Melbourne",29
13795,2011-04-21,"R5","Brisbane Lions",11,10,76,"St Kilda",13,11,89,"Gabba",-13,2011,"Regular",5,"Away","St Kilda","Brisbane Lions",13
13796,2011-04-23,"R5","Port Adelaide",15,11,101,"Gold Coast",15,14,104,"Football Park",-3,2011,"Regular",5,"Away","Gold Coast","Port Adelaide",3
13797,2011-04-23,"R5","Carlton",11,19,85,"Adelaide",12,7,79,"Docklands",6,2011,"Regular",5,"Home","Carlton","Adelaide",6
13798,2011-04-24,"R5","North Melbourne",14,19,103,"Richmond",17,10,112,"Docklands",-9,2011,"Regular",5,"Away","Richmond","North Melbourne",9
13799,2011-04-25,"R5","Essendon",11,11,77,"Collingwood",16,11,107,"M.C.G.",-30,2011,"Regular",5,"Away","Collingwood","Essendon",30
13800,2011-04-25,"R5","Fremantle",12,13,85,"Footscray",11,12,78,"Subiaco",7,2011,"Regular",5,"Home","Fremantle","Footscray",7
13801,2011-04-26,"R5","Hawthorn",15,8,98,"Geelong",17,15,117,"M.C.G.",-19,2011,"Regular",5,"Away","Geelong","Hawthorn",19
13802,2011-04-28,"R6","West Coast",15,16,106,"Melbourne",6,16,52,"Subiaco",54,2011,"Regular",6,"Home","West Coast","Melbourne",54
13803,2011-04-29,"R6","Sydney",10,11,71,"Carlton",12,15,87,"S.C.G.",-16,2011,"Regular",6,"Away","Carlton","Sydney",16
13804,2011-04-30,"R6","North Melbourne",18,25,133,"Port Adelaide",10,13,73,"Docklands",60,2011,"Regular",6,"Home","North Melbourne","Port Adelaide",60
13805,2011-04-30,"R6","Richmond",18,16,124,"Brisbane Lions",14,14,98,"M.C.G.",26,2011,"Regular",6,"Home","Richmond","Brisbane Lions",26
13806,2011-04-30,"R6","Adelaide",13,12,90,"St Kilda",9,17,71,"Football Park",19,2011,"Regular",6,"Home","Adelaide","St Kilda",19
13807,2011-05-01,"R6","Essendon",31,11,197,"Gold Coast",8,10,58,"Docklands",139,2011,"Regular",6,"Home","Essendon","Gold Coast",139
13808,2011-05-01,"R6","Collingwood",15,15,105,"Footscray",8,9,57,"M.C.G.",48,2011,"Regular",6,"Home","Collingwood","Footscray",48
13809,2011-05-06,"R7","Port Adelaide",10,12,72,"Hawthorn",15,14,104,"Football Park",-32,2011,"Regular",7,"Away","Hawthorn","Port Adelaide",32
13810,2011-05-07,"R7","Footscray",10,5,65,"Sydney",10,13,73,"Manuka Oval",-8,2011,"Regular",7,"Away","Sydney","Footscray",8
13811,2011-05-07,"R7","Geelong",19,13,127,"North Melbourne",9,7,61,"Kardinia Park",66,2011,"Regular",7,"Home","Geelong","North Melbourne",66
13812,2011-05-07,"R7","Richmond",23,10,148,"Fremantle",14,15,99,"M.C.G.",49,2011,"Regular",7,"Home","Richmond","Fremantle",49
13813,2011-05-07,"R7","Gold Coast",18,16,124,"Brisbane Lions",17,14,116,"Gabba",8,2011,"Regular",7,"Home","Gold Coast","Brisbane Lions",8
13814,2011-05-08,"R7","Essendon",16,10,106,"West Coast",12,18,90,"Docklands",16,2011,"Regular",7,"Home","Essendon","West Coast",16
13815,2011-05-08,"R7","Melbourne",22,17,149,"Adelaide",8,5,53,"M.C.G.",96,2011,"Regular",7,"Home","Melbourne","Adelaide",96
13816,2011-05-09,"R7","St Kilda",12,9,81,"Carlton",11,18,84,"Docklands",-3,2011,"Regular",7,"Away","Carlton","St Kilda",3
13817,2011-05-13,"R8","Geelong",8,17,65,"Collingwood",9,8,62,"M.C.G.",3,2011,"Regular",8,"Home","Geelong","Collingwood",3
13818,2011-05-14,"R8","North Melbourne",19,10,124,"Melbourne",12,11,83,"Docklands",41,2011,"Regular",8,"Home","North Melbourne","Melbourne",41
13819,2011-05-14,"R8","Adelaide",20,10,130,"Gold Coast",9,19,73,"Football Park",57,2011,"Regular",8,"Home","Adelaide","Gold Coast",57
13820,2011-05-14,"R8","Brisbane Lions",9,12,66,"Essendon",15,12,102,"Gabba",-36,2011,"Regular",8,"Away","Essendon","Brisbane Lions",36
13821,2011-05-14,"R8","Sydney",18,13,121,"Port Adelaide",9,5,59,"S.C.G.",62,2011,"Regular",8,"Home","Sydney","Port Adelaide",62
13822,2011-05-15,"R8","Hawthorn",14,15,99,"St Kilda",10,9,69,"M.C.G.",30,2011,"Regular",8,"Home","Hawthorn","St Kilda",30
13823,2011-05-15,"R8","Footscray",23,15,153,"Richmond",18,10,118,"Docklands",35,2011,"Regular",8,"Home","Footscray","Richmond",35
13824,2011-05-15,"R8","West Coast",14,12,96,"Fremantle",9,9,63,"Subiaco",33,2011,"Regular",8,"Home","West Coast","Fremantle",33
13825,2011-05-20,"R9","Carlton",14,16,100,"Geelong",15,12,102,"Docklands",-2,2011,"Regular",9,"Away","Geelong","Carlton",2
13826,2011-05-21,"R9","St Kilda",16,10,106,"Melbourne",13,8,86,"Docklands",20,2011,"Regular",9,"Home","St Kilda","Melbourne",20
13827,2011-05-21,"R9","Port Adelaide",14,6,90,"Fremantle",21,16,142,"Football Park",-52,2011,"Regular",9,"Away","Fremantle","Port Adelaide",52
13828,2011-05-21,"R9","Richmond",16,9,105,"Essendon",13,11,89,"M.C.G.",16,2011,"Regular",9,"Home","Richmond","Essendon",16
13829,2011-05-21,"R9","Brisbane Lions",10,13,73,"North Melbourne",8,11,59,"Gabba",14,2011,"Regular",9,"Home","Brisbane Lions","North Melbourne",14
13830,2011-05-22,"R9","Collingwood",20,15,135,"Adelaide",14,8,92,"Docklands",43,2011,"Regular",9,"Home","Collingwood","Adelaide",43
13831,2011-05-22,"R9","Sydney",8,12,60,"Hawthorn",15,16,106,"S.C.G.",-46,2011,"Regular",9,"Away","Hawthorn","Sydney",46
13832,2011-05-22,"R9","West Coast",26,19,175,"Footscray",8,4,52,"Subiaco",123,2011,"Regular",9,"Home","West Coast","Footscray",123
13833,2011-05-27,"R10","Melbourne",6,10,46,"Carlton",13,15,93,"M.C.G.",-47,2011,"Regular",10,"Away","Carlton","Melbourne",47
13834,2011-05-28,"R10","North Melbourne",9,17,71,"Sydney",10,12,72,"Docklands",-1,2011,"Regular",10,"Away","Sydney","North Melbourne",1
13835,2011-05-28,"R10","Fremantle",7,14,56,"St Kilda",15,12,102,"Subiaco",-46,2011,"Regular",10,"Away","St Kilda","Fremantle",46
13836,2011-05-28,"R10","Gold Coast",10,13,73,"Geelong",21,13,139,"Carrara",-66,2011,"Regular",10,"Away","Geelong","Gold Coast",66
13837,2011-05-28,"R10","Richmond",10,14,74,"Port Adelaide",13,11,89,"Marrara Oval",-15,2011,"Regular",10,"Away","Port Adelaide","Richmond",15
13838,2011-05-29,"R10","Adelaide",8,13,61,"Brisbane Lions",15,11,101,"Football Park",-40,2011,"Regular",10,"Away","Brisbane Lions","Adelaide",40
13839,2011-05-29,"R10","Collingwood",16,9,105,"West Coast",7,11,53,"M.C.G.",52,2011,"Regular",10,"Home","Collingwood","West Coast",52
13840,2011-05-29,"R10","Footscray",9,8,62,"Hawthorn",13,13,91,"Docklands",-29,2011,"Regular",10,"Away","Hawthorn","Footscray",29
13841,2011-06-03,"R11","Essendon",10,8,68,"Melbourne",15,11,101,"M.C.G.",-33,2011,"Regular",11,"Away","Melbourne","Essendon",33
13842,2011-06-04,"R11","Geelong",23,10,148,"Footscray",13,9,87,"Kardinia Park",61,2011,"Regular",11,"Home","Geelong","Footscray",61
13843,2011-06-04,"R11","West Coast",13,7,85,"Gold Coast",10,7,67,"Subiaco",18,2011,"Regular",11,"Home","West Coast","Gold Coast",18
13844,2011-06-04,"R11","Collingwood",16,12,108,"St Kilda",7,9,51,"M.C.G.",57,2011,"Regular",11,"Home","Collingwood","St Kilda",57
13845,2011-06-04,"R11","Brisbane Lions",7,9,51,"Sydney",17,14,116,"Gabba",-65,2011,"Regular",11,"Away","Sydney","Brisbane Lions",65
13846,2011-06-05,"R11","Hawthorn",17,9,111,"Fremantle",13,11,89,"M.C.G.",22,2011,"Regular",11,"Home","Hawthorn","Fremantle",22
13847,2011-06-05,"R11","North Melbourne",18,7,115,"Adelaide",10,8,68,"Docklands",47,2011,"Regular",11,"Home","North Melbourne","Adelaide",47
13848,2011-06-05,"R11","Port Adelaide",7,7,49,"Carlton",16,15,111,"Football Park",-62,2011,"Regular",11,"Away","Carlton","Port Adelaide",62
13849,2011-06-10,"R12","St Kilda",12,9,81,"Footscray",8,9,57,"Docklands",24,2011,"Regular",12,"Home","St Kilda","Footscray",24
13850,2011-06-11,"R12","Adelaide",10,7,67,"West Coast",15,16,106,"Football Park",-39,2011,"Regular",12,"Away","West Coast","Adelaide",39
13851,2011-06-11,"R12","Geelong",13,10,88,"Hawthorn",13,5,83,"M.C.G.",5,2011,"Regular",12,"Home","Geelong","Hawthorn",5
13852,2011-06-11,"R12","Gold Coast",9,9,63,"North Melbourne",18,14,122,"Carrara",-59,2011,"Regular",12,"Away","North Melbourne","Gold Coast",59
13853,2011-06-12,"R12","Carlton",19,10,124,"Brisbane Lions",9,9,63,"Docklands",61,2011,"Regular",12,"Home","Carlton","Brisbane Lions",61
13854,2011-06-12,"R12","Sydney",9,21,75,"Richmond",9,11,65,"S.C.G.",10,2011,"Regular",12,"Home","Sydney","Richmond",10
13855,2011-06-12,"R12","Fremantle",15,8,98,"Essendon",9,10,64,"Subiaco",34,2011,"Regular",12,"Home","Fremantle","Essendon",34
13856,2011-06-13,"R12","Melbourne",6,5,41,"Collingwood",19,15,129,"M.C.G.",-88,2011,"Regular",12,"Away","Collingwood","Melbourne",88
13857,2011-06-17,"R13","Footscray",14,16,100,"Adelaide",10,10,70,"Docklands",30,2011,"Regular",13,"Home","Footscray","Adelaide",30
13858,2011-06-18,"R13","Essendon",12,18,90,"North Melbourne",17,9,111,"Docklands",-21,2011,"Regular",13,"Away","North Melbourne","Essendon",21
13859,2011-06-18,"R13","Hawthorn",19,15,129,"Gold Coast",8,10,58,"York Park",71,2011,"Regular",13,"Home","Hawthorn","Gold Coast",71
13860,2011-06-18,"R13","St Kilda",11,6,72,"Geelong",15,10,100,"M.C.G.",-28,2011,"Regular",13,"Away","Geelong","St Kilda",28
13861,2011-06-18,"R13","Brisbane Lions",14,10,94,"Richmond",18,17,125,"Gabba",-31,2011,"Regular",13,"Away","Richmond","Brisbane Lions",31
13862,2011-06-19,"R13","Melbourne",22,17,149,"Fremantle",8,12,60,"M.C.G.",89,2011,"Regular",13,"Home","Melbourne","Fremantle",89
13863,2011-06-19,"R13","Carlton",15,10,100,"Sydney",10,6,66,"Docklands",34,2011,"Regular",13,"Home","Carlton","Sydney",34
13864,2011-06-19,"R13","West Coast",15,20,110,"Port Adelaide",13,10,88,"Subiaco",22,2011,"Regular",13,"Home","West Coast","Port Adelaide",22
13865,2011-06-24,"R14","Hawthorn",23,8,146,"Essendon",12,9,81,"M.C.G.",65,2011,"Regular",14,"Home","Hawthorn","Essendon",65
13866,2011-06-25,"R14","Gold Coast",13,10,88,"Footscray",17,8,110,"Carrara",-22,2011,"Regular",14,"Away","Footscray","Gold Coast",22
13867,2011-06-25,"R14","Richmond",13,13,91,"Melbourne",17,16,118,"M.C.G.",-27,2011,"Regular",14,"Away","Melbourne","Richmond",27
13868,2011-06-25,"R14","Sydney",14,9,93,"Collingwood",13,21,99,"Stadium Australia",-6,2011,"Regular",14,"Away","Collingwood","Sydney",6
13869,2011-06-25,"R14","Fremantle",12,16,88,"Brisbane Lions",10,5,65,"Subiaco",23,2011,"Regular",14,"Home","Fremantle","Brisbane Lions",23
13870,2011-06-26,"R14","Geelong",19,11,125,"Adelaide",10,13,73,"Kardinia Park",52,2011,"Regular",14,"Home","Geelong","Adelaide",52
13871,2011-06-26,"R14","Carlton",10,7,67,"West Coast",15,13,103,"Docklands",-36,2011,"Regular",14,"Away","West Coast","Carlton",36
13872,2011-06-26,"R14","Port Adelaide",14,7,91,"North Melbourne",21,10,136,"Football Park",-45,2011,"Regular",14,"Away","North Melbourne","Port Adelaide",45
13873,2011-07-01,"R15","Footscray",19,13,127,"Melbourne",8,15,63,"Docklands",64,2011,"Regular",15,"Home","Footscray","Melbourne",64
13874,2011-07-02,"R15","Richmond",12,9,81,"Carlton",28,16,184,"M.C.G.",-103,2011,"Regular",15,"Away","Carlton","Richmond",103
13875,2011-07-02,"R15","Fremantle",17,10,112,"Gold Coast",9,8,62,"Subiaco",50,2011,"Regular",15,"Home","Fremantle","Gold Coast",50
13876,2011-07-02,"R15","Essendon",18,7,115,"Geelong",16,15,111,"Docklands",4,2011,"Regular",15,"Home","Essendon","Geelong",4
13877,2011-07-02,"R15","Adelaide",8,9,57,"Sydney",6,14,50,"Football Park",7,2011,"Regular",15,"Home","Adelaide","Sydney",7
13878,2011-07-03,"R15","Brisbane Lions",15,9,99,"Port Adelaide",13,10,88,"Gabba",11,2011,"Regular",15,"Home","Brisbane Lions","Port Adelaide",11
13879,2011-07-03,"R15","Collingwood",15,16,106,"Hawthorn",9,11,65,"M.C.G.",41,2011,"Regular",15,"Home","Collingwood","Hawthorn",41
13880,2011-07-03,"R15","North Melbourne",10,10,70,"St Kilda",12,7,79,"Docklands",-9,2011,"Regular",15,"Away","St Kilda","North Melbourne",9
13881,2011-07-08,"R16","West Coast",14,12,96,"Geelong",13,10,88,"Subiaco",8,2011,"Regular",16,"Home","West Coast","Geelong",8
13882,2011-07-09,"R16","Hawthorn",16,9,105,"Brisbane Lions",9,9,63,"York Park",42,2011,"Regular",16,"Home","Hawthorn","Brisbane Lions",42
13883,2011-07-09,"R16","Essendon",15,15,105,"Richmond",9,12,66,"M.C.G.",39,2011,"Regular",16,"Home","Essendon","Richmond",39
13884,2011-07-09,"R16","Gold Coast",4,12,36,"Sydney",15,16,106,"Carrara",-70,2011,"Regular",16,"Away","Sydney","Gold Coast",70
13885,2011-07-10,"R16","Collingwood",22,15,147,"North Melbourne",3,12,30,"M.C.G.",117,2011,"Regular",16,"Home","Collingwood","North Melbourne",117
13886,2011-07-10,"R16","Port Adelaide",8,5,53,"St Kilda",17,7,109,"Football Park",-56,2011,"Regular",16,"Away","St Kilda","Port Adelaide",56
13887,2011-07-10,"R16","Footscray",14,12,96,"Carlton",9,15,69,"Docklands",27,2011,"Regular",16,"Home","Footscray","Carlton",27
13888,2011-07-15,"R17","Adelaide",10,13,73,"Essendon",12,12,84,"Football Park",-11,2011,"Regular",17,"Away","Essendon","Adelaide",11
13889,2011-07-16,"R17","Carlton",11,13,79,"Collingwood",13,20,98,"M.C.G.",-19,2011,"Regular",17,"Away","Collingwood","Carlton",19
13890,2011-07-16,"R17","Richmond",9,16,70,"Gold Coast",12,13,85,"Cazaly's Stadium",-15,2011,"Regular",17,"Away","Gold Coast","Richmond",15
13891,2011-07-16,"R17","St Kilda",13,4,82,"West Coast",9,7,61,"Docklands",21,2011,"Regular",17,"Home","St Kilda","West Coast",21
13892,2011-07-16,"R17","Melbourne",17,11,113,"Port Adelaide",14,8,92,"Marrara Oval",21,2011,"Regular",17,"Home","Melbourne","Port Adelaide",21
13893,2011-07-17,"R17","Sydney",13,9,87,"Fremantle",15,8,98,"S.C.G.",-11,2011,"Regular",17,"Away","Fremantle","Sydney",11
13894,2011-07-17,"R17","Brisbane Lions",15,14,104,"Geelong",20,13,133,"Gabba",-29,2011,"Regular",17,"Away","Geelong","Brisbane Lions",29
13895,2011-07-17,"R17","North Melbourne",21,16,142,"Footscray",17,9,111,"Docklands",31,2011,"Regular",17,"Home","North Melbourne","Footscray",31
13896,2011-07-22,"R18","St Kilda",19,13,127,"Adelaide",3,6,24,"Docklands",103,2011,"Regular",18,"Home","St Kilda","Adelaide",103
13897,2011-07-23,"R18","Sydney",16,18,114,"Footscray",11,9,75,"S.C.G.",39,2011,"Regular",18,"Home","Sydney","Footscray",39
13898,2011-07-23,"R18","North Melbourne",17,20,122,"Brisbane Lions",11,11,77,"Docklands",45,2011,"Regular",18,"Home","North Melbourne","Brisbane Lions",45
13899,2011-07-23,"R18","Essendon",12,7,79,"Carlton",24,9,153,"M.C.G.",-74,2011,"Regular",18,"Away","Carlton","Essendon",74
13900,2011-07-23,"R18","Gold Coast",11,9,75,"Collingwood",19,15,129,"Carrara",-54,2011,"Regular",18,"Away","Collingwood","Gold Coast",54
13901,2011-07-24,"R18","Geelong",17,11,113,"Richmond",7,9,51,"Docklands",62,2011,"Regular",18,"Home","Geelong","Richmond",62
13902,2011-07-24,"R18","Melbourne",12,6,78,"Hawthorn",20,12,132,"M.C.G.",-54,2011,"Regular",18,"Away","Hawthorn","Melbourne",54
13903,2011-07-24,"R18","Fremantle",9,10,64,"West Coast",8,17,65,"Subiaco",-1,2011,"Regular",18,"Away","West Coast","Fremantle",1
13904,2011-07-29,"R19","North Melbourne",9,8,62,"Carlton",11,14,80,"Docklands",-18,2011,"Regular",19,"Away","Carlton","North Melbourne",18
13905,2011-07-30,"R19","Footscray",15,5,95,"West Coast",15,13,103,"Docklands",-8,2011,"Regular",19,"Away","West Coast","Footscray",8
13906,2011-07-30,"R19","Geelong",37,11,233,"Melbourne",7,5,47,"Kardinia Park",186,2011,"Regular",19,"Home","Geelong","Melbourne",186
13907,2011-07-30,"R19","Gold Coast",6,18,54,"St Kilda",10,14,74,"Carrara",-20,2011,"Regular",19,"Away","St Kilda","Gold Coast",20
13908,2011-07-30,"R19","Fremantle",6,8,44,"Hawthorn",13,17,95,"Subiaco",-51,2011,"Regular",19,"Away","Hawthorn","Fremantle",51
13909,2011-07-31,"R19","Collingwood",25,16,166,"Essendon",14,8,92,"M.C.G.",74,2011,"Regular",19,"Home","Collingwood","Essendon",74
13910,2011-07-31,"R19","Adelaide",16,15,111,"Port Adelaide",11,13,79,"Football Park",32,2011,"Regular",19,"Home","Adelaide","Port Adelaide",32
13911,2011-08-05,"R20","St Kilda",16,17,113,"Fremantle",10,12,72,"Docklands",41,2011,"Regular",20,"Home","St Kilda","Fremantle",41
13912,2011-08-06,"R20","Geelong",29,14,188,"Gold Coast",6,2,38,"Kardinia Park",150,2011,"Regular",20,"Home","Geelong","Gold Coast",150
13913,2011-08-06,"R20","Carlton",21,8,134,"Melbourne",7,16,58,"M.C.G.",76,2011,"Regular",20,"Home","Carlton","Melbourne",76
13914,2011-08-06,"R20","Essendon",15,10,100,"Sydney",14,15,99,"Docklands",1,2011,"Regular",20,"Home","Essendon","Sydney",1
13915,2011-08-06,"R20","Port Adelaide",3,3,21,"Collingwood",23,21,159,"Football Park",-138,2011,"Regular",20,"Away","Collingwood","Port Adelaide",138
13916,2011-08-07,"R20","Brisbane Lions",16,9,105,"Adelaide",16,14,110,"Gabba",-5,2011,"Regular",20,"Away","Adelaide","Brisbane Lions",5
13917,2011-08-07,"R20","Hawthorn",15,13,103,"North Melbourne",13,8,86,"York Park",17,2011,"Regular",20,"Home","Hawthorn","North Melbourne",17
13918,2011-08-07,"R20","West Coast",22,15,147,"Richmond",14,6,90,"Subiaco",57,2011,"Regular",20,"Home","West Coast","Richmond",57
13919,2011-08-12,"R21","St Kilda",10,10,70,"Collingwood",14,5,89,"Docklands",-19,2011,"Regular",21,"Away","Collingwood","St Kilda",19
13920,2011-08-13,"R21","Hawthorn",31,11,197,"Port Adelaide",5,2,32,"M.C.G.",165,2011,"Regular",21,"Home","Hawthorn","Port Adelaide",165
13921,2011-08-13,"R21","Fremantle",12,13,85,"Carlton",16,19,115,"Subiaco",-30,2011,"Regular",21,"Away","Carlton","Fremantle",30
13922,2011-08-13,"R21","Footscray",15,11,101,"Essendon",23,12,150,"Docklands",-49,2011,"Regular",21,"Away","Essendon","Footscray",49
13923,2011-08-13,"R21","Brisbane Lions",18,15,123,"Gold Coast",8,13,61,"Gabba",62,2011,"Regular",21,"Home","Brisbane Lions","Gold Coast",62
13924,2011-08-14,"R21","Melbourne",9,8,62,"West Coast",16,14,110,"Docklands",-48,2011,"Regular",21,"Away","West Coast","Melbourne",48
13925,2011-08-14,"R21","Richmond",14,15,99,"Sydney",7,14,56,"M.C.G.",43,2011,"Regular",21,"Home","Richmond","Sydney",43
13926,2011-08-14,"R21","Adelaide",12,13,85,"Geelong",14,12,96,"Football Park",-11,2011,"Regular",21,"Away","Geelong","Adelaide",11
13927,2011-08-19,"R22","Carlton",8,18,66,"Hawthorn",10,18,78,"Docklands",-12,2011,"Regular",22,"Away","Hawthorn","Carlton",12
13928,2011-08-20,"R22","Gold Coast",9,10,64,"Adelaide",18,17,125,"Carrara",-61,2011,"Regular",22,"Away","Adelaide","Gold Coast",61
13929,2011-08-20,"R22","West Coast",20,14,134,"Essendon",11,11,77,"Subiaco",57,2011,"Regular",22,"Home","West Coast","Essendon",57
13930,2011-08-20,"R22","Collingwood",14,18,102,"Brisbane Lions",13,6,84,"M.C.G.",18,2011,"Regular",22,"Home","Collingwood","Brisbane Lions",18
13931,2011-08-20,"R22","North Melbourne",21,17,143,"Fremantle",6,9,45,"Docklands",98,2011,"Regular",22,"Home","North Melbourne","Fremantle",98
13932,2011-08-21,"R22","Sydney",10,23,83,"St Kilda",10,8,68,"Stadium Australia",15,2011,"Regular",22,"Home","Sydney","St Kilda",15
13933,2011-08-21,"R22","Port Adelaide",15,7,97,"Footscray",24,13,157,"Football Park",-60,2011,"Regular",22,"Away","Footscray","Port Adelaide",60
13934,2011-08-21,"R22","Melbourne",17,8,110,"Richmond",17,15,117,"M.C.G.",-7,2011,"Regular",22,"Away","Richmond","Melbourne",7
13935,2011-08-26,"R23","Fremantle",8,4,52,"Collingwood",20,12,132,"Subiaco",-80,2011,"Regular",23,"Away","Collingwood","Fremantle",80
13936,2011-08-27,"R23","Hawthorn",16,17,113,"Footscray",10,7,67,"M.C.G.",46,2011,"Regular",23,"Home","Hawthorn","Footscray",46
13937,2011-08-27,"R23","Geelong",12,14,86,"Sydney",15,9,99,"Kardinia Park",-13,2011,"Regular",23,"Away","Sydney","Geelong",13
13938,2011-08-27,"R23","St Kilda",19,21,135,"North Melbourne",10,10,70,"Docklands",65,2011,"Regular",23,"Home","St Kilda","North Melbourne",65
13939,2011-08-27,"R23","Brisbane Lions",11,15,81,"West Coast",13,11,89,"Gabba",-8,2011,"Regular",23,"Away","West Coast","Brisbane Lions",8
13940,2011-08-28,"R23","Adelaide",15,9,99,"Richmond",17,19,121,"Football Park",-22,2011,"Regular",23,"Away","Richmond","Adelaide",22
13941,2011-08-28,"R23","Melbourne",17,10,112,"Gold Coast",12,10,82,"M.C.G.",30,2011,"Regular",23,"Home","Melbourne","Gold Coast",30
13942,2011-08-28,"R23","Essendon",17,18,120,"Port Adelaide",17,11,113,"Docklands",7,2011,"Regular",23,"Home","Essendon","Port Adelaide",7
13943,2011-09-02,"R24","Collingwood",8,5,53,"Geelong",22,17,149,"M.C.G.",-96,2011,"Regular",24,"Away","Geelong","Collingwood",96
13944,2011-09-03,"R24","Gold Coast",14,13,97,"Hawthorn",16,10,106,"Carrara",-9,2011,"Regular",24,"Away","Hawthorn","Gold Coast",9
13945,2011-09-03,"R24","Footscray",15,17,107,"Fremantle",8,13,61,"Docklands",46,2011,"Regular",24,"Home","Footscray","Fremantle",46
13946,2011-09-03,"R24","Sydney",18,11,119,"Brisbane Lions",9,13,67,"S.C.G.",52,2011,"Regular",24,"Home","Sydney","Brisbane Lions",52
13947,2011-09-03,"R24","West Coast",22,13,145,"Adelaide",7,8,50,"Subiaco",95,2011,"Regular",24,"Home","West Coast","Adelaide",95
13948,2011-09-03,"R24","Carlton",9,12,66,"St Kilda",13,8,86,"M.C.G.",-20,2011,"Regular",24,"Away","St Kilda","Carlton",20
13949,2011-09-04,"R24","Port Adelaide",17,10,112,"Melbourne",15,14,104,"Adelaide Oval",8,2011,"Regular",24,"Home","Port Adelaide","Melbourne",8
13950,2011-09-04,"R24","Richmond",13,13,91,"North Melbourne",15,14,104,"Docklands",-13,2011,"Regular",24,"Away","North Melbourne","Richmond",13
13951,2011-09-09,"QF","Geelong",14,14,98,"Hawthorn",9,13,67,"M.C.G.",31,2011,"Finals",25,"Home","Geelong","Hawthorn",31
13952,2011-09-10,"QF","Collingwood",12,10,82,"West Coast",9,8,62,"M.C.G.",20,2011,"Finals",25,"Home","Collingwood","West Coast",20
13953,2011-09-10,"EF","St Kilda",8,9,57,"Sydney",12,10,82,"Docklands",-25,2011,"Finals",25,"Away","Sydney","St Kilda",25
13954,2011-09-11,"EF","Carlton",21,23,149,"Essendon",13,9,87,"M.C.G.",62,2011,"Finals",25,"Home","Carlton","Essendon",62
13955,2011-09-16,"SF","Hawthorn",19,8,122,"Sydney",13,8,86,"M.C.G.",36,2011,"Finals",26,"Home","Hawthorn","Sydney",36
13956,2011-09-17,"SF","West Coast",15,11,101,"Carlton",15,8,98,"Subiaco",3,2011,"Finals",26,"Home","West Coast","Carlton",3
13957,2011-09-23,"PF","Collingwood",10,8,68,"Hawthorn",9,11,65,"M.C.G.",3,2011,"Finals",27,"Home","Collingwood","Hawthorn",3
13958,2011-09-24,"PF","Geelong",17,15,117,"West Coast",10,9,69,"M.C.G.",48,2011,"Finals",27,"Home","Geelong","West Coast",48
13959,2011-10-01,"GF","Collingwood",12,9,81,"Geelong",18,11,119,"M.C.G.",-38,2011,"Finals",28,"Away","Geelong","Collingwood",38
13960,2012-03-24,"R1","GWS",5,7,37,"Sydney",14,16,100,"Stadium Australia",-63,2012,"Regular",1,"Away","Sydney","GWS",63
13961,2012-03-29,"R1","Richmond",12,9,81,"Carlton",18,17,125,"M.C.G.",-44,2012,"Regular",1,"Away","Carlton","Richmond",44
13962,2012-03-30,"R1","Hawthorn",20,17,137,"Collingwood",16,19,115,"M.C.G.",22,2012,"Regular",1,"Home","Hawthorn","Collingwood",22
13963,2012-03-31,"R1","Melbourne",11,12,78,"Brisbane Lions",17,17,119,"M.C.G.",-41,2012,"Regular",1,"Away","Brisbane Lions","Melbourne",41
13964,2012-03-31,"R1","Gold Coast",10,8,68,"Adelaide",19,23,137,"Carrara",-69,2012,"Regular",1,"Away","Adelaide","Gold Coast",69
13965,2012-03-31,"R1","North Melbourne",15,12,102,"Essendon",14,20,104,"Docklands",-2,2012,"Regular",1,"Away","Essendon","North Melbourne",2
13966,2012-03-31,"R1","Fremantle",16,9,105,"Geelong",15,11,101,"Subiaco",4,2012,"Regular",1,"Home","Fremantle","Geelong",4
13967,2012-04-01,"R1","Footscray",12,15,87,"West Coast",21,10,136,"Docklands",-49,2012,"Regular",1,"Away","West Coast","Footscray",49
13968,2012-04-01,"R1","Port Adelaide",13,11,89,"St Kilda",13,7,85,"Football Park",4,2012,"Regular",1,"Home","Port Adelaide","St Kilda",4
13969,2012-04-05,"R2","Brisbane Lions",9,9,63,"Carlton",23,16,154,"Gabba",-91,2012,"Regular",2,"Away","Carlton","Brisbane Lions",91
13970,2012-04-07,"R2","Essendon",16,15,111,"Port Adelaide",13,8,86,"Docklands",25,2012,"Regular",2,"Home","Essendon","Port Adelaide",25
13971,2012-04-07,"R2","Sydney",14,10,94,"Fremantle",12,9,81,"S.C.G.",13,2012,"Regular",2,"Home","Sydney","Fremantle",13
13972,2012-04-07,"R2","West Coast",25,16,166,"Melbourne",9,4,58,"Subiaco",108,2012,"Regular",2,"Home","West Coast","Melbourne",108
13973,2012-04-07,"R2","Adelaide",11,16,82,"Footscray",9,10,64,"Football Park",18,2012,"Regular",2,"Home","Adelaide","Footscray",18
13974,2012-04-07,"R2","Collingwood",12,13,85,"Richmond",8,16,64,"M.C.G.",21,2012,"Regular",2,"Home","Collingwood","Richmond",21
13975,2012-04-08,"R2","North Melbourne",28,15,183,"GWS",8,6,54,"Bellerive Oval",129,2012,"Regular",2,"Home","North Melbourne","GWS",129
13976,2012-04-08,"R2","St Kilda",21,13,139,"Gold Coast",7,5,47,"Docklands",92,2012,"Regular",2,"Home","St Kilda","Gold Coast",92
13977,2012-04-09,"R2","Geelong",14,8,92,"Hawthorn",13,12,90,"M.C.G.",2,2012,"Regular",2,"Home","Geelong","Hawthorn",2
13978,2012-04-13,"R3","Carlton",18,14,122,"Collingwood",9,8,62,"M.C.G.",60,2012,"Regular",3,"Home","Carlton","Collingwood",60
13979,2012-04-14,"R3","Richmond",20,13,133,"Melbourne",11,8,74,"M.C.G.",59,2012,"Regular",3,"Home","Richmond","Melbourne",59
13980,2012-04-14,"R3","Port Adelaide",12,11,83,"Sydney",16,9,105,"Football Park",-22,2012,"Regular",3,"Away","Sydney","Port Adelaide",22
13981,2012-04-14,"R3","Fremantle",8,16,64,"Brisbane Lions",5,5,35,"Subiaco",29,2012,"Regular",3,"Home","Fremantle","Brisbane Lions",29
13982,2012-04-14,"R3","Gold Coast",13,10,88,"Essendon",15,15,105,"Carrara",-17,2012,"Regular",3,"Away","Essendon","Gold Coast",17
13983,2012-04-14,"R3","Footscray",5,10,40,"St Kilda",15,13,103,"Docklands",-63,2012,"Regular",3,"Away","St Kilda","Footscray",63
13984,2012-04-15,"R3","GWS",10,9,69,"West Coast",23,12,150,"Blacktown",-81,2012,"Regular",3,"Away","West Coast","GWS",81
13985,2012-04-15,"R3","Hawthorn",21,14,140,"Adelaide",12,12,84,"M.C.G.",56,2012,"Regular",3,"Home","Hawthorn","Adelaide",56
13986,2012-04-15,"R3","North Melbourne",20,11,131,"Geelong",16,18,114,"Docklands",17,2012,"Regular",3,"Home","North Melbourne","Geelong",17
13987,2012-04-20,"R4","St Kilda",11,13,79,"Fremantle",14,8,92,"Docklands",-13,2012,"Regular",4,"Away","Fremantle","St Kilda",13
13988,2012-04-21,"R4","Carlton",11,13,79,"Essendon",15,19,109,"M.C.G.",-30,2012,"Regular",4,"Away","Essendon","Carlton",30
13989,2012-04-21,"R4","Collingwood",14,13,97,"Port Adelaide",10,13,73,"Docklands",24,2012,"Regular",4,"Home","Collingwood","Port Adelaide",24
13990,2012-04-21,"R4","Adelaide",13,18,96,"GWS",7,8,50,"Football Park",46,2012,"Regular",4,"Home","Adelaide","GWS",46
13991,2012-04-21,"R4","West Coast",5,21,51,"Hawthorn",5,16,46,"Subiaco",5,2012,"Regular",4,"Home","West Coast","Hawthorn",5
13992,2012-04-21,"R4","Brisbane Lions",17,9,111,"Gold Coast",6,10,46,"Gabba",65,2012,"Regular",4,"Home","Brisbane Lions","Gold Coast",65
13993,2012-04-22,"R4","Geelong",11,9,75,"Richmond",9,11,65,"Kardinia Park",10,2012,"Regular",4,"Home","Geelong","Richmond",10
13994,2012-04-22,"R4","Sydney",17,11,113,"North Melbourne",10,17,77,"S.C.G.",36,2012,"Regular",4,"Home","Sydney","North Melbourne",36
13995,2012-04-22,"R4","Melbourne",9,13,67,"Footscray",13,10,88,"M.C.G.",-21,2012,"Regular",4,"Away","Footscray","Melbourne",21
13996,2012-04-25,"R5","Collingwood",11,14,80,"Essendon",11,13,79,"M.C.G.",1,2012,"Regular",5,"Home","Collingwood","Essendon",1
13997,2012-04-27,"R5","Fremantle",7,15,57,"Carlton",10,5,65,"Subiaco",-8,2012,"Regular",5,"Away","Carlton","Fremantle",8
13998,2012-04-28,"R5","GWS",9,8,62,"Footscray",15,14,104,"Manuka Oval",-42,2012,"Regular",5,"Away","Footscray","GWS",42
13999,2012-04-28,"R5","North Melbourne",17,25,127,"Gold Coast",13,15,93,"Docklands",34,2012,"Regular",5,"Home","North Melbourne","Gold Coast",34
14000,2012-04-28,"R5","Melbourne",10,6,66,"St Kilda",12,12,84,"M.C.G.",-18,2012,"Regular",5,"Away","St Kilda","Melbourne",18
14001,2012-04-28,"R5","Brisbane Lions",4,17,41,"Geelong",12,7,79,"Gabba",-38,2012,"Regular",5,"Away","Geelong","Brisbane Lions",38
14002,2012-04-29,"R5","Hawthorn",10,9,69,"Sydney",16,10,106,"York Park",-37,2012,"Regular",5,"Away","Sydney","Hawthorn",37
14003,2012-04-29,"R5","Richmond",14,13,97,"West Coast",16,11,107,"Docklands",-10,2012,"Regular",5,"Away","West Coast","Richmond",10
14004,2012-04-29,"R5","Adelaide",16,14,110,"Port Adelaide",14,7,91,"Football Park",19,2012,"Regular",5,"Home","Adelaide","Port Adelaide",19
14005,2012-05-04,"R6","Footscray",11,11,77,"Collingwood",15,8,98,"Docklands",-21,2012,"Regular",6,"Away","Collingwood","Footscray",21
14006,2012-05-05,"R6","Essendon",19,15,129,"Brisbane Lions",9,8,62,"Docklands",67,2012,"Regular",6,"Home","Essendon","Brisbane Lions",67
14007,2012-05-05,"R6","Geelong",17,17,119,"Melbourne",11,10,76,"Kardinia Park",43,2012,"Regular",6,"Home","Geelong","Melbourne",43
14008,2012-05-05,"R6","Gold Coast",14,3,87,"Fremantle",14,10,94,"Carrara",-7,2012,"Regular",6,"Away","Fremantle","Gold Coast",7
14009,2012-05-05,"R6","Sydney",14,10,94,"Adelaide",15,9,99,"S.C.G.",-5,2012,"Regular",6,"Away","Adelaide","Sydney",5
14010,2012-05-05,"R6","St Kilda",13,10,88,"Hawthorn",18,15,123,"M.C.G.",-35,2012,"Regular",6,"Away","Hawthorn","St Kilda",35
14011,2012-05-06,"R6","Carlton",15,20,110,"GWS",6,7,43,"Docklands",67,2012,"Regular",6,"Home","Carlton","GWS",67
14012,2012-05-06,"R6","Port Adelaide",8,6,54,"Richmond",13,13,91,"Football Park",-37,2012,"Regular",6,"Away","Richmond","Port Adelaide",37
14013,2012-05-06,"R6","West Coast",17,18,120,"North Melbourne",15,5,95,"Subiaco",25,2012,"Regular",6,"Home","West Coast","North Melbourne",25
14014,2012-05-11,"R7","Melbourne",6,13,49,"Hawthorn",15,25,115,"M.C.G.",-66,2012,"Regular",7,"Away","Hawthorn","Melbourne",66
14015,2012-05-12,"R7","Adelaide",19,8,122,"Geelong",10,12,72,"Football Park",50,2012,"Regular",7,"Home","Adelaide","Geelong",50
14016,2012-05-12,"R7","GWS",13,16,94,"Gold Coast",9,13,67,"Manuka Oval",27,2012,"Regular",7,"Home","GWS","Gold Coast",27
14017,2012-05-12,"R7","Richmond",13,13,91,"Sydney",8,14,62,"M.C.G.",29,2012,"Regular",7,"Home","Richmond","Sydney",29
14018,2012-05-12,"R7","Brisbane Lions",8,10,58,"Collingwood",17,14,116,"Gabba",-58,2012,"Regular",7,"Away","Collingwood","Brisbane Lions",58
14019,2012-05-12,"R7","Essendon",16,17,113,"West Coast",7,10,52,"Docklands",61,2012,"Regular",7,"Home","Essendon","West Coast",61
14020,2012-05-13,"R7","North Melbourne",12,11,83,"Footscray",15,11,101,"Docklands",-18,2012,"Regular",7,"Away","Footscray","North Melbourne",18
14021,2012-05-13,"R7","Fremantle",12,15,87,"Port Adelaide",7,5,47,"Subiaco",40,2012,"Regular",7,"Home","Fremantle","Port Adelaide",40
14022,2012-05-14,"R7","St Kilda",19,8,122,"Carlton",14,14,98,"Docklands",24,2012,"Regular",7,"Home","St Kilda","Carlton",24
14023,2012-05-18,"R8","Collingwood",14,12,96,"Geelong",11,18,84,"M.C.G.",12,2012,"Regular",8,"Home","Collingwood","Geelong",12
14024,2012-05-19,"R8","Port Adelaide",14,11,95,"North Melbourne",14,9,93,"Football Park",2,2012,"Regular",8,"Home","Port Adelaide","North Melbourne",2
14025,2012-05-19,"R8","Hawthorn",17,17,119,"Fremantle",9,9,63,"York Park",56,2012,"Regular",8,"Home","Hawthorn","Fremantle",56
14026,2012-05-19,"R8","Sydney",21,12,138,"Melbourne",5,7,37,"S.C.G.",101,2012,"Regular",8,"Home","Sydney","Melbourne",101
14027,2012-05-19,"R8","Footscray",9,18,72,"Gold Coast",4,10,34,"Marrara Oval",38,2012,"Regular",8,"Home","Footscray","Gold Coast",38
14028,2012-05-19,"R8","Essendon",19,14,128,"Richmond",15,19,109,"M.C.G.",19,2012,"Regular",8,"Home","Essendon","Richmond",19
14029,2012-05-20,"R8","Brisbane Lions",19,18,132,"GWS",5,10,40,"Gabba",92,2012,"Regular",8,"Home","Brisbane Lions","GWS",92
14030,2012-05-20,"R8","Carlton",8,7,55,"Adelaide",19,10,124,"Docklands",-69,2012,"Regular",8,"Away","Adelaide","Carlton",69
14031,2012-05-20,"R8","West Coast",18,13,121,"St Kilda",13,13,91,"Subiaco",30,2012,"Regular",8,"Home","West Coast","St Kilda",30
14032,2012-05-25,"R9","Footscray",11,9,75,"Geelong",14,11,95,"Docklands",-20,2012,"Regular",9,"Away","Geelong","Footscray",20
14033,2012-05-26,"R9","Richmond",21,11,137,"Hawthorn",10,15,75,"M.C.G.",62,2012,"Regular",9,"Home","Richmond","Hawthorn",62
14034,2012-05-26,"R9","Gold Coast",10,10,70,"Port Adelaide",17,16,118,"Carrara",-48,2012,"Regular",9,"Away","Port Adelaide","Gold Coast",48
14035,2012-05-26,"R9","St Kilda",16,15,111,"Sydney",12,11,83,"Docklands",28,2012,"Regular",9,"Home","St Kilda","Sydney",28
14036,2012-05-26,"R9","Adelaide",6,13,49,"Collingwood",10,15,75,"Football Park",-26,2012,"Regular",9,"Away","Collingwood","Adelaide",26
14037,2012-05-26,"R9","GWS",7,11,53,"Essendon",18,11,119,"Sydney Showground",-66,2012,"Regular",9,"Away","Essendon","GWS",66
14038,2012-05-27,"R9","North Melbourne",17,10,112,"Brisbane Lions",15,6,96,"Docklands",16,2012,"Regular",9,"Home","North Melbourne","Brisbane Lions",16
14039,2012-05-27,"R9","Carlton",15,17,107,"Melbourne",6,13,49,"M.C.G.",58,2012,"Regular",9,"Home","Carlton","Melbourne",58
14040,2012-05-27,"R9","West Coast",11,18,84,"Fremantle",5,6,36,"Subiaco",48,2012,"Regular",9,"Home","West Coast","Fremantle",48
14041,2012-06-01,"R10","St Kilda",16,17,113,"Richmond",18,13,121,"Docklands",-8,2012,"Regular",10,"Away","Richmond","St Kilda",8
14042,2012-06-02,"R10","Geelong",19,12,126,"GWS",9,7,61,"Kardinia Park",65,2012,"Regular",10,"Home","Geelong","GWS",65
14043,2012-06-02,"R10","Hawthorn",27,12,174,"North Melbourne",9,5,59,"York Park",115,2012,"Regular",10,"Home","Hawthorn","North Melbourne",115
14044,2012-06-02,"R10","Fremantle",12,10,82,"Adelaide",17,9,111,"Subiaco",-29,2012,"Regular",10,"Away","Adelaide","Fremantle",29
14045,2012-06-02,"R10","Port Adelaide",14,15,99,"Carlton",6,9,45,"Football Park",54,2012,"Regular",10,"Home","Port Adelaide","Carlton",54
14046,2012-06-02,"R10","Essendon",6,16,52,"Melbourne",8,10,58,"M.C.G.",-6,2012,"Regular",10,"Away","Melbourne","Essendon",6
14047,2012-06-03,"R10","Brisbane Lions",16,6,102,"West Coast",15,10,100,"Gabba",2,2012,"Regular",10,"Home","Brisbane Lions","West Coast",2
14048,2012-06-03,"R10","Sydney",20,12,132,"Footscray",5,10,40,"S.C.G.",92,2012,"Regular",10,"Home","Sydney","Footscray",92
14049,2012-06-03,"R10","Collingwood",23,11,149,"Gold Coast",7,10,52,"M.C.G.",97,2012,"Regular",10,"Home","Collingwood","Gold Coast",97
14050,2012-06-08,"R11","Carlton",11,19,85,"Geelong",14,13,97,"Docklands",-12,2012,"Regular",11,"Away","Geelong","Carlton",12
14051,2012-06-09,"R11","Richmond",9,12,66,"Fremantle",12,6,78,"M.C.G.",-12,2012,"Regular",11,"Away","Fremantle","Richmond",12
14052,2012-06-09,"R11","Gold Coast",7,7,49,"St Kilda",21,18,144,"Carrara",-95,2012,"Regular",11,"Away","St Kilda","Gold Coast",95
14053,2012-06-09,"R11","Essendon",11,16,82,"Sydney",13,8,86,"Docklands",-4,2012,"Regular",11,"Away","Sydney","Essendon",4
14054,2012-06-10,"R11","Port Adelaide",9,8,62,"Hawthorn",16,12,108,"Football Park",-46,2012,"Regular",11,"Away","Hawthorn","Port Adelaide",46
14055,2012-06-11,"R11","Melbourne",13,9,87,"Collingwood",19,15,129,"M.C.G.",-42,2012,"Regular",11,"Away","Collingwood","Melbourne",42
14056,2012-06-14,"R12","West Coast",10,19,79,"Carlton",10,9,69,"Subiaco",10,2012,"Regular",12,"Home","West Coast","Carlton",10
14057,2012-06-15,"R12","Adelaide",17,13,115,"St Kilda",16,15,111,"Football Park",4,2012,"Regular",12,"Home","Adelaide","St Kilda",4
14058,2012-06-16,"R12","GWS",12,2,74,"Richmond",11,20,86,"Sydney Showground",-12,2012,"Regular",12,"Away","Richmond","GWS",12
14059,2012-06-16,"R12","Gold Coast",12,8,80,"North Melbourne",11,21,87,"Carrara",-7,2012,"Regular",12,"Away","North Melbourne","Gold Coast",7
14060,2012-06-17,"R12","Hawthorn",19,21,135,"Brisbane Lions",11,4,70,"M.C.G.",65,2012,"Regular",12,"Home","Hawthorn","Brisbane Lions",65
14061,2012-06-17,"R12","Footscray",13,17,95,"Port Adelaide",8,9,57,"Docklands",38,2012,"Regular",12,"Home","Footscray","Port Adelaide",38
14062,2012-06-22,"R13","Sydney",12,8,80,"Geelong",11,8,74,"S.C.G.",6,2012,"Regular",13,"Home","Sydney","Geelong",6
14063,2012-06-23,"R13","Footscray",7,14,56,"Brisbane Lions",18,6,114,"Docklands",-58,2012,"Regular",13,"Away","Brisbane Lions","Footscray",58
14064,2012-06-23,"R13","Collingwood",12,13,85,"West Coast",12,10,82,"M.C.G.",3,2012,"Regular",13,"Home","Collingwood","West Coast",3
14065,2012-06-23,"R13","Fremantle",14,5,89,"Essendon",17,11,113,"Subiaco",-24,2012,"Regular",13,"Away","Essendon","Fremantle",24
14066,2012-06-24,"R13","Melbourne",20,15,135,"GWS",9,3,57,"M.C.G.",78,2012,"Regular",13,"Home","Melbourne","GWS",78
14067,2012-06-24,"R13","North Melbourne",17,19,121,"Adelaide",13,11,89,"Docklands",32,2012,"Regular",13,"Home","North Melbourne","Adelaide",32
14068,2012-06-29,"R14","Carlton",10,10,70,"Hawthorn",18,12,120,"M.C.G.",-50,2012,"Regular",14,"Away","Hawthorn","Carlton",50
14069,2012-06-30,"R14","Collingwood",15,17,107,"Fremantle",12,6,78,"M.C.G.",29,2012,"Regular",14,"Home","Collingwood","Fremantle",29
14070,2012-06-30,"R14","Adelaide",17,4,106,"Richmond",13,9,87,"Football Park",19,2012,"Regular",14,"Home","Adelaide","Richmond",19
14071,2012-06-30,"R14","West Coast",25,16,166,"Gold Coast",5,10,40,"Subiaco",126,2012,"Regular",14,"Home","West Coast","Gold Coast",126
14072,2012-06-30,"R14","Essendon",21,14,140,"Footscray",8,8,56,"Docklands",84,2012,"Regular",14,"Home","Essendon","Footscray",84
14073,2012-06-30,"R14","Sydney",19,18,132,"GWS",5,8,38,"Stadium Australia",94,2012,"Regular",14,"Home","Sydney","GWS",94
14074,2012-07-01,"R14","Geelong",14,15,99,"Port Adelaide",8,13,61,"Kardinia Park",38,2012,"Regular",14,"Home","Geelong","Port Adelaide",38
14075,2012-07-01,"R14","Brisbane Lions",18,14,122,"Melbourne",8,13,61,"Gabba",61,2012,"Regular",14,"Home","Brisbane Lions","Melbourne",61
14076,2012-07-01,"R14","St Kilda",15,13,103,"North Melbourne",21,10,136,"Docklands",-33,2012,"Regular",14,"Away","North Melbourne","St Kilda",33
14077,2012-07-06,"R15","Collingwood",8,14,62,"Carlton",12,13,85,"M.C.G.",-23,2012,"Regular",15,"Away","Carlton","Collingwood",23
14078,2012-07-07,"R15","North Melbourne",13,6,84,"West Coast",12,14,86,"Bellerive Oval",-2,2012,"Regular",15,"Away","West Coast","North Melbourne",2
14079,2012-07-07,"R15","Melbourne",11,12,78,"Richmond",13,23,101,"M.C.G.",-23,2012,"Regular",15,"Away","Richmond","Melbourne",23
14080,2012-07-07,"R15","Sydney",16,14,110,"Brisbane Lions",9,9,63,"S.C.G.",47,2012,"Regular",15,"Home","Sydney","Brisbane Lions",47
14081,2012-07-07,"R15","Port Adelaide",8,10,58,"Adelaide",17,14,116,"Football Park",-58,2012,"Regular",15,"Away","Adelaide","Port Adelaide",58
14082,2012-07-07,"R15","St Kilda",21,7,133,"Essendon",8,14,62,"Docklands",71,2012,"Regular",15,"Home","St Kilda","Essendon",71
14083,2012-07-08,"R15","Hawthorn",28,25,193,"GWS",4,7,31,"M.C.G.",162,2012,"Regular",15,"Home","Hawthorn","GWS",162
14084,2012-07-08,"R15","Gold Coast",13,18,96,"Geelong",15,20,110,"Carrara",-14,2012,"Regular",15,"Away","Geelong","Gold Coast",14
14085,2012-07-08,"R15","Fremantle",14,11,95,"Footscray",8,9,57,"Subiaco",38,2012,"Regular",15,"Home","Fremantle","Footscray",38
14086,2012-07-13,"R16","North Melbourne",24,5,149,"Carlton",14,12,96,"Docklands",53,2012,"Regular",16,"Home","North Melbourne","Carlton",53
14087,2012-07-14,"R16","Melbourne",12,11,83,"Fremantle",18,9,117,"Docklands",-34,2012,"Regular",16,"Away","Fremantle","Melbourne",34
14088,2012-07-14,"R16","Port Adelaide",11,11,77,"Essendon",19,13,127,"Football Park",-50,2012,"Regular",16,"Away","Essendon","Port Adelaide",50
14089,2012-07-14,"R16","Richmond",13,10,88,"Gold Coast",13,12,90,"Cazaly's Stadium",-2,2012,"Regular",16,"Away","Gold Coast","Richmond",2
14090,2012-07-14,"R16","Geelong",10,19,79,"Collingwood",17,8,110,"M.C.G.",-31,2012,"Regular",16,"Away","Collingwood","Geelong",31
14091,2012-07-14,"R16","Brisbane Lions",14,8,92,"St Kilda",16,9,105,"Gabba",-13,2012,"Regular",16,"Away","St Kilda","Brisbane Lions",13
14092,2012-07-15,"R16","GWS",8,11,59,"Adelaide",27,16,178,"Sydney Showground",-119,2012,"Regular",16,"Away","Adelaide","GWS",119
14093,2012-07-15,"R16","Footscray",6,8,44,"Hawthorn",17,14,116,"Docklands",-72,2012,"Regular",16,"Away","Hawthorn","Footscray",72
14094,2012-07-15,"R16","West Coast",10,9,69,"Sydney",18,13,121,"Subiaco",-52,2012,"Regular",16,"Away","Sydney","West Coast",52
14095,2012-07-20,"R17","Geelong",20,14,134,"Essendon",10,7,67,"Docklands",67,2012,"Regular",17,"Home","Geelong","Essendon",67
14096,2012-07-21,"R17","Collingwood",13,13,91,"Hawthorn",21,12,138,"M.C.G.",-47,2012,"Regular",17,"Away","Hawthorn","Collingwood",47
14097,2012-07-21,"R17","Adelaide",19,10,124,"West Coast",11,9,75,"Football Park",49,2012,"Regular",17,"Home","Adelaide","West Coast",49
14098,2012-07-21,"R17","Gold Coast",5,18,48,"Brisbane Lions",8,11,59,"Carrara",-11,2012,"Regular",17,"Away","Brisbane Lions","Gold Coast",11
14099,2012-07-21,"R17","Footscray",12,12,84,"Carlton",16,6,102,"Docklands",-18,2012,"Regular",17,"Away","Carlton","Footscray",18
14100,2012-07-21,"R17","Melbourne",8,8,56,"Port Adelaide",12,12,84,"Marrara Oval",-28,2012,"Regular",17,"Away","Port Adelaide","Melbourne",28
14101,2012-07-22,"R17","Sydney",15,15,105,"St Kilda",10,16,76,"S.C.G.",29,2012,"Regular",17,"Home","Sydney","St Kilda",29
14102,2012-07-22,"R17","Richmond",14,15,99,"North Melbourne",15,13,103,"M.C.G.",-4,2012,"Regular",17,"Away","North Melbourne","Richmond",4
14103,2012-07-22,"R17","Fremantle",18,24,132,"GWS",5,7,37,"Subiaco",95,2012,"Regular",17,"Home","Fremantle","GWS",95
14104,2012-07-27,"R18","Essendon",12,14,86,"Hawthorn",27,18,180,"Docklands",-94,2012,"Regular",18,"Away","Hawthorn","Essendon",94
14105,2012-07-28,"R18","Geelong",15,12,102,"Adelaide",11,9,75,"Kardinia Park",27,2012,"Regular",18,"Home","Geelong","Adelaide",27
14106,2012-07-28,"R18","North Melbourne",19,13,127,"Melbourne",11,7,73,"Docklands",54,2012,"Regular",18,"Home","North Melbourne","Melbourne",54
14107,2012-07-28,"R18","GWS",7,12,54,"Collingwood",26,18,174,"Sydney Showground",-120,2012,"Regular",18,"Away","Collingwood","GWS",120
14108,2012-07-28,"R18","Carlton",14,11,95,"Richmond",13,13,91,"M.C.G.",4,2012,"Regular",18,"Home","Carlton","Richmond",4
14109,2012-07-28,"R18","Gold Coast",8,6,54,"Sydney",19,12,126,"Carrara",-72,2012,"Regular",18,"Away","Sydney","Gold Coast",72
14110,2012-07-29,"R18","Port Adelaide",6,12,48,"Fremantle",11,9,75,"Football Park",-27,2012,"Regular",18,"Away","Fremantle","Port Adelaide",27
14111,2012-07-29,"R18","St Kilda",16,22,118,"Footscray",6,6,42,"Docklands",76,2012,"Regular",18,"Home","St Kilda","Footscray",76
14112,2012-07-29,"R18","West Coast",28,7,175,"Brisbane Lions",12,5,77,"Subiaco",98,2012,"Regular",18,"Home","West Coast","Brisbane Lions",98
14113,2012-08-03,"R19","Hawthorn",17,14,116,"Geelong",18,10,118,"M.C.G.",-2,2012,"Regular",19,"Away","Geelong","Hawthorn",2
14114,2012-08-04,"R19","Footscray",8,13,61,"North Melbourne",18,7,115,"Docklands",-54,2012,"Regular",19,"Away","North Melbourne","Footscray",54
14115,2012-08-04,"R19","GWS",16,11,107,"Port Adelaide",10,13,73,"Sydney Showground",34,2012,"Regular",19,"Home","GWS","Port Adelaide",34
14116,2012-08-04,"R19","Fremantle",17,11,113,"West Coast",6,12,48,"Subiaco",65,2012,"Regular",19,"Home","Fremantle","West Coast",65
14117,2012-08-04,"R19","Collingwood",12,19,91,"St Kilda",13,7,85,"M.C.G.",6,2012,"Regular",19,"Home","Collingwood","St Kilda",6
14118,2012-08-04,"R19","Brisbane Lions",12,12,84,"Richmond",20,12,132,"Gabba",-48,2012,"Regular",19,"Away","Richmond","Brisbane Lions",48
14119,2012-08-05,"R19","Melbourne",16,12,108,"Gold Coast",9,12,66,"M.C.G.",42,2012,"Regular",19,"Home","Melbourne","Gold Coast",42
14120,2012-08-05,"R19","Carlton",10,11,71,"Sydney",14,9,93,"Docklands",-22,2012,"Regular",19,"Away","Sydney","Carlton",22
14121,2012-08-05,"R19","Adelaide",16,8,104,"Essendon",15,10,100,"Football Park",4,2012,"Regular",19,"Home","Adelaide","Essendon",4
14122,2012-08-10,"R20","West Coast",16,6,102,"Geelong",15,7,97,"Subiaco",5,2012,"Regular",20,"Home","West Coast","Geelong",5
14123,2012-08-11,"R20","St Kilda",16,11,107,"Melbourne",12,10,82,"M.C.G.",25,2012,"Regular",20,"Home","St Kilda","Melbourne",25
14124,2012-08-11,"R20","Adelaide",17,17,119,"Fremantle",14,7,91,"Football Park",28,2012,"Regular",20,"Home","Adelaide","Fremantle",28
14125,2012-08-11,"R20","Gold Coast",16,13,109,"GWS",12,7,79,"Carrara",30,2012,"Regular",20,"Home","Gold Coast","GWS",30
14126,2012-08-11,"R20","Carlton",17,11,113,"Brisbane Lions",10,17,77,"Docklands",36,2012,"Regular",20,"Home","Carlton","Brisbane Lions",36
14127,2012-08-11,"R20","Sydney",9,16,70,"Collingwood",12,6,78,"Stadium Australia",-8,2012,"Regular",20,"Away","Collingwood","Sydney",8
14128,2012-08-12,"R20","Hawthorn",24,15,159,"Port Adelaide",13,9,87,"York Park",72,2012,"Regular",20,"Home","Hawthorn","Port Adelaide",72
14129,2012-08-12,"R20","Richmond",22,18,150,"Footscray",12,8,80,"M.C.G.",70,2012,"Regular",20,"Home","Richmond","Footscray",70
14130,2012-08-12,"R20","Essendon",11,10,76,"North Melbourne",15,10,100,"Docklands",-24,2012,"Regular",20,"Away","North Melbourne","Essendon",24
14131,2012-08-17,"R21","Geelong",18,15,123,"St Kilda",11,15,81,"Docklands",42,2012,"Regular",21,"Home","Geelong","St Kilda",42
14132,2012-08-18,"R21","Essendon",8,12,60,"Carlton",24,12,156,"M.C.G.",-96,2012,"Regular",21,"Away","Carlton","Essendon",96
14133,2012-08-18,"R21","GWS",9,5,59,"Melbourne",11,18,84,"Manuka Oval",-25,2012,"Regular",21,"Away","Melbourne","GWS",25
14134,2012-08-18,"R21","Fremantle",13,16,94,"Richmond",11,6,72,"Subiaco",22,2012,"Regular",21,"Home","Fremantle","Richmond",22
14135,2012-08-18,"R21","Brisbane Lions",13,17,95,"Adelaide",12,13,85,"Gabba",10,2012,"Regular",21,"Home","Brisbane Lions","Adelaide",10
14136,2012-08-18,"R21","Collingwood",8,13,61,"North Melbourne",13,13,91,"Docklands",-30,2012,"Regular",21,"Away","North Melbourne","Collingwood",30
14137,2012-08-19,"R21","Port Adelaide",6,14,50,"West Coast",14,14,98,"Football Park",-48,2012,"Regular",21,"Away","West Coast","Port Adelaide",48
14138,2012-08-19,"R21","Footscray",13,7,85,"Sydney",26,11,167,"Docklands",-82,2012,"Regular",21,"Away","Sydney","Footscray",82
14139,2012-08-19,"R21","Hawthorn",19,15,129,"Gold Coast",10,5,65,"M.C.G.",64,2012,"Regular",21,"Home","Hawthorn","Gold Coast",64
14140,2012-08-24,"R22","Richmond",13,24,102,"Essendon",8,9,57,"M.C.G.",45,2012,"Regular",22,"Home","Richmond","Essendon",45
14141,2012-08-25,"R22","St Kilda",25,13,163,"GWS",5,5,35,"Docklands",128,2012,"Regular",22,"Home","St Kilda","GWS",128
14142,2012-08-25,"R22","Port Adelaide",14,9,93,"Brisbane Lions",16,8,104,"Football Park",-11,2012,"Regular",22,"Away","Brisbane Lions","Port Adelaide",11
14143,2012-08-25,"R22","Sydney",14,11,95,"Hawthorn",15,12,102,"S.C.G.",-7,2012,"Regular",22,"Away","Hawthorn","Sydney",7
14144,2012-08-25,"R22","Gold Coast",15,8,98,"Carlton",11,20,86,"Carrara",12,2012,"Regular",22,"Home","Gold Coast","Carlton",12
14145,2012-08-25,"R22","West Coast",15,17,107,"Collingwood",8,10,58,"Subiaco",49,2012,"Regular",22,"Home","West Coast","Collingwood",49
14146,2012-08-26,"R22","Geelong",16,11,107,"Footscray",11,7,73,"Kardinia Park",34,2012,"Regular",22,"Home","Geelong","Footscray",34
14147,2012-08-26,"R22","North Melbourne",12,7,79,"Fremantle",20,12,132,"Docklands",-53,2012,"Regular",22,"Away","Fremantle","North Melbourne",53
14148,2012-08-26,"R22","Melbourne",11,15,81,"Adelaide",22,18,150,"M.C.G.",-69,2012,"Regular",22,"Away","Adelaide","Melbourne",69
14149,2012-08-31,"R23","Hawthorn",14,11,95,"West Coast",10,10,70,"M.C.G.",25,2012,"Regular",23,"Home","Hawthorn","West Coast",25
14150,2012-09-01,"R23","Geelong",17,10,112,"Sydney",11,12,78,"Kardinia Park",34,2012,"Regular",23,"Home","Geelong","Sydney",34
14151,2012-09-01,"R23","Adelaide",22,21,153,"Gold Coast",9,8,62,"Football Park",91,2012,"Regular",23,"Home","Adelaide","Gold Coast",91
14152,2012-09-01,"R23","GWS",11,11,77,"North Melbourne",16,9,105,"Sydney Showground",-28,2012,"Regular",23,"Away","North Melbourne","GWS",28
14153,2012-09-01,"R23","Essendon",10,12,72,"Collingwood",14,20,104,"M.C.G.",-32,2012,"Regular",23,"Away","Collingwood","Essendon",32
14154,2012-09-01,"R23","Fremantle",14,17,101,"Melbourne",5,10,40,"Subiaco",61,2012,"Regular",23,"Home","Fremantle","Melbourne",61
14155,2012-09-02,"R23","Carlton",12,19,91,"St Kilda",16,10,106,"Docklands",-15,2012,"Regular",23,"Away","St Kilda","Carlton",15
14156,2012-09-02,"R23","Richmond",16,10,106,"Port Adelaide",16,10,106,"M.C.G.",0,2012,"Regular",23,"Home","Richmond","Port Adelaide",0
14157,2012-09-02,"R23","Brisbane Lions",19,14,128,"Footscray",9,7,61,"Gabba",67,2012,"Regular",23,"Home","Brisbane Lions","Footscray",67
14158,2012-09-07,"QF","Hawthorn",20,15,135,"Collingwood",15,7,97,"M.C.G.",38,2012,"Finals",24,"Home","Hawthorn","Collingwood",38
14159,2012-09-08,"QF","Adelaide",5,12,42,"Sydney",11,5,71,"Football Park",-29,2012,"Finals",24,"Away","Sydney","Adelaide",29
14160,2012-09-08,"EF","Geelong",11,14,80,"Fremantle",14,12,96,"M.C.G.",-16,2012,"Finals",24,"Away","Fremantle","Geelong",16
14161,2012-09-09,"EF","West Coast",24,18,162,"North Melbourne",9,12,66,"Subiaco",96,2012,"Finals",24,"Home","West Coast","North Melbourne",96
14162,2012-09-14,"SF","Adelaide",12,9,81,"Fremantle",11,5,71,"Football Park",10,2012,"Finals",25,"Home","Adelaide","Fremantle",10
14163,2012-09-15,"SF","Collingwood",10,13,73,"West Coast",9,6,60,"M.C.G.",13,2012,"Finals",25,"Home","Collingwood","West Coast",13
14164,2012-09-21,"PF","Sydney",13,18,96,"Collingwood",10,10,70,"Stadium Australia",26,2012,"Finals",26,"Home","Sydney","Collingwood",26
14165,2012-09-22,"PF","Hawthorn",13,19,97,"Adelaide",14,8,92,"M.C.G.",5,2012,"Finals",26,"Home","Hawthorn","Adelaide",5
14166,2012-09-29,"GF","Hawthorn",11,15,81,"Sydney",14,7,91,"M.C.G.",-10,2012,"Finals",27,"Away","Sydney","Hawthorn",10
14167,2013-03-22,"R1","Adelaide",11,16,82,"Essendon",18,9,117,"Football Park",-35,2013,"Regular",1,"Away","Essendon","Adelaide",35
14168,2013-03-23,"R1","Fremantle",16,12,108,"West Coast",11,14,80,"Subiaco",28,2013,"Regular",1,"Home","Fremantle","West Coast",28
14169,2013-03-28,"R1","Carlton",14,17,101,"Richmond",14,22,106,"M.C.G.",-5,2013,"Regular",1,"Away","Richmond","Carlton",5
14170,2013-03-30,"R1","Footscray",19,13,127,"Brisbane Lions",7,17,59,"Docklands",68,2013,"Regular",1,"Home","Footscray","Brisbane Lions",68
14171,2013-03-30,"R1","GWS",11,10,76,"Sydney",16,10,106,"Stadium Australia",-30,2013,"Regular",1,"Away","Sydney","GWS",30
14172,2013-03-30,"R1","Gold Coast",13,12,90,"St Kilda",10,17,77,"Carrara",13,2013,"Regular",1,"Home","Gold Coast","St Kilda",13
14173,2013-03-31,"R1","Melbourne",8,6,54,"Port Adelaide",19,19,133,"M.C.G.",-79,2013,"Regular",1,"Away","Port Adelaide","Melbourne",79
14174,2013-03-31,"R1","North Melbourne",13,9,87,"Collingwood",15,13,103,"Docklands",-16,2013,"Regular",1,"Away","Collingwood","North Melbourne",16
14175,2013-04-01,"R1","Hawthorn",12,14,86,"Geelong",13,15,93,"M.C.G.",-7,2013,"Regular",1,"Away","Geelong","Hawthorn",7
14176,2013-04-05,"R2","St Kilda",12,10,82,"Richmond",14,15,99,"M.C.G.",-17,2013,"Regular",2,"Away","Richmond","St Kilda",17
14177,2013-04-06,"R2","Sydney",17,12,114,"Gold Coast",11,7,73,"S.C.G.",41,2013,"Regular",2,"Home","Sydney","Gold Coast",41
14178,2013-04-06,"R2","Footscray",11,12,78,"Fremantle",16,10,106,"Docklands",-28,2013,"Regular",2,"Away","Fremantle","Footscray",28
14179,2013-04-06,"R2","Brisbane Lions",10,17,77,"Adelaide",14,12,96,"Gabba",-19,2013,"Regular",2,"Away","Adelaide","Brisbane Lions",19
14180,2013-04-06,"R2","Essendon",28,16,184,"Melbourne",5,6,36,"M.C.G.",148,2013,"Regular",2,"Home","Essendon","Melbourne",148
14181,2013-04-06,"R2","Port Adelaide",19,20,134,"GWS",11,12,78,"Football Park",56,2013,"Regular",2,"Home","Port Adelaide","GWS",56
14182,2013-04-07,"R2","Geelong",16,16,112,"North Melbourne",17,6,108,"Docklands",4,2013,"Regular",2,"Home","Geelong","North Melbourne",4
14183,2013-04-07,"R2","Collingwood",17,15,117,"Carlton",15,10,100,"M.C.G.",17,2013,"Regular",2,"Home","Collingwood","Carlton",17
14184,2013-04-07,"R2","West Coast",15,8,98,"Hawthorn",23,10,148,"Subiaco",-50,2013,"Regular",2,"Away","Hawthorn","West Coast",50
14185,2013-04-12,"R3","Fremantle",9,14,68,"Essendon",10,12,72,"Subiaco",-4,2013,"Regular",3,"Away","Essendon","Fremantle",4
14186,2013-04-13,"R3","North Melbourne",13,14,92,"Sydney",20,11,131,"Bellerive Oval",-39,2013,"Regular",3,"Away","Sydney","North Melbourne",39
14187,2013-04-13,"R3","Melbourne",13,5,83,"West Coast",27,15,177,"M.C.G.",-94,2013,"Regular",3,"Away","West Coast","Melbourne",94
14188,2013-04-13,"R3","GWS",10,8,68,"St Kilda",21,14,140,"Manuka Oval",-72,2013,"Regular",3,"Away","St Kilda","GWS",72
14189,2013-04-13,"R3","Geelong",18,11,119,"Carlton",15,13,103,"Docklands",16,2013,"Regular",3,"Home","Geelong","Carlton",16
14190,2013-04-13,"R3","Gold Coast",13,14,92,"Brisbane Lions",13,16,94,"Carrara",-2,2013,"Regular",3,"Away","Brisbane Lions","Gold Coast",2
14191,2013-04-14,"R3","Richmond",20,15,135,"Footscray",10,8,68,"Docklands",67,2013,"Regular",3,"Home","Richmond","Footscray",67
14192,2013-04-14,"R3","Collingwood",13,12,90,"Hawthorn",22,13,145,"M.C.G.",-55,2013,"Regular",3,"Away","Hawthorn","Collingwood",55
14193,2013-04-14,"R3","Port Adelaide",17,16,118,"Adelaide",16,13,109,"Football Park",9,2013,"Regular",3,"Home","Port Adelaide","Adelaide",9
14194,2013-04-19,"R4","Sydney",16,7,103,"Geelong",19,10,124,"S.C.G.",-21,2013,"Regular",4,"Away","Geelong","Sydney",21
14195,2013-04-20,"R4","Hawthorn",18,10,118,"Fremantle",11,10,76,"York Park",42,2013,"Regular",4,"Home","Hawthorn","Fremantle",42
14196,2013-04-20,"R4","Richmond",11,13,79,"Collingwood",16,17,113,"M.C.G.",-34,2013,"Regular",4,"Away","Collingwood","Richmond",34
14197,2013-04-20,"R4","St Kilda",13,13,91,"Essendon",19,14,128,"Docklands",-37,2013,"Regular",4,"Away","Essendon","St Kilda",37
14198,2013-04-20,"R4","West Coast",7,23,65,"Carlton",12,17,89,"Subiaco",-24,2013,"Regular",4,"Away","Carlton","West Coast",24
14199,2013-04-20,"R4","Gold Coast",9,12,66,"Port Adelaide",16,8,104,"Carrara",-38,2013,"Regular",4,"Away","Port Adelaide","Gold Coast",38
14200,2013-04-21,"R4","Melbourne",22,12,144,"GWS",15,13,103,"M.C.G.",41,2013,"Regular",4,"Home","Melbourne","GWS",41
14201,2013-04-21,"R4","Adelaide",12,8,80,"Footscray",4,4,28,"Football Park",52,2013,"Regular",4,"Home","Adelaide","Footscray",52
14202,2013-04-21,"R4","North Melbourne",18,17,125,"Brisbane Lions",9,8,62,"Docklands",63,2013,"Regular",4,"Home","North Melbourne","Brisbane Lions",63
14203,2013-04-25,"R5","Essendon",18,13,121,"Collingwood",10,15,75,"M.C.G.",46,2013,"Regular",5,"Home","Essendon","Collingwood",46
14204,2013-04-25,"R5","St Kilda",9,9,63,"Sydney",11,13,79,"Wellington",-16,2013,"Regular",5,"Away","Sydney","St Kilda",16
14205,2013-04-26,"R5","Fremantle",12,9,81,"Richmond",12,8,80,"Subiaco",1,2013,"Regular",5,"Home","Fremantle","Richmond",1
14206,2013-04-27,"R5","GWS",16,8,104,"Gold Coast",21,22,148,"Manuka Oval",-44,2013,"Regular",5,"Away","Gold Coast","GWS",44
14207,2013-04-27,"R5","Carlton",17,13,115,"Adelaide",12,11,83,"M.C.G.",32,2013,"Regular",5,"Home","Carlton","Adelaide",32
14208,2013-04-27,"R5","Footscray",13,8,86,"Geelong",15,17,107,"Docklands",-21,2013,"Regular",5,"Away","Geelong","Footscray",21
14209,2013-04-27,"R5","Port Adelaide",12,12,84,"West Coast",10,19,79,"Football Park",5,2013,"Regular",5,"Home","Port Adelaide","West Coast",5
14210,2013-04-28,"R5","Brisbane Lions",17,20,122,"Melbourne",14,10,94,"Gabba",28,2013,"Regular",5,"Home","Brisbane Lions","Melbourne",28
14211,2013-04-28,"R5","Hawthorn",14,15,99,"North Melbourne",13,18,96,"M.C.G.",3,2013,"Regular",5,"Home","Hawthorn","North Melbourne",3
14212,2013-05-03,"R6","Collingwood",15,13,103,"St Kilda",11,11,77,"Docklands",26,2013,"Regular",6,"Home","Collingwood","St Kilda",26
14213,2013-05-04,"R6","Essendon",17,18,120,"GWS",12,9,81,"Docklands",39,2013,"Regular",6,"Home","Essendon","GWS",39
14214,2013-05-04,"R6","North Melbourne",14,9,93,"Port Adelaide",12,11,83,"Bellerive Oval",10,2013,"Regular",6,"Home","North Melbourne","Port Adelaide",10
14215,2013-05-04,"R6","Adelaide",11,12,78,"Hawthorn",13,11,89,"Football Park",-11,2013,"Regular",6,"Away","Hawthorn","Adelaide",11
14216,2013-05-04,"R6","Gold Coast",7,12,54,"Fremantle",15,9,99,"Carrara",-45,2013,"Regular",6,"Away","Fremantle","Gold Coast",45
14217,2013-05-04,"R6","Richmond",13,9,87,"Geelong",20,11,131,"M.C.G.",-44,2013,"Regular",6,"Away","Geelong","Richmond",44
14218,2013-05-05,"R6","Sydney",17,13,115,"Brisbane Lions",8,7,55,"S.C.G.",60,2013,"Regular",6,"Home","Sydney","Brisbane Lions",60
14219,2013-05-05,"R6","Carlton",18,13,121,"Melbourne",8,12,60,"M.C.G.",61,2013,"Regular",6,"Home","Carlton","Melbourne",61
14220,2013-05-05,"R6","West Coast",21,11,137,"Footscray",10,7,67,"Subiaco",70,2013,"Regular",6,"Home","West Coast","Footscray",70
14221,2013-05-10,"R7","Geelong",17,11,113,"Essendon",11,19,85,"Docklands",28,2013,"Regular",7,"Home","Geelong","Essendon",28
14222,2013-05-11,"R7","Port Adelaide",10,13,73,"Richmond",18,6,114,"Football Park",-41,2013,"Regular",7,"Away","Richmond","Port Adelaide",41
14223,2013-05-11,"R7","Brisbane Lions",12,10,82,"West Coast",17,6,108,"Gabba",-26,2013,"Regular",7,"Away","West Coast","Brisbane Lions",26
14224,2013-05-11,"R7","Footscray",15,7,97,"North Melbourne",22,19,151,"Docklands",-54,2013,"Regular",7,"Away","North Melbourne","Footscray",54
14225,2013-05-11,"R7","Fremantle",15,10,100,"Collingwood",10,13,73,"Subiaco",27,2013,"Regular",7,"Home","Fremantle","Collingwood",27
14226,2013-05-11,"R7","Hawthorn",18,11,119,"Sydney",12,10,82,"M.C.G.",37,2013,"Regular",7,"Home","Hawthorn","Sydney",37
14227,2013-05-12,"R7","GWS",7,10,52,"Adelaide",29,13,187,"Sydney Showground",-135,2013,"Regular",7,"Away","Adelaide","GWS",135
14228,2013-05-12,"R7","Melbourne",7,12,54,"Gold Coast",16,18,114,"M.C.G.",-60,2013,"Regular",7,"Away","Gold Coast","Melbourne",60
14229,2013-05-13,"R7","St Kilda",11,11,77,"Carlton",9,14,68,"Docklands",9,2013,"Regular",7,"Home","St Kilda","Carlton",9
14230,2013-05-17,"R8","West Coast",12,18,90,"North Melbourne",13,10,88,"Subiaco",2,2013,"Regular",8,"Home","West Coast","North Melbourne",2
14231,2013-05-18,"R8","Essendon",12,14,86,"Brisbane Lions",14,12,96,"Docklands",-10,2013,"Regular",8,"Away","Brisbane Lions","Essendon",10
14232,2013-05-18,"R8","Hawthorn",21,14,140,"GWS",9,3,57,"York Park",83,2013,"Regular",8,"Home","Hawthorn","GWS",83
14233,2013-05-18,"R8","Gold Coast",13,15,93,"Footscray",8,13,61,"Carrara",32,2013,"Regular",8,"Home","Gold Coast","Footscray",32
14234,2013-05-18,"R8","Collingwood",15,12,102,"Geelong",14,12,96,"M.C.G.",6,2013,"Regular",8,"Home","Collingwood","Geelong",6
14235,2013-05-18,"R8","Sydney",11,4,70,"Fremantle",9,16,70,"S.C.G.",0,2013,"Regular",8,"Home","Sydney","Fremantle",0
14236,2013-05-19,"R8","Carlton",16,13,109,"Port Adelaide",14,7,91,"Docklands",18,2013,"Regular",8,"Home","Carlton","Port Adelaide",18
14237,2013-05-19,"R8","Richmond",15,16,106,"Melbourne",11,6,72,"M.C.G.",34,2013,"Regular",8,"Home","Richmond","Melbourne",34
14238,2013-05-19,"R8","Adelaide",12,15,87,"St Kilda",6,11,47,"Football Park",40,2013,"Regular",8,"Home","Adelaide","St Kilda",40
14239,2013-05-24,"R9","Collingwood",8,7,55,"Sydney",15,12,102,"M.C.G.",-47,2013,"Regular",9,"Away","Sydney","Collingwood",47
14240,2013-05-25,"R9","Port Adelaide",9,14,68,"Geelong",18,8,116,"Football Park",-48,2013,"Regular",9,"Away","Geelong","Port Adelaide",48
14241,2013-05-25,"R9","GWS",8,7,55,"West Coast",23,17,155,"Sydney Showground",-100,2013,"Regular",9,"Away","West Coast","GWS",100
14242,2013-05-25,"R9","St Kilda",15,11,101,"Footscray",17,8,110,"Docklands",-9,2013,"Regular",9,"Away","Footscray","St Kilda",9
14243,2013-05-25,"R9","Brisbane Lions",12,13,85,"Carlton",13,20,98,"Gabba",-13,2013,"Regular",9,"Away","Carlton","Brisbane Lions",13
14244,2013-05-25,"R9","Richmond",9,8,62,"Essendon",13,13,91,"M.C.G.",-29,2013,"Regular",9,"Away","Essendon","Richmond",29
14245,2013-05-26,"R9","Hawthorn",18,10,118,"Gold Coast",14,8,92,"M.C.G.",26,2013,"Regular",9,"Home","Hawthorn","Gold Coast",26
14246,2013-05-26,"R9","North Melbourne",19,10,124,"Adelaide",18,17,125,"Docklands",-1,2013,"Regular",9,"Away","Adelaide","North Melbourne",1
14247,2013-05-26,"R9","Fremantle",19,16,130,"Melbourne",6,4,40,"Subiaco",90,2013,"Regular",9,"Home","Fremantle","Melbourne",90
14248,2013-05-31,"R10","Brisbane Lions",7,9,51,"Collingwood",14,16,100,"Gabba",-49,2013,"Regular",10,"Away","Collingwood","Brisbane Lions",49
14249,2013-06-01,"R10","Carlton",22,16,148,"GWS",8,6,54,"Docklands",94,2013,"Regular",10,"Home","Carlton","GWS",94
14250,2013-06-01,"R10","Adelaide",8,11,59,"Fremantle",10,6,66,"Football Park",-7,2013,"Regular",10,"Away","Fremantle","Adelaide",7
14251,2013-06-01,"R10","Sydney",17,13,115,"Essendon",10,11,71,"S.C.G.",44,2013,"Regular",10,"Home","Sydney","Essendon",44
14252,2013-06-01,"R10","Footscray",10,7,67,"Port Adelaide",8,10,58,"Marrara Oval",9,2013,"Regular",10,"Home","Footscray","Port Adelaide",9
14253,2013-06-01,"R10","Geelong",18,15,123,"Gold Coast",10,11,71,"Kardinia Park",52,2013,"Regular",10,"Home","Geelong","Gold Coast",52
14254,2013-06-02,"R10","Melbourne",6,12,48,"Hawthorn",21,17,143,"M.C.G.",-95,2013,"Regular",10,"Away","Hawthorn","Melbourne",95
14255,2013-06-02,"R10","North Melbourne",19,19,133,"St Kilda",10,5,65,"Docklands",68,2013,"Regular",10,"Home","North Melbourne","St Kilda",68
14256,2013-06-03,"R10","West Coast",8,14,62,"Richmond",16,7,103,"Subiaco",-41,2013,"Regular",10,"Away","Richmond","West Coast",41
14257,2013-06-07,"R11","Essendon",11,11,77,"Carlton",10,12,72,"M.C.G.",5,2013,"Regular",11,"Home","Essendon","Carlton",5
14258,2013-06-08,"R11","GWS",15,8,98,"Geelong",24,13,157,"Sydney Showground",-59,2013,"Regular",11,"Away","Geelong","GWS",59
14259,2013-06-08,"R11","Adelaide",6,14,50,"Sydney",19,13,127,"Football Park",-77,2013,"Regular",11,"Away","Sydney","Adelaide",77
14260,2013-06-08,"R11","Gold Coast",9,12,66,"North Melbourne",8,3,51,"Carrara",15,2013,"Regular",11,"Home","Gold Coast","North Melbourne",15
14261,2013-06-09,"R11","St Kilda",11,14,80,"West Coast",12,12,84,"Docklands",-4,2013,"Regular",11,"Away","West Coast","St Kilda",4
14262,2013-06-10,"R11","Melbourne",5,9,39,"Collingwood",17,20,122,"M.C.G.",-83,2013,"Regular",11,"Away","Collingwood","Melbourne",83
14263,2013-06-14,"R12","Carlton",13,9,87,"Hawthorn",15,12,102,"Docklands",-15,2013,"Regular",12,"Away","Hawthorn","Carlton",15
14264,2013-06-15,"R12","Richmond",16,14,110,"Adelaide",10,12,72,"M.C.G.",38,2013,"Regular",12,"Home","Richmond","Adelaide",38
14265,2013-06-15,"R12","Fremantle",12,14,86,"Brisbane Lions",6,10,46,"Subiaco",40,2013,"Regular",12,"Home","Fremantle","Brisbane Lions",40
14266,2013-06-15,"R12","Essendon",17,13,115,"Gold Coast",11,6,72,"Docklands",43,2013,"Regular",12,"Home","Essendon","Gold Coast",43
14267,2013-06-16,"R12","GWS",6,14,50,"Port Adelaide",19,11,125,"Sydney Showground",-75,2013,"Regular",12,"Away","Port Adelaide","GWS",75
14268,2013-06-16,"R12","Collingwood",15,9,99,"Footscray",9,11,65,"Docklands",34,2013,"Regular",12,"Home","Collingwood","Footscray",34
14269,2013-06-21,"R13","Hawthorn",19,9,123,"West Coast",16,7,103,"Docklands",20,2013,"Regular",13,"Home","Hawthorn","West Coast",20
14270,2013-06-22,"R13","Port Adelaide",10,12,72,"Sydney",8,6,54,"Football Park",18,2013,"Regular",13,"Home","Port Adelaide","Sydney",18
14271,2013-06-22,"R13","St Kilda",16,8,104,"Melbourne",10,9,69,"M.C.G.",35,2013,"Regular",13,"Home","St Kilda","Melbourne",35
14272,2013-06-22,"R13","Footscray",8,13,61,"Richmond",17,19,121,"Docklands",-60,2013,"Regular",13,"Away","Richmond","Footscray",60
14273,2013-06-23,"R13","Fremantle",10,7,67,"North Melbourne",4,5,29,"Subiaco",38,2013,"Regular",13,"Home","Fremantle","North Melbourne",38
14274,2013-06-23,"R13","Brisbane Lions",15,13,103,"Geelong",14,14,98,"Gabba",5,2013,"Regular",13,"Home","Brisbane Lions","Geelong",5
14275,2013-06-27,"R14","West Coast",13,13,91,"Essendon",15,8,98,"Subiaco",-7,2013,"Regular",14,"Away","Essendon","West Coast",7
14276,2013-06-28,"R14","Sydney",8,17,65,"Carlton",5,13,43,"S.C.G.",22,2013,"Regular",14,"Home","Sydney","Carlton",22
14277,2013-06-29,"R14","Gold Coast",11,17,83,"Adelaide",16,15,111,"Carrara",-28,2013,"Regular",14,"Away","Adelaide","Gold Coast",28
14278,2013-06-29,"R14","Port Adelaide",13,8,86,"Collingwood",7,9,51,"Football Park",35,2013,"Regular",14,"Home","Port Adelaide","Collingwood",35
14279,2013-06-29,"R14","Melbourne",15,13,103,"Footscray",15,10,100,"M.C.G.",3,2013,"Regular",14,"Home","Melbourne","Footscray",3
14280,2013-06-29,"R14","Geelong",11,19,85,"Fremantle",7,2,44,"Kardinia Park",41,2013,"Regular",14,"Home","Geelong","Fremantle",41
14281,2013-06-30,"R14","Hawthorn",21,17,143,"Brisbane Lions",12,13,85,"York Park",58,2013,"Regular",14,"Home","Hawthorn","Brisbane Lions",58
14282,2013-06-30,"R14","North Melbourne",19,16,130,"GWS",6,8,44,"Docklands",86,2013,"Regular",14,"Home","North Melbourne","GWS",86
14283,2013-06-30,"R14","Richmond",17,17,119,"St Kilda",8,7,55,"M.C.G.",64,2013,"Regular",14,"Home","Richmond","St Kilda",64
14284,2013-07-05,"R15","Carlton",12,5,77,"Collingwood",17,16,118,"M.C.G.",-41,2013,"Regular",15,"Away","Collingwood","Carlton",41
14285,2013-07-06,"R15","GWS",12,11,83,"Footscray",13,9,87,"Manuka Oval",-4,2013,"Regular",15,"Away","Footscray","GWS",4
14286,2013-07-06,"R15","North Melbourne",19,14,128,"Richmond",8,18,66,"Docklands",62,2013,"Regular",15,"Home","North Melbourne","Richmond",62
14287,2013-07-06,"R15","Brisbane Lions",17,14,116,"Gold Coast",12,11,83,"Gabba",33,2013,"Regular",15,"Home","Brisbane Lions","Gold Coast",33
14288,2013-07-06,"R15","Adelaide",9,15,69,"West Coast",11,9,75,"Football Park",-6,2013,"Regular",15,"Away","West Coast","Adelaide",6
14289,2013-07-06,"R15","Geelong",11,16,82,"Hawthorn",10,12,72,"M.C.G.",10,2013,"Regular",15,"Home","Geelong","Hawthorn",10
14290,2013-07-07,"R15","Melbourne",13,7,85,"Sydney",16,20,116,"M.C.G.",-31,2013,"Regular",15,"Away","Sydney","Melbourne",31
14291,2013-07-07,"R15","Fremantle",15,10,100,"St Kilda",11,4,70,"Subiaco",30,2013,"Regular",15,"Home","Fremantle","St Kilda",30
14292,2013-07-07,"R15","Essendon",18,10,118,"Port Adelaide",12,16,88,"Docklands",30,2013,"Regular",15,"Home","Essendon","Port Adelaide",30
14293,2013-07-12,"R16","Collingwood",17,9,111,"Adelaide",12,12,84,"M.C.G.",27,2013,"Regular",16,"Home","Collingwood","Adelaide",27
14294,2013-07-13,"R16","Port Adelaide",12,7,79,"Hawthorn",19,10,124,"Football Park",-45,2013,"Regular",16,"Away","Hawthorn","Port Adelaide",45
14295,2013-07-13,"R16","Geelong",13,20,98,"Melbourne",4,6,30,"Kardinia Park",68,2013,"Regular",16,"Home","Geelong","Melbourne",68
14296,2013-07-13,"R16","Richmond",6,17,53,"Gold Coast",6,8,44,"Cazaly's Stadium",9,2013,"Regular",16,"Home","Richmond","Gold Coast",9
14297,2013-07-13,"R16","Carlton",16,14,110,"St Kilda",10,14,74,"Docklands",36,2013,"Regular",16,"Home","Carlton","St Kilda",36
14298,2013-07-13,"R16","Brisbane Lions",18,9,117,"North Melbourne",17,3,105,"Gabba",12,2013,"Regular",16,"Home","Brisbane Lions","North Melbourne",12
14299,2013-07-14,"R16","Sydney",24,27,171,"GWS",5,12,42,"S.C.G.",129,2013,"Regular",16,"Home","Sydney","GWS",129
14300,2013-07-14,"R16","Footscray",14,6,90,"Essendon",18,13,121,"Docklands",-31,2013,"Regular",16,"Away","Essendon","Footscray",31
14301,2013-07-14,"R16","West Coast",14,9,93,"Fremantle",19,7,121,"Subiaco",-28,2013,"Regular",16,"Away","Fremantle","West Coast",28
14302,2013-07-19,"R17","North Melbourne",16,12,108,"Carlton",16,13,109,"Docklands",-1,2013,"Regular",17,"Away","Carlton","North Melbourne",1
14303,2013-07-20,"R17","Hawthorn",13,17,95,"Footscray",11,10,76,"York Park",19,2013,"Regular",17,"Home","Hawthorn","Footscray",19
14304,2013-07-20,"R17","GWS",11,11,77,"Essendon",18,8,116,"Sydney Showground",-39,2013,"Regular",17,"Away","Essendon","GWS",39
14305,2013-07-20,"R17","Gold Coast",13,7,85,"Collingwood",11,12,78,"Carrara",7,2013,"Regular",17,"Home","Gold Coast","Collingwood",7
14306,2013-07-20,"R17","Melbourne",11,9,75,"Brisbane Lions",13,16,94,"Marrara Oval",-19,2013,"Regular",17,"Away","Brisbane Lions","Melbourne",19
14307,2013-07-20,"R17","St Kilda",13,14,92,"Port Adelaide",14,13,97,"Docklands",-5,2013,"Regular",17,"Away","Port Adelaide","St Kilda",5
14308,2013-07-21,"R17","Richmond",12,12,84,"Fremantle",8,9,57,"M.C.G.",27,2013,"Regular",17,"Home","Richmond","Fremantle",27
14309,2013-07-21,"R17","Adelaide",14,10,94,"Geelong",14,8,92,"Football Park",2,2013,"Regular",17,"Home","Adelaide","Geelong",2
14310,2013-07-21,"R17","West Coast",11,13,79,"Sydney",17,11,113,"Subiaco",-34,2013,"Regular",17,"Away","Sydney","West Coast",34
14311,2013-07-26,"R18","Essendon",13,9,87,"Hawthorn",22,11,143,"Docklands",-56,2013,"Regular",18,"Away","Hawthorn","Essendon",56
14312,2013-07-27,"R18","Gold Coast",11,11,77,"Carlton",16,24,120,"Carrara",-43,2013,"Regular",18,"Away","Carlton","Gold Coast",43
14313,2013-07-27,"R18","Melbourne",4,4,28,"North Melbourne",22,18,150,"Docklands",-122,2013,"Regular",18,"Away","North Melbourne","Melbourne",122
14314,2013-07-27,"R18","Collingwood",15,16,106,"GWS",10,6,66,"M.C.G.",40,2013,"Regular",18,"Home","Collingwood","GWS",40
14315,2013-07-27,"R18","Fremantle",11,9,75,"Adelaide",7,11,53,"Subiaco",22,2013,"Regular",18,"Home","Fremantle","Adelaide",22
14316,2013-07-27,"R18","Geelong",21,11,137,"St Kilda",5,6,36,"Kardinia Park",101,2013,"Regular",18,"Home","Geelong","St Kilda",101
14317,2013-07-28,"R18","Port Adelaide",9,17,71,"Brisbane Lions",9,8,62,"Football Park",9,2013,"Regular",18,"Home","Port Adelaide","Brisbane Lions",9
14318,2013-07-28,"R18","Footscray",16,15,111,"West Coast",13,11,89,"Docklands",22,2013,"Regular",18,"Home","Footscray","West Coast",22
14319,2013-07-28,"R18","Sydney",16,14,110,"Richmond",9,9,63,"S.C.G.",47,2013,"Regular",18,"Home","Sydney","Richmond",47
14320,2013-08-02,"R19","North Melbourne",15,6,96,"Geelong",13,8,86,"Docklands",10,2013,"Regular",19,"Home","North Melbourne","Geelong",10
14321,2013-08-03,"R19","GWS",19,10,124,"Melbourne",12,15,87,"Sydney Showground",37,2013,"Regular",19,"Home","GWS","Melbourne",37
14322,2013-08-03,"R19","Hawthorn",9,12,66,"Richmond",16,11,107,"M.C.G.",-41,2013,"Regular",19,"Away","Richmond","Hawthorn",41
14323,2013-08-03,"R19","West Coast",20,10,130,"Gold Coast",17,11,113,"Subiaco",17,2013,"Regular",19,"Home","West Coast","Gold Coast",17
14324,2013-08-03,"R19","Carlton",12,8,80,"Fremantle",17,14,116,"Docklands",-36,2013,"Regular",19,"Away","Fremantle","Carlton",36
14325,2013-08-03,"R19","Brisbane Lions",16,12,108,"St Kilda",11,11,77,"Gabba",31,2013,"Regular",19,"Home","Brisbane Lions","St Kilda",31
14326,2013-08-04,"R19","Footscray",15,9,99,"Sydney",21,8,134,"Docklands",-35,2013,"Regular",19,"Away","Sydney","Footscray",35
14327,2013-08-04,"R19","Adelaide",15,13,103,"Port Adelaide",17,5,107,"Football Park",-4,2013,"Regular",19,"Away","Port Adelaide","Adelaide",4
14328,2013-08-04,"R19","Collingwood",20,13,133,"Essendon",7,12,54,"M.C.G.",79,2013,"Regular",19,"Home","Collingwood","Essendon",79
14329,2013-08-09,"R20","St Kilda",7,14,56,"Hawthorn",14,18,102,"Docklands",-46,2013,"Regular",20,"Away","Hawthorn","St Kilda",46
14330,2013-08-10,"R20","Richmond",14,13,97,"Brisbane Lions",11,8,74,"M.C.G.",23,2013,"Regular",20,"Home","Richmond","Brisbane Lions",23
14331,2013-08-10,"R20","Geelong",20,9,129,"Port Adelaide",16,8,104,"Kardinia Park",25,2013,"Regular",20,"Home","Geelong","Port Adelaide",25
14332,2013-08-10,"R20","Carlton",13,11,89,"Footscray",16,21,117,"Docklands",-28,2013,"Regular",20,"Away","Footscray","Carlton",28
14333,2013-08-10,"R20","Sydney",10,11,71,"Collingwood",14,16,100,"Stadium Australia",-29,2013,"Regular",20,"Away","Collingwood","Sydney",29
14334,2013-08-10,"R20","Gold Coast",13,12,90,"Melbourne",10,17,77,"Carrara",13,2013,"Regular",20,"Home","Gold Coast","Melbourne",13
14335,2013-08-11,"R20","Essendon",9,13,67,"West Coast",18,12,120,"Docklands",-53,2013,"Regular",20,"Away","West Coast","Essendon",53
14336,2013-08-11,"R20","Adelaide",11,13,79,"North Melbourne",10,10,70,"Football Park",9,2013,"Regular",20,"Home","Adelaide","North Melbourne",9
14337,2013-08-11,"R20","Fremantle",24,13,157,"GWS",6,8,44,"Subiaco",113,2013,"Regular",20,"Home","Fremantle","GWS",113
14338,2013-08-16,"R21","Hawthorn",18,11,119,"Collingwood",12,12,84,"M.C.G.",35,2013,"Regular",21,"Home","Hawthorn","Collingwood",35
14339,2013-08-17,"R21","Richmond",14,12,96,"Carlton",16,10,106,"M.C.G.",-10,2013,"Regular",21,"Away","Carlton","Richmond",10
14340,2013-08-17,"R21","Port Adelaide",16,17,113,"Gold Coast",14,12,96,"Football Park",17,2013,"Regular",21,"Home","Port Adelaide","Gold Coast",17
14341,2013-08-17,"R21","Essendon",9,16,70,"North Melbourne",17,13,115,"Docklands",-45,2013,"Regular",21,"Away","North Melbourne","Essendon",45
14342,2013-08-17,"R21","West Coast",6,5,41,"Geelong",16,11,107,"Subiaco",-66,2013,"Regular",21,"Away","Geelong","West Coast",66
14343,2013-08-17,"R21","Brisbane Lions",18,15,123,"GWS",9,9,63,"Gabba",60,2013,"Regular",21,"Home","Brisbane Lions","GWS",60
14344,2013-08-18,"R21","Melbourne",5,8,38,"Fremantle",20,13,133,"M.C.G.",-95,2013,"Regular",21,"Away","Fremantle","Melbourne",95
14345,2013-08-18,"R21","Sydney",18,10,118,"St Kilda",8,11,59,"S.C.G.",59,2013,"Regular",21,"Home","Sydney","St Kilda",59
14346,2013-08-18,"R21","Footscray",20,11,131,"Adelaide",17,12,114,"Docklands",17,2013,"Regular",21,"Home","Footscray","Adelaide",17
14347,2013-08-23,"R22","Collingwood",15,11,101,"West Coast",5,9,39,"M.C.G.",62,2013,"Regular",22,"Home","Collingwood","West Coast",62
14348,2013-08-24,"R22","Adelaide",18,12,120,"Melbourne",7,10,52,"Football Park",68,2013,"Regular",22,"Home","Adelaide","Melbourne",68
14349,2013-08-24,"R22","North Melbourne",15,13,103,"Hawthorn",17,15,117,"Docklands",-14,2013,"Regular",22,"Away","Hawthorn","North Melbourne",14
14350,2013-08-24,"R22","Geelong",13,14,92,"Sydney",7,6,48,"Kardinia Park",44,2013,"Regular",22,"Home","Geelong","Sydney",44
14351,2013-08-24,"R22","Carlton",9,22,76,"Essendon",12,10,82,"M.C.G.",-6,2013,"Regular",22,"Away","Essendon","Carlton",6
14352,2013-08-24,"R22","Fremantle",21,8,134,"Port Adelaide",9,6,60,"Subiaco",74,2013,"Regular",22,"Home","Fremantle","Port Adelaide",74
14353,2013-08-25,"R22","St Kilda",17,14,116,"Gold Coast",10,10,70,"Docklands",46,2013,"Regular",22,"Home","St Kilda","Gold Coast",46
14354,2013-08-25,"R22","GWS",6,6,42,"Richmond",25,13,163,"Sydney Showground",-121,2013,"Regular",22,"Away","Richmond","GWS",121
14355,2013-08-25,"R22","Brisbane Lions",15,10,100,"Footscray",13,15,93,"Gabba",7,2013,"Regular",22,"Home","Brisbane Lions","Footscray",7
14356,2013-08-30,"R23","Sydney",16,4,100,"Hawthorn",17,10,112,"Stadium Australia",-12,2013,"Regular",23,"Away","Hawthorn","Sydney",12
14357,2013-08-31,"R23","St Kilda",16,16,112,"Fremantle",6,5,41,"Docklands",71,2013,"Regular",23,"Home","St Kilda","Fremantle",71
14358,2013-08-31,"R23","Geelong",15,22,112,"Brisbane Lions",17,9,111,"Kardinia Park",1,2013,"Regular",23,"Home","Geelong","Brisbane Lions",1
14359,2013-08-31,"R23","Port Adelaide",15,13,103,"Carlton",15,14,104,"Football Park",-1,2013,"Regular",23,"Away","Carlton","Port Adelaide",1
14360,2013-08-31,"R23","Essendon",9,11,65,"Richmond",15,14,104,"M.C.G.",-39,2013,"Regular",23,"Away","Richmond","Essendon",39
14361,2013-08-31,"R23","West Coast",5,13,43,"Adelaide",19,15,129,"Subiaco",-86,2013,"Regular",23,"Away","Adelaide","West Coast",86
14362,2013-09-01,"R23","Gold Coast",22,14,146,"GWS",9,9,63,"Carrara",83,2013,"Regular",23,"Home","Gold Coast","GWS",83
14363,2013-09-01,"R23","Collingwood",17,12,114,"North Melbourne",19,11,125,"M.C.G.",-11,2013,"Regular",23,"Away","North Melbourne","Collingwood",11
14364,2013-09-01,"R23","Footscray",16,11,107,"Melbourne",13,9,87,"Docklands",20,2013,"Regular",23,"Home","Footscray","Melbourne",20
14365,2013-09-06,"QF","Hawthorn",15,15,105,"Sydney",7,9,51,"M.C.G.",54,2013,"Finals",24,"Home","Hawthorn","Sydney",54
14366,2013-09-07,"QF","Geelong",9,18,72,"Fremantle",12,15,87,"Kardinia Park",-15,2013,"Finals",24,"Away","Fremantle","Geelong",15
14367,2013-09-07,"EF","Collingwood",9,9,63,"Port Adelaide",12,15,87,"M.C.G.",-24,2013,"Finals",24,"Away","Port Adelaide","Collingwood",24
14368,2013-09-08,"EF","Richmond",14,12,96,"Carlton",18,8,116,"M.C.G.",-20,2013,"Finals",24,"Away","Carlton","Richmond",20
14369,2013-09-13,"SF","Geelong",13,18,96,"Port Adelaide",12,8,80,"M.C.G.",16,2013,"Finals",25,"Home","Geelong","Port Adelaide",16
14370,2013-09-14,"SF","Sydney",13,8,86,"Carlton",8,14,62,"Stadium Australia",24,2013,"Finals",25,"Home","Sydney","Carlton",24
14371,2013-09-20,"PF","Hawthorn",14,18,102,"Geelong",15,7,97,"M.C.G.",5,2013,"Finals",26,"Home","Hawthorn","Geelong",5
14372,2013-09-21,"PF","Fremantle",14,15,99,"Sydney",11,8,74,"Subiaco",25,2013,"Finals",26,"Home","Fremantle","Sydney",25
14373,2013-09-28,"GF","Hawthorn",11,11,77,"Fremantle",8,14,62,"M.C.G.",15,2013,"Finals",27,"Home","Hawthorn","Fremantle",15
14374,2014-03-14,"R1","Collingwood",5,16,46,"Fremantle",17,14,116,"Docklands",-70,2014,"Regular",1,"Away","Fremantle","Collingwood",70
14375,2014-03-15,"R1","GWS",15,9,99,"Sydney",9,13,67,"Sydney Showground",32,2014,"Regular",1,"Home","GWS","Sydney",32
14376,2014-03-15,"R1","Gold Coast",12,15,87,"Richmond",10,9,69,"Carrara",18,2014,"Regular",1,"Home","Gold Coast","Richmond",18
14377,2014-03-16,"R1","Carlton",12,15,87,"Port Adelaide",18,12,120,"Docklands",-33,2014,"Regular",1,"Away","Port Adelaide","Carlton",33
14378,2014-03-20,"R1","Geelong",18,11,119,"Adelaide",12,9,81,"Kardinia Park",38,2014,"Regular",1,"Home","Geelong","Adelaide",38
14379,2014-03-21,"R1","North Melbourne",9,6,60,"Essendon",15,9,99,"Docklands",-39,2014,"Regular",1,"Away","Essendon","North Melbourne",39
14380,2014-03-22,"R1","Hawthorn",21,13,139,"Brisbane Lions",13,13,91,"York Park",48,2014,"Regular",1,"Home","Hawthorn","Brisbane Lions",48
14381,2014-03-22,"R1","St Kilda",10,8,68,"Melbourne",6,15,51,"Docklands",17,2014,"Regular",1,"Home","St Kilda","Melbourne",17
14382,2014-03-23,"R1","West Coast",21,8,134,"Footscray",11,3,69,"Subiaco",65,2014,"Regular",1,"Home","West Coast","Footscray",65
14383,2014-03-27,"R2","Richmond",14,14,98,"Carlton",12,14,86,"M.C.G.",12,2014,"Regular",2,"Home","Richmond","Carlton",12
14384,2014-03-28,"R2","Essendon",12,14,86,"Hawthorn",13,12,90,"Docklands",-4,2014,"Regular",2,"Away","Hawthorn","Essendon",4
14385,2014-03-29,"R2","St Kilda",15,5,95,"GWS",13,10,88,"Docklands",7,2014,"Regular",2,"Home","St Kilda","GWS",7
14386,2014-03-29,"R2","Port Adelaide",19,13,127,"Adelaide",11,7,73,"Adelaide Oval",54,2014,"Regular",2,"Home","Port Adelaide","Adelaide",54
14387,2014-03-29,"R2","Sydney",10,9,69,"Collingwood",12,17,89,"Stadium Australia",-20,2014,"Regular",2,"Away","Collingwood","Sydney",20
14388,2014-03-29,"R2","Fremantle",12,15,87,"Gold Coast",5,9,39,"Subiaco",48,2014,"Regular",2,"Home","Fremantle","Gold Coast",48
14389,2014-03-30,"R2","Brisbane Lions",10,8,68,"Geelong",13,15,93,"Gabba",-25,2014,"Regular",2,"Away","Geelong","Brisbane Lions",25
14390,2014-03-30,"R2","Melbourne",4,6,30,"West Coast",18,15,123,"M.C.G.",-93,2014,"Regular",2,"Away","West Coast","Melbourne",93
14391,2014-03-30,"R2","Footscray",8,6,54,"North Melbourne",12,11,83,"Docklands",-29,2014,"Regular",2,"Away","North Melbourne","Footscray",29
14392,2014-04-04,"R3","Hawthorn",21,11,137,"Fremantle",11,13,79,"M.C.G.",58,2014,"Regular",3,"Home","Hawthorn","Fremantle",58
14393,2014-04-05,"R3","Adelaide",9,17,71,"Sydney",21,8,134,"Adelaide Oval",-63,2014,"Regular",3,"Away","Sydney","Adelaide",63
14394,2014-04-05,"R3","Footscray",15,10,100,"Richmond",15,8,98,"Docklands",2,2014,"Regular",3,"Home","Footscray","Richmond",2
14395,2014-04-05,"R3","Gold Coast",17,12,114,"Brisbane Lions",9,7,61,"Carrara",53,2014,"Regular",3,"Home","Gold Coast","Brisbane Lions",53
14396,2014-04-05,"R3","Collingwood",11,10,76,"Geelong",12,15,87,"M.C.G.",-11,2014,"Regular",3,"Away","Geelong","Collingwood",11
14397,2014-04-05,"R3","West Coast",12,11,83,"St Kilda",8,10,58,"Subiaco",25,2014,"Regular",3,"Home","West Coast","St Kilda",25
14398,2014-04-06,"R3","GWS",10,19,79,"Melbourne",7,5,47,"Sydney Showground",32,2014,"Regular",3,"Home","GWS","Melbourne",32
14399,2014-04-06,"R3","North Melbourne",14,13,97,"Port Adelaide",13,12,90,"Docklands",7,2014,"Regular",3,"Home","North Melbourne","Port Adelaide",7
14400,2014-04-06,"R3","Essendon",21,12,138,"Carlton",8,9,57,"M.C.G.",81,2014,"Regular",3,"Home","Essendon","Carlton",81
14401,2014-04-11,"R4","Richmond",10,12,72,"Collingwood",16,14,110,"M.C.G.",-38,2014,"Regular",4,"Away","Collingwood","Richmond",38
14402,2014-04-12,"R4","Carlton",7,16,58,"Melbourne",12,9,81,"M.C.G.",-23,2014,"Regular",4,"Away","Melbourne","Carlton",23
14403,2014-04-12,"R4","Port Adelaide",24,15,159,"Brisbane Lions",7,4,46,"Adelaide Oval",113,2014,"Regular",4,"Home","Port Adelaide","Brisbane Lions",113
14404,2014-04-12,"R4","GWS",12,11,83,"Footscray",17,8,110,"Manuka Oval",-27,2014,"Regular",4,"Away","Footscray","GWS",27
14405,2014-04-12,"R4","Geelong",16,11,107,"West Coast",4,8,32,"Kardinia Park",75,2014,"Regular",4,"Home","Geelong","West Coast",75
14406,2014-04-12,"R4","Gold Coast",7,7,49,"Hawthorn",23,10,148,"Carrara",-99,2014,"Regular",4,"Away","Hawthorn","Gold Coast",99
14407,2014-04-13,"R4","Sydney",6,12,48,"North Melbourne",13,13,91,"S.C.G.",-43,2014,"Regular",4,"Away","North Melbourne","Sydney",43
14408,2014-04-13,"R4","St Kilda",7,8,50,"Adelaide",20,16,136,"Docklands",-86,2014,"Regular",4,"Away","Adelaide","St Kilda",86
14409,2014-04-13,"R4","Fremantle",18,5,113,"Essendon",9,6,60,"Subiaco",53,2014,"Regular",4,"Home","Fremantle","Essendon",53
14410,2014-04-17,"R5","Brisbane Lions",9,9,63,"Richmond",15,16,106,"Gabba",-43,2014,"Regular",5,"Away","Richmond","Brisbane Lions",43
14411,2014-04-19,"R5","Collingwood",13,15,93,"North Melbourne",8,10,58,"M.C.G.",35,2014,"Regular",5,"Home","Collingwood","North Melbourne",35
14412,2014-04-19,"R5","Sydney",13,14,92,"Fremantle",11,9,75,"S.C.G.",17,2014,"Regular",5,"Home","Sydney","Fremantle",17
14413,2014-04-19,"R5","Essendon",9,11,65,"St Kilda",11,15,81,"Docklands",-16,2014,"Regular",5,"Away","St Kilda","Essendon",16
14414,2014-04-19,"R5","West Coast",7,14,56,"Port Adelaide",10,10,70,"Subiaco",-14,2014,"Regular",5,"Away","Port Adelaide","West Coast",14
14415,2014-04-20,"R5","Adelaide",21,11,137,"GWS",10,12,72,"Adelaide Oval",65,2014,"Regular",5,"Home","Adelaide","GWS",65
14416,2014-04-20,"R5","Melbourne",11,12,78,"Gold Coast",11,20,86,"M.C.G.",-8,2014,"Regular",5,"Away","Gold Coast","Melbourne",8
14417,2014-04-20,"R5","Footscray",13,13,91,"Carlton",18,11,119,"Docklands",-28,2014,"Regular",5,"Away","Carlton","Footscray",28
14418,2014-04-21,"R5","Geelong",15,16,106,"Hawthorn",12,15,87,"M.C.G.",19,2014,"Regular",5,"Home","Geelong","Hawthorn",19
14419,2014-04-25,"R6","Collingwood",12,11,83,"Essendon",8,12,60,"M.C.G.",23,2014,"Regular",6,"Home","Collingwood","Essendon",23
14420,2014-04-25,"R6","St Kilda",11,13,79,"Brisbane Lions",12,10,82,"Wellington",-3,2014,"Regular",6,"Away","Brisbane Lions","St Kilda",3
14421,2014-04-25,"R6","Fremantle",8,13,61,"North Melbourne",10,14,74,"Subiaco",-13,2014,"Regular",6,"Away","North Melbourne","Fremantle",13
14422,2014-04-26,"R6","Gold Coast",20,14,134,"GWS",13,16,94,"Carrara",40,2014,"Regular",6,"Home","Gold Coast","GWS",40
14423,2014-04-26,"R6","Carlton",14,8,92,"West Coast",12,17,89,"Docklands",3,2014,"Regular",6,"Home","Carlton","West Coast",3
14424,2014-04-26,"R6","Melbourne",5,8,38,"Sydney",9,15,69,"M.C.G.",-31,2014,"Regular",6,"Away","Sydney","Melbourne",31
14425,2014-04-27,"R6","Footscray",12,11,83,"Adelaide",13,14,92,"Docklands",-9,2014,"Regular",6,"Away","Adelaide","Footscray",9
14426,2014-04-27,"R6","Richmond",7,10,52,"Hawthorn",18,10,118,"M.C.G.",-66,2014,"Regular",6,"Away","Hawthorn","Richmond",66
14427,2014-04-27,"R6","Port Adelaide",16,11,107,"Geelong",9,13,67,"Adelaide Oval",40,2014,"Regular",6,"Home","Port Adelaide","Geelong",40
14428,2014-05-02,"R7","Carlton",10,10,70,"Collingwood",14,20,104,"M.C.G.",-34,2014,"Regular",7,"Away","Collingwood","Carlton",34
14429,2014-05-03,"R7","Hawthorn",27,13,175,"St Kilda",4,6,30,"M.C.G.",145,2014,"Regular",7,"Home","Hawthorn","St Kilda",145
14430,2014-05-03,"R7","GWS",15,7,97,"Port Adelaide",20,12,132,"Manuka Oval",-35,2014,"Regular",7,"Away","Port Adelaide","GWS",35
14431,2014-05-03,"R7","Adelaide",9,13,67,"Melbourne",11,4,70,"Adelaide Oval",-3,2014,"Regular",7,"Away","Melbourne","Adelaide",3
14432,2014-05-03,"R7","Essendon",10,13,73,"Footscray",9,11,65,"Docklands",8,2014,"Regular",7,"Home","Essendon","Footscray",8
14433,2014-05-03,"R7","Brisbane Lions",6,8,44,"Sydney",18,15,123,"Gabba",-79,2014,"Regular",7,"Away","Sydney","Brisbane Lions",79
14434,2014-05-04,"R7","North Melbourne",11,11,77,"Gold Coast",18,12,120,"Docklands",-43,2014,"Regular",7,"Away","Gold Coast","North Melbourne",43
14435,2014-05-04,"R7","Geelong",11,15,81,"Richmond",12,4,76,"M.C.G.",5,2014,"Regular",7,"Home","Geelong","Richmond",5
14436,2014-05-04,"R7","West Coast",7,12,54,"Fremantle",11,7,73,"Subiaco",-19,2014,"Regular",7,"Away","Fremantle","West Coast",19
14437,2014-05-09,"R8","Sydney",15,17,107,"Hawthorn",13,10,88,"Stadium Australia",19,2014,"Regular",8,"Home","Sydney","Hawthorn",19
14438,2014-05-10,"R8","Port Adelaide",13,16,94,"Fremantle",11,10,76,"Adelaide Oval",18,2014,"Regular",8,"Home","Port Adelaide","Fremantle",18
14439,2014-05-10,"R8","Brisbane Lions",8,9,57,"Essendon",9,11,65,"Gabba",-8,2014,"Regular",8,"Away","Essendon","Brisbane Lions",8
14440,2014-05-10,"R8","Melbourne",12,11,83,"Footscray",15,9,99,"M.C.G.",-16,2014,"Regular",8,"Away","Footscray","Melbourne",16
14441,2014-05-11,"R8","West Coast",30,8,188,"GWS",12,5,77,"Subiaco",111,2014,"Regular",8,"Home","West Coast","GWS",111
14442,2014-05-12,"R8","St Kilda",9,15,69,"Carlton",15,11,101,"Docklands",-32,2014,"Regular",8,"Away","Carlton","St Kilda",32
14443,2014-05-15,"R9","Adelaide",10,16,76,"Collingwood",7,13,55,"Adelaide Oval",21,2014,"Regular",9,"Home","Adelaide","Collingwood",21
14444,2014-05-16,"R9","Essendon",9,10,64,"Sydney",18,6,114,"Docklands",-50,2014,"Regular",9,"Away","Sydney","Essendon",50
14445,2014-05-17,"R9","Richmond",9,20,74,"Melbourne",14,7,91,"M.C.G.",-17,2014,"Regular",9,"Away","Melbourne","Richmond",17
14446,2014-05-17,"R9","North Melbourne",17,23,125,"Brisbane Lions",6,2,38,"Docklands",87,2014,"Regular",9,"Home","North Melbourne","Brisbane Lions",87
14447,2014-05-17,"R9","Fremantle",13,18,96,"Geelong",9,10,64,"Subiaco",32,2014,"Regular",9,"Home","Fremantle","Geelong",32
14448,2014-05-18,"R9","St Kilda",13,9,87,"Gold Coast",19,11,125,"Docklands",-38,2014,"Regular",9,"Away","Gold Coast","St Kilda",38
14449,2014-05-23,"R10","Geelong",16,15,111,"North Melbourne",13,13,91,"Kardinia Park",20,2014,"Regular",10,"Home","Geelong","North Melbourne",20
14450,2014-05-24,"R10","GWS",5,11,41,"Richmond",24,10,154,"Sydney Showground",-113,2014,"Regular",10,"Away","Richmond","GWS",113
14451,2014-05-24,"R10","Collingwood",17,7,109,"West Coast",15,11,101,"M.C.G.",8,2014,"Regular",10,"Home","Collingwood","West Coast",8
14452,2014-05-24,"R10","Port Adelaide",15,10,100,"Hawthorn",13,8,86,"Adelaide Oval",14,2014,"Regular",10,"Home","Port Adelaide","Hawthorn",14
14453,2014-05-25,"R10","Gold Coast",18,11,119,"Footscray",10,14,74,"Carrara",45,2014,"Regular",10,"Home","Gold Coast","Footscray",45
14454,2014-05-25,"R10","Carlton",12,9,81,"Adelaide",10,16,76,"M.C.G.",5,2014,"Regular",10,"Home","Carlton","Adelaide",5
14455,2014-05-29,"R11","Sydney",22,16,148,"Geelong",5,8,38,"S.C.G.",110,2014,"Regular",11,"Home","Sydney","Geelong",110
14456,2014-05-30,"R11","St Kilda",8,6,54,"Collingwood",21,14,140,"Docklands",-86,2014,"Regular",11,"Away","Collingwood","St Kilda",86
14457,2014-05-31,"R11","Melbourne",11,9,75,"Port Adelaide",14,11,95,"Traeger Park",-20,2014,"Regular",11,"Away","Port Adelaide","Melbourne",20
14458,2014-05-31,"R11","Brisbane Lions",14,14,98,"Carlton",13,13,91,"Gabba",7,2014,"Regular",11,"Home","Brisbane Lions","Carlton",7
14459,2014-05-31,"R11","Essendon",15,14,104,"Richmond",7,12,54,"M.C.G.",50,2014,"Regular",11,"Home","Essendon","Richmond",50
14460,2014-06-01,"R11","Adelaide",16,13,109,"Gold Coast",11,11,77,"Adelaide Oval",32,2014,"Regular",11,"Home","Adelaide","Gold Coast",32
14461,2014-06-01,"R11","Footscray",6,15,51,"Fremantle",13,11,89,"Docklands",-38,2014,"Regular",11,"Away","Fremantle","Footscray",38
14462,2014-06-01,"R11","Hawthorn",14,10,94,"GWS",13,9,87,"M.C.G.",7,2014,"Regular",11,"Home","Hawthorn","GWS",7
14463,2014-06-01,"R11","West Coast",6,8,44,"North Melbourne",12,10,82,"Subiaco",-38,2014,"Regular",11,"Away","North Melbourne","West Coast",38
14464,2014-06-06,"R12","Geelong",16,11,107,"Carlton",15,12,102,"Docklands",5,2014,"Regular",12,"Home","Geelong","Carlton",5
14465,2014-06-07,"R12","Hawthorn",19,9,123,"West Coast",12,7,79,"York Park",44,2014,"Regular",12,"Home","Hawthorn","West Coast",44
14466,2014-06-07,"R12","Port Adelaide",19,15,129,"St Kilda",9,5,59,"Adelaide Oval",70,2014,"Regular",12,"Home","Port Adelaide","St Kilda",70
14467,2014-06-07,"R12","GWS",9,12,66,"Essendon",11,15,81,"Sydney Showground",-15,2014,"Regular",12,"Away","Essendon","GWS",15
14468,2014-06-07,"R12","Footscray",13,9,87,"Brisbane Lions",14,11,95,"Docklands",-8,2014,"Regular",12,"Away","Brisbane Lions","Footscray",8
14469,2014-06-08,"R12","Gold Coast",10,14,74,"Sydney",17,7,109,"Carrara",-35,2014,"Regular",12,"Away","Sydney","Gold Coast",35
14470,2014-06-08,"R12","Fremantle",12,18,90,"Adelaide",7,8,50,"Subiaco",40,2014,"Regular",12,"Home","Fremantle","Adelaide",40
14471,2014-06-08,"R12","North Melbourne",17,14,116,"Richmond",13,10,88,"Docklands",28,2014,"Regular",12,"Home","North Melbourne","Richmond",28
14472,2014-06-09,"R12","Melbourne",3,10,28,"Collingwood",8,13,61,"M.C.G.",-33,2014,"Regular",12,"Away","Collingwood","Melbourne",33
14473,2014-06-13,"R13","Carlton",13,12,90,"Hawthorn",18,10,118,"M.C.G.",-28,2014,"Regular",13,"Away","Hawthorn","Carlton",28
14474,2014-06-14,"R13","Richmond",12,13,85,"Fremantle",16,9,105,"M.C.G.",-20,2014,"Regular",13,"Away","Fremantle","Richmond",20
14475,2014-06-14,"R13","Sydney",14,14,98,"Port Adelaide",13,16,94,"S.C.G.",4,2014,"Regular",13,"Home","Sydney","Port Adelaide",4
14476,2014-06-14,"R13","West Coast",15,13,103,"Gold Coast",15,10,100,"Subiaco",3,2014,"Regular",13,"Home","West Coast","Gold Coast",3
14477,2014-06-14,"R13","Adelaide",16,13,109,"North Melbourne",10,13,73,"Adelaide Oval",36,2014,"Regular",13,"Home","Adelaide","North Melbourne",36
14478,2014-06-14,"R13","Brisbane Lions",12,8,80,"GWS",19,11,125,"Gabba",-45,2014,"Regular",13,"Away","GWS","Brisbane Lions",45
14479,2014-06-15,"R13","Geelong",20,13,133,"St Kilda",5,7,37,"Kardinia Park",96,2014,"Regular",13,"Home","Geelong","St Kilda",96
14480,2014-06-15,"R13","Collingwood",15,8,98,"Footscray",16,10,106,"Docklands",-8,2014,"Regular",13,"Away","Footscray","Collingwood",8
14481,2014-06-15,"R13","Essendon",10,17,77,"Melbourne",12,6,78,"M.C.G.",-1,2014,"Regular",13,"Away","Melbourne","Essendon",1
14482,2014-06-20,"R14","Richmond",7,9,51,"Sydney",9,8,62,"M.C.G.",-11,2014,"Regular",14,"Away","Sydney","Richmond",11
14483,2014-06-21,"R14","Port Adelaide",19,14,128,"Footscray",8,8,56,"Adelaide Oval",72,2014,"Regular",14,"Home","Port Adelaide","Footscray",72
14484,2014-06-21,"R14","Hawthorn",17,13,115,"Collingwood",13,8,86,"M.C.G.",29,2014,"Regular",14,"Home","Hawthorn","Collingwood",29
14485,2014-06-21,"R14","Gold Coast",17,16,118,"Geelong",11,12,78,"Carrara",40,2014,"Regular",14,"Home","Gold Coast","Geelong",40
14486,2014-06-21,"R14","Essendon",15,11,101,"Adelaide",14,8,92,"Docklands",9,2014,"Regular",14,"Home","Essendon","Adelaide",9
14487,2014-06-21,"R14","Fremantle",15,15,105,"Brisbane Lions",3,4,22,"Subiaco",83,2014,"Regular",14,"Home","Fremantle","Brisbane Lions",83
14488,2014-06-22,"R14","GWS",15,10,100,"Carlton",14,8,92,"Sydney Showground",8,2014,"Regular",14,"Home","GWS","Carlton",8
14489,2014-06-22,"R14","St Kilda",10,10,70,"West Coast",15,13,103,"Docklands",-33,2014,"Regular",14,"Away","West Coast","St Kilda",33
14490,2014-06-22,"R14","Melbourne",10,6,66,"North Melbourne",15,17,107,"M.C.G.",-41,2014,"Regular",14,"Away","North Melbourne","Melbourne",41
14491,2014-06-27,"R15","Geelong",13,11,89,"Essendon",11,14,80,"Docklands",9,2014,"Regular",15,"Home","Geelong","Essendon",9
14492,2014-06-28,"R15","Hawthorn",17,14,116,"Gold Coast",10,3,63,"York Park",53,2014,"Regular",15,"Home","Hawthorn","Gold Coast",53
14493,2014-06-28,"R15","St Kilda",11,7,73,"Richmond",18,9,117,"Docklands",-44,2014,"Regular",15,"Away","Richmond","St Kilda",44
14494,2014-06-28,"R15","Fremantle",13,10,88,"West Coast",11,15,81,"Subiaco",7,2014,"Regular",15,"Home","Fremantle","West Coast",7
14495,2014-06-28,"R15","Brisbane Lions",10,10,70,"North Melbourne",9,12,66,"Gabba",4,2014,"Regular",15,"Home","Brisbane Lions","North Melbourne",4
14496,2014-06-28,"R15","Sydney",15,16,106,"GWS",8,12,60,"S.C.G.",46,2014,"Regular",15,"Home","Sydney","GWS",46
14497,2014-06-29,"R15","Footscray",14,7,91,"Melbourne",13,7,85,"Docklands",6,2014,"Regular",15,"Home","Footscray","Melbourne",6
14498,2014-06-29,"R15","Adelaide",14,15,99,"Port Adelaide",10,16,76,"Adelaide Oval",23,2014,"Regular",15,"Home","Adelaide","Port Adelaide",23
14499,2014-06-29,"R15","Collingwood",13,13,91,"Carlton",11,10,76,"M.C.G.",15,2014,"Regular",15,"Home","Collingwood","Carlton",15
14500,2014-07-04,"R16","North Melbourne",16,12,108,"Hawthorn",13,10,88,"Docklands",20,2014,"Regular",16,"Home","North Melbourne","Hawthorn",20
14501,2014-07-05,"R16","Richmond",12,7,79,"Brisbane Lions",7,12,54,"M.C.G.",25,2014,"Regular",16,"Home","Richmond","Brisbane Lions",25
14502,2014-07-05,"R16","GWS",9,18,72,"Adelaide",20,20,140,"Sydney Showground",-68,2014,"Regular",16,"Away","Adelaide","GWS",68
14503,2014-07-05,"R16","Gold Coast",11,14,80,"Collingwood",10,15,75,"Carrara",5,2014,"Regular",16,"Home","Gold Coast","Collingwood",5
14504,2014-07-05,"R16","Port Adelaide",7,18,60,"Essendon",8,14,62,"Adelaide Oval",-2,2014,"Regular",16,"Away","Essendon","Port Adelaide",2
14505,2014-07-05,"R16","Melbourne",4,10,34,"Fremantle",15,7,97,"Marrara Oval",-63,2014,"Regular",16,"Away","Fremantle","Melbourne",63
14506,2014-07-06,"R16","Carlton",24,7,151,"St Kilda",10,6,66,"Docklands",85,2014,"Regular",16,"Home","Carlton","St Kilda",85
14507,2014-07-06,"R16","West Coast",7,9,51,"Sydney",10,19,79,"Subiaco",-28,2014,"Regular",16,"Away","Sydney","West Coast",28
14508,2014-07-06,"R16","Geelong",10,9,69,"Footscray",7,14,56,"Kardinia Park",13,2014,"Regular",16,"Home","Geelong","Footscray",13
14509,2014-07-11,"R17","Adelaide",14,8,92,"Hawthorn",15,14,104,"Adelaide Oval",-12,2014,"Regular",17,"Away","Hawthorn","Adelaide",12
14510,2014-07-12,"R17","Melbourne",5,6,36,"Geelong",14,18,102,"M.C.G.",-66,2014,"Regular",17,"Away","Geelong","Melbourne",66
14511,2014-07-12,"R17","North Melbourne",13,14,92,"St Kilda",3,15,33,"Bellerive Oval",59,2014,"Regular",17,"Home","North Melbourne","St Kilda",59
14512,2014-07-12,"R17","Footscray",13,16,94,"Gold Coast",9,12,66,"Cazaly's Stadium",28,2014,"Regular",17,"Home","Footscray","Gold Coast",28
14513,2014-07-12,"R17","Sydney",18,14,122,"Carlton",7,9,51,"S.C.G.",71,2014,"Regular",17,"Home","Sydney","Carlton",71
14514,2014-07-12,"R17","Brisbane Lions",9,10,64,"West Coast",11,10,76,"Gabba",-12,2014,"Regular",17,"Away","West Coast","Brisbane Lions",12
14515,2014-07-13,"R17","Richmond",19,12,126,"Port Adelaide",16,10,106,"Docklands",20,2014,"Regular",17,"Home","Richmond","Port Adelaide",20
14516,2014-07-13,"R17","Essendon",16,7,103,"Collingwood",5,9,39,"M.C.G.",64,2014,"Regular",17,"Home","Essendon","Collingwood",64
14517,2014-07-13,"R17","Fremantle",21,10,136,"GWS",9,6,60,"Subiaco",76,2014,"Regular",17,"Home","Fremantle","GWS",76
14518,2014-07-18,"R18","Carlton",16,13,109,"North Melbourne",13,8,86,"Docklands",23,2014,"Regular",18,"Home","Carlton","North Melbourne",23
14519,2014-07-19,"R18","St Kilda",17,16,118,"Fremantle",9,6,60,"Docklands",58,2014,"Regular",18,"Home","St Kilda","Fremantle",58
14520,2014-07-19,"R18","GWS",12,15,87,"Geelong",13,16,94,"Sydney Showground",-7,2014,"Regular",18,"Away","Geelong","GWS",7
14521,2014-07-20,"R18","Port Adelaide",10,12,72,"Melbourne",10,9,69,"Adelaide Oval",3,2014,"Regular",18,"Home","Port Adelaide","Melbourne",3
14522,2014-07-20,"R18","Footscray",14,10,94,"Essendon",15,11,101,"Docklands",-7,2014,"Regular",18,"Away","Essendon","Footscray",7
14523,2014-07-25,"R18","West Coast",6,6,42,"Richmond",8,11,59,"Subiaco",-17,2014,"Regular",18,"Away","Richmond","West Coast",17
14524,2014-07-26,"R18","Brisbane Lions",16,14,110,"Gold Coast",8,8,56,"Gabba",54,2014,"Regular",18,"Home","Brisbane Lions","Gold Coast",54
14525,2014-07-26,"R18","Hawthorn",15,14,104,"Sydney",13,16,94,"M.C.G.",10,2014,"Regular",18,"Home","Hawthorn","Sydney",10
14526,2014-07-27,"R18","Collingwood",12,10,82,"Adelaide",14,14,98,"M.C.G.",-16,2014,"Regular",18,"Away","Adelaide","Collingwood",16
14527,2014-07-31,"R19","Fremantle",12,11,83,"Carlton",11,12,78,"Subiaco",5,2014,"Regular",19,"Home","Fremantle","Carlton",5
14528,2014-08-01,"R19","Sydney",11,13,79,"Essendon",8,9,57,"S.C.G.",22,2014,"Regular",19,"Home","Sydney","Essendon",22
14529,2014-08-02,"R19","Adelaide",16,9,105,"West Coast",20,16,136,"Adelaide Oval",-31,2014,"Regular",19,"Away","West Coast","Adelaide",31
14530,2014-08-02,"R19","Richmond",13,11,89,"GWS",8,14,62,"M.C.G.",27,2014,"Regular",19,"Home","Richmond","GWS",27
14531,2014-08-02,"R19","North Melbourne",10,19,79,"Geelong",16,15,111,"Docklands",-32,2014,"Regular",19,"Away","Geelong","North Melbourne",32
14532,2014-08-02,"R19","Gold Coast",17,15,117,"St Kilda",9,10,64,"Carrara",53,2014,"Regular",19,"Home","Gold Coast","St Kilda",53
14533,2014-08-03,"R19","Melbourne",6,15,51,"Brisbane Lions",11,8,74,"Docklands",-23,2014,"Regular",19,"Away","Brisbane Lions","Melbourne",23
14534,2014-08-03,"R19","Hawthorn",16,11,107,"Footscray",6,9,45,"York Park",62,2014,"Regular",19,"Home","Hawthorn","Footscray",62
14535,2014-08-03,"R19","Collingwood",11,10,76,"Port Adelaide",10,10,70,"M.C.G.",6,2014,"Regular",19,"Home","Collingwood","Port Adelaide",6
14536,2014-08-08,"R20","Richmond",14,11,95,"Essendon",11,11,77,"M.C.G.",18,2014,"Regular",20,"Home","Richmond","Essendon",18
14537,2014-08-09,"R20","GWS",7,9,51,"North Melbourne",19,12,126,"Manuka Oval",-75,2014,"Regular",20,"Away","North Melbourne","GWS",75
14538,2014-08-09,"R20","Carlton",14,13,97,"Gold Coast",8,10,58,"Docklands",39,2014,"Regular",20,"Home","Carlton","Gold Coast",39
14539,2014-08-09,"R20","Hawthorn",17,13,115,"Melbourne",9,11,65,"M.C.G.",50,2014,"Regular",20,"Home","Hawthorn","Melbourne",50
14540,2014-08-09,"R20","Geelong",12,9,81,"Fremantle",11,13,79,"Kardinia Park",2,2014,"Regular",20,"Home","Geelong","Fremantle",2
14541,2014-08-09,"R20","Port Adelaide",7,16,58,"Sydney",12,12,84,"Adelaide Oval",-26,2014,"Regular",20,"Away","Sydney","Port Adelaide",26
14542,2014-08-10,"R20","Brisbane Lions",9,9,63,"Adelaide",25,18,168,"Gabba",-105,2014,"Regular",20,"Away","Adelaide","Brisbane Lions",105
14543,2014-08-10,"R20","St Kilda",15,9,99,"Footscray",18,14,122,"Docklands",-23,2014,"Regular",20,"Away","Footscray","St Kilda",23
14544,2014-08-10,"R20","West Coast",19,12,126,"Collingwood",10,6,66,"Subiaco",60,2014,"Regular",20,"Home","West Coast","Collingwood",60
14545,2014-08-15,"R21","Carlton",11,10,76,"Geelong",11,16,82,"Docklands",-6,2014,"Regular",21,"Away","Geelong","Carlton",6
14546,2014-08-16,"R21","Sydney",19,13,127,"St Kilda",8,8,56,"S.C.G.",71,2014,"Regular",21,"Home","Sydney","St Kilda",71
14547,2014-08-16,"R21","Gold Coast",7,5,47,"Port Adelaide",7,14,56,"Carrara",-9,2014,"Regular",21,"Away","Port Adelaide","Gold Coast",9
14548,2014-08-16,"R21","Essendon",11,11,77,"West Coast",11,8,74,"Docklands",3,2014,"Regular",21,"Home","Essendon","West Coast",3
14549,2014-08-16,"R21","Adelaide",9,15,69,"Richmond",10,19,79,"Adelaide Oval",-10,2014,"Regular",21,"Away","Richmond","Adelaide",10
14550,2014-08-16,"R21","Collingwood",8,8,56,"Brisbane Lions",18,15,123,"M.C.G.",-67,2014,"Regular",21,"Away","Brisbane Lions","Collingwood",67
14551,2014-08-17,"R21","North Melbourne",17,9,111,"Footscray",8,13,61,"Docklands",50,2014,"Regular",21,"Home","North Melbourne","Footscray",50
14552,2014-08-17,"R21","Melbourne",3,16,34,"GWS",15,8,98,"M.C.G.",-64,2014,"Regular",21,"Away","GWS","Melbourne",64
14553,2014-08-17,"R21","Fremantle",17,8,110,"Hawthorn",13,13,91,"Subiaco",19,2014,"Regular",21,"Home","Fremantle","Hawthorn",19
14554,2014-08-22,"R22","Port Adelaide",20,20,140,"Carlton",5,7,37,"Adelaide Oval",103,2014,"Regular",22,"Home","Port Adelaide","Carlton",103
14555,2014-08-23,"R22","North Melbourne",14,17,101,"Adelaide",13,16,94,"Bellerive Oval",7,2014,"Regular",22,"Home","North Melbourne","Adelaide",7
14556,2014-08-23,"R22","Essendon",16,12,108,"Gold Coast",13,11,89,"Docklands",19,2014,"Regular",22,"Home","Essendon","Gold Coast",19
14557,2014-08-23,"R22","GWS",9,13,67,"Collingwood",11,9,75,"Sydney Showground",-8,2014,"Regular",22,"Away","Collingwood","GWS",8
14558,2014-08-23,"R22","Hawthorn",14,10,94,"Geelong",11,5,71,"M.C.G.",23,2014,"Regular",22,"Home","Hawthorn","Geelong",23
14559,2014-08-23,"R22","West Coast",18,11,119,"Melbourne",8,5,53,"Subiaco",66,2014,"Regular",22,"Home","West Coast","Melbourne",66
14560,2014-08-24,"R22","Brisbane Lions",6,12,48,"Fremantle",15,16,106,"Gabba",-58,2014,"Regular",22,"Away","Fremantle","Brisbane Lions",58
14561,2014-08-24,"R22","Footscray",9,13,67,"Sydney",20,10,130,"Docklands",-63,2014,"Regular",22,"Away","Sydney","Footscray",63
14562,2014-08-24,"R22","Richmond",15,8,98,"St Kilda",10,12,72,"M.C.G.",26,2014,"Regular",22,"Home","Richmond","St Kilda",26
14563,2014-08-29,"R23","Collingwood",8,8,56,"Hawthorn",18,13,121,"M.C.G.",-65,2014,"Regular",23,"Away","Hawthorn","Collingwood",65
14564,2014-08-30,"R23","Carlton",14,6,90,"Essendon",13,12,90,"M.C.G.",0,2014,"Regular",23,"Home","Carlton","Essendon",0
14565,2014-08-30,"R23","Fremantle",16,9,105,"Port Adelaide",14,13,97,"Subiaco",8,2014,"Regular",23,"Home","Fremantle","Port Adelaide",8
14566,2014-08-30,"R23","Sydney",9,11,65,"Richmond",10,8,68,"Stadium Australia",-3,2014,"Regular",23,"Away","Richmond","Sydney",3
14567,2014-08-30,"R23","Geelong",21,17,143,"Brisbane Lions",12,9,81,"Kardinia Park",62,2014,"Regular",23,"Home","Geelong","Brisbane Lions",62
14568,2014-08-30,"R23","North Melbourne",19,9,123,"Melbourne",14,9,93,"Docklands",30,2014,"Regular",23,"Home","North Melbourne","Melbourne",30
14569,2014-08-31,"R23","Gold Coast",15,9,99,"West Coast",23,13,151,"Carrara",-52,2014,"Regular",23,"Away","West Coast","Gold Coast",52
14570,2014-08-31,"R23","Adelaide",22,9,141,"St Kilda",9,8,62,"Adelaide Oval",79,2014,"Regular",23,"Home","Adelaide","St Kilda",79
14571,2014-08-31,"R23","Footscray",15,19,109,"GWS",18,7,115,"Docklands",-6,2014,"Regular",23,"Away","GWS","Footscray",6
14572,2014-09-05,"QF","Hawthorn",15,14,104,"Geelong",10,8,68,"M.C.G.",36,2014,"Finals",24,"Home","Hawthorn","Geelong",36
14573,2014-09-06,"QF","Sydney",13,15,93,"Fremantle",10,9,69,"Stadium Australia",24,2014,"Finals",24,"Home","Sydney","Fremantle",24
14574,2014-09-06,"EF","North Melbourne",14,9,93,"Essendon",12,9,81,"M.C.G.",12,2014,"Finals",24,"Home","North Melbourne","Essendon",12
14575,2014-09-07,"EF","Port Adelaide",20,12,132,"Richmond",11,9,75,"Adelaide Oval",57,2014,"Finals",24,"Home","Port Adelaide","Richmond",57
14576,2014-09-12,"SF","Geelong",13,14,92,"North Melbourne",14,14,98,"M.C.G.",-6,2014,"Finals",25,"Away","North Melbourne","Geelong",6
14577,2014-09-13,"SF","Fremantle",11,17,83,"Port Adelaide",15,15,105,"Subiaco",-22,2014,"Finals",25,"Away","Port Adelaide","Fremantle",22
14578,2014-09-19,"PF","Sydney",19,22,136,"North Melbourne",9,11,65,"Stadium Australia",71,2014,"Finals",26,"Home","Sydney","North Melbourne",71
14579,2014-09-20,"PF","Hawthorn",15,7,97,"Port Adelaide",13,16,94,"M.C.G.",3,2014,"Finals",26,"Home","Hawthorn","Port Adelaide",3
14580,2014-09-27,"GF","Sydney",11,8,74,"Hawthorn",21,11,137,"M.C.G.",-63,2014,"Finals",27,"Away","Hawthorn","Sydney",63
14581,2015-04-02,"R1","Carlton",11,12,78,"Richmond",15,15,105,"M.C.G.",-27,2015,"Regular",1,"Away","Richmond","Carlton",27
14582,2015-04-04,"R1","Melbourne",17,13,115,"Gold Coast",13,11,89,"M.C.G.",26,2015,"Regular",1,"Home","Melbourne","Gold Coast",26
14583,2015-04-04,"R1","Sydney",10,12,72,"Essendon",9,6,60,"Stadium Australia",12,2015,"Regular",1,"Home","Sydney","Essendon",12
14584,2015-04-04,"R1","Brisbane Lions",11,8,74,"Collingwood",12,14,86,"Gabba",-12,2015,"Regular",1,"Away","Collingwood","Brisbane Lions",12
14585,2015-04-04,"R1","Footscray",14,13,97,"West Coast",14,3,87,"Docklands",10,2015,"Regular",1,"Home","Footscray","West Coast",10
14586,2015-04-05,"R1","St Kilda",11,12,78,"GWS",12,15,87,"Docklands",-9,2015,"Regular",1,"Away","GWS","St Kilda",9
14587,2015-04-05,"R1","Adelaide",21,14,140,"North Melbourne",9,9,63,"Adelaide Oval",77,2015,"Regular",1,"Home","Adelaide","North Melbourne",77
14588,2015-04-05,"R1","Fremantle",11,9,75,"Port Adelaide",10,8,68,"Subiaco",7,2015,"Regular",1,"Home","Fremantle","Port Adelaide",7
14589,2015-04-06,"R1","Hawthorn",17,21,123,"Geelong",8,13,61,"M.C.G.",62,2015,"Regular",1,"Home","Hawthorn","Geelong",62
14590,2015-04-10,"R2","West Coast",20,11,131,"Carlton",9,8,62,"Subiaco",69,2015,"Regular",2,"Home","West Coast","Carlton",69
14591,2015-04-11,"R2","Richmond",9,12,66,"Footscray",12,13,85,"M.C.G.",-19,2015,"Regular",2,"Away","Footscray","Richmond",19
14592,2015-04-11,"R2","GWS",15,11,101,"Melbourne",8,8,56,"Manuka Oval",45,2015,"Regular",2,"Home","GWS","Melbourne",45
14593,2015-04-11,"R2","Collingwood",9,9,63,"Adelaide",12,18,90,"Docklands",-27,2015,"Regular",2,"Away","Adelaide","Collingwood",27
14594,2015-04-11,"R2","Gold Coast",10,16,76,"St Kilda",16,8,104,"Carrara",-28,2015,"Regular",2,"Away","St Kilda","Gold Coast",28
14595,2015-04-11,"R2","Port Adelaide",6,8,44,"Sydney",14,8,92,"Adelaide Oval",-48,2015,"Regular",2,"Away","Sydney","Port Adelaide",48
14596,2015-04-12,"R2","Geelong",9,6,60,"Fremantle",15,14,104,"Kardinia Park",-44,2015,"Regular",2,"Away","Fremantle","Geelong",44
14597,2015-04-12,"R2","Essendon",12,6,78,"Hawthorn",11,10,76,"M.C.G.",2,2015,"Regular",2,"Home","Essendon","Hawthorn",2
14598,2015-04-12,"R2","North Melbourne",20,13,133,"Brisbane Lions",7,9,51,"Docklands",82,2015,"Regular",2,"Home","North Melbourne","Brisbane Lions",82
14599,2015-04-17,"R3","Collingwood",21,14,140,"St Kilda",10,6,66,"M.C.G.",74,2015,"Regular",3,"Home","Collingwood","St Kilda",74
14600,2015-04-18,"R3","Carlton",11,18,84,"Essendon",16,9,105,"M.C.G.",-21,2015,"Regular",3,"Away","Essendon","Carlton",21
14601,2015-04-18,"R3","Adelaide",12,8,80,"Melbourne",7,13,55,"Adelaide Oval",25,2015,"Regular",3,"Home","Adelaide","Melbourne",25
14602,2015-04-18,"R3","Sydney",16,15,111,"GWS",12,18,90,"S.C.G.",21,2015,"Regular",3,"Home","Sydney","GWS",21
14603,2015-04-18,"R3","North Melbourne",16,9,105,"Port Adelaide",17,11,113,"Docklands",-8,2015,"Regular",3,"Away","Port Adelaide","North Melbourne",8
14604,2015-04-18,"R3","Brisbane Lions",8,10,58,"Richmond",21,11,137,"Gabba",-79,2015,"Regular",3,"Away","Richmond","Brisbane Lions",79
14605,2015-04-19,"R3","Hawthorn",19,13,127,"Footscray",8,9,57,"York Park",70,2015,"Regular",3,"Home","Hawthorn","Footscray",70
14606,2015-04-19,"R3","Geelong",16,9,105,"Gold Coast",13,18,96,"Kardinia Park",9,2015,"Regular",3,"Home","Geelong","Gold Coast",9
14607,2015-04-19,"R3","West Coast",12,9,81,"Fremantle",17,9,111,"Subiaco",-30,2015,"Regular",3,"Away","Fremantle","West Coast",30
14608,2015-04-24,"R4","Richmond",6,15,51,"Melbourne",12,11,83,"M.C.G.",-32,2015,"Regular",4,"Away","Melbourne","Richmond",32
14609,2015-04-25,"R4","St Kilda",12,9,81,"Carlton",18,13,121,"Wellington",-40,2015,"Regular",4,"Away","Carlton","St Kilda",40
14610,2015-04-25,"R4","Essendon",6,13,49,"Collingwood",9,15,69,"M.C.G.",-20,2015,"Regular",4,"Away","Collingwood","Essendon",20
14611,2015-04-25,"R4","GWS",16,23,119,"Gold Coast",7,11,53,"Manuka Oval",66,2015,"Regular",4,"Home","GWS","Gold Coast",66
14612,2015-04-25,"R4","Port Adelaide",15,9,99,"Hawthorn",13,13,91,"Adelaide Oval",8,2015,"Regular",4,"Home","Port Adelaide","Hawthorn",8
14613,2015-04-25,"R4","Fremantle",11,8,74,"Sydney",8,12,60,"Subiaco",14,2015,"Regular",4,"Home","Fremantle","Sydney",14
14614,2015-04-26,"R4","Brisbane Lions",9,11,65,"West Coast",17,16,118,"Gabba",-53,2015,"Regular",4,"Away","West Coast","Brisbane Lions",53
14615,2015-04-26,"R4","Geelong",9,13,67,"North Melbourne",12,11,83,"Kardinia Park",-16,2015,"Regular",4,"Away","North Melbourne","Geelong",16
14616,2015-04-26,"R4","Footscray",18,17,125,"Adelaide",10,8,68,"Docklands",57,2015,"Regular",4,"Home","Footscray","Adelaide",57
14617,2015-05-01,"R5","Carlton",6,9,45,"Collingwood",18,12,120,"M.C.G.",-75,2015,"Regular",5,"Away","Collingwood","Carlton",75
14618,2015-05-02,"R5","Richmond",11,10,76,"Geelong",12,13,85,"M.C.G.",-9,2015,"Regular",5,"Away","Geelong","Richmond",9
14619,2015-05-02,"R5","Sydney",10,13,73,"Footscray",11,11,77,"S.C.G.",-4,2015,"Regular",5,"Away","Footscray","Sydney",4
14620,2015-05-02,"R5","Gold Coast",18,10,118,"Brisbane Lions",7,12,54,"Carrara",64,2015,"Regular",5,"Home","Gold Coast","Brisbane Lions",64
14621,2015-05-02,"R5","North Melbourne",10,10,70,"Hawthorn",19,16,130,"Docklands",-60,2015,"Regular",5,"Away","Hawthorn","North Melbourne",60
14622,2015-05-02,"R5","West Coast",18,12,120,"GWS",4,9,33,"Subiaco",87,2015,"Regular",5,"Home","West Coast","GWS",87
14623,2015-05-03,"R5","Melbourne",6,14,50,"Fremantle",18,10,118,"M.C.G.",-68,2015,"Regular",5,"Away","Fremantle","Melbourne",68
14624,2015-05-03,"R5","St Kilda",11,14,80,"Essendon",11,16,82,"Docklands",-2,2015,"Regular",5,"Away","Essendon","St Kilda",2
14625,2015-05-03,"R5","Adelaide",13,13,91,"Port Adelaide",18,7,115,"Adelaide Oval",-24,2015,"Regular",5,"Away","Port Adelaide","Adelaide",24
14626,2015-05-08,"R6","Collingwood",8,11,59,"Geelong",15,10,100,"M.C.G.",-41,2015,"Regular",6,"Away","Geelong","Collingwood",41
14627,2015-05-09,"R6","North Melbourne",16,13,109,"Richmond",10,14,74,"Bellerive Oval",35,2015,"Regular",6,"Home","North Melbourne","Richmond",35
14628,2015-05-09,"R6","Footscray",13,9,87,"St Kilda",14,10,94,"Docklands",-7,2015,"Regular",6,"Away","St Kilda","Footscray",7
14629,2015-05-09,"R6","GWS",16,12,108,"Hawthorn",14,14,98,"Sydney Showground",10,2015,"Regular",6,"Home","GWS","Hawthorn",10
14630,2015-05-09,"R6","Gold Coast",11,12,78,"Adelaide",18,11,119,"Carrara",-41,2015,"Regular",6,"Away","Adelaide","Gold Coast",41
14631,2015-05-09,"R6","Melbourne",7,8,50,"Sydney",12,16,88,"M.C.G.",-38,2015,"Regular",6,"Away","Sydney","Melbourne",38
14632,2015-05-09,"R6","Fremantle",12,8,80,"Essendon",7,10,52,"Subiaco",28,2015,"Regular",6,"Home","Fremantle","Essendon",28
14633,2015-05-10,"R6","Carlton",11,9,75,"Brisbane Lions",12,12,84,"Docklands",-9,2015,"Regular",6,"Away","Brisbane Lions","Carlton",9
14634,2015-05-10,"R6","Port Adelaide",10,8,68,"West Coast",11,12,78,"Adelaide Oval",-10,2015,"Regular",6,"Away","West Coast","Port Adelaide",10
14635,2015-05-15,"R7","Essendon",12,10,82,"North Melbourne",13,15,93,"Docklands",-11,2015,"Regular",7,"Away","North Melbourne","Essendon",11
14636,2015-05-16,"R7","Adelaide",18,11,119,"St Kilda",10,13,73,"Adelaide Oval",46,2015,"Regular",7,"Home","Adelaide","St Kilda",46
14637,2015-05-16,"R7","Hawthorn",24,11,155,"Melbourne",7,8,50,"M.C.G.",105,2015,"Regular",7,"Home","Hawthorn","Melbourne",105
14638,2015-05-16,"R7","Carlton",9,3,57,"GWS",19,21,135,"Docklands",-78,2015,"Regular",7,"Away","GWS","Carlton",78
14639,2015-05-16,"R7","Sydney",18,12,120,"Geelong",11,11,77,"Stadium Australia",43,2015,"Regular",7,"Home","Sydney","Geelong",43
14640,2015-05-16,"R7","West Coast",21,9,135,"Gold Coast",6,7,43,"Subiaco",92,2015,"Regular",7,"Home","West Coast","Gold Coast",92
14641,2015-05-17,"R7","Footscray",14,4,88,"Fremantle",15,11,101,"Docklands",-13,2015,"Regular",7,"Away","Fremantle","Footscray",13
14642,2015-05-17,"R7","Richmond",16,9,105,"Collingwood",15,10,100,"M.C.G.",5,2015,"Regular",7,"Home","Richmond","Collingwood",5
14643,2015-05-17,"R7","Brisbane Lions",15,12,102,"Port Adelaide",8,17,65,"Gabba",37,2015,"Regular",7,"Home","Brisbane Lions","Port Adelaide",37
14644,2015-05-22,"R8","Geelong",22,8,140,"Carlton",9,9,63,"Docklands",77,2015,"Regular",8,"Home","Geelong","Carlton",77
14645,2015-05-23,"R8","St Kilda",12,6,78,"West Coast",20,11,131,"Docklands",-53,2015,"Regular",8,"Away","West Coast","St Kilda",53
14646,2015-05-23,"R8","GWS",16,12,108,"Adelaide",12,12,84,"Sydney Showground",24,2015,"Regular",8,"Home","GWS","Adelaide",24
14647,2015-05-23,"R8","Gold Coast",9,9,63,"Collingwood",20,12,132,"Carrara",-69,2015,"Regular",8,"Away","Collingwood","Gold Coast",69
14648,2015-05-23,"R8","Hawthorn",9,15,69,"Sydney",11,7,73,"M.C.G.",-4,2015,"Regular",8,"Away","Sydney","Hawthorn",4
14649,2015-05-23,"R8","Fremantle",17,13,115,"North Melbourne",5,12,42,"Subiaco",73,2015,"Regular",8,"Home","Fremantle","North Melbourne",73
14650,2015-05-24,"R8","Essendon",21,10,136,"Brisbane Lions",12,6,78,"Docklands",58,2015,"Regular",8,"Home","Essendon","Brisbane Lions",58
14651,2015-05-24,"R8","Melbourne",15,13,103,"Footscray",9,10,64,"M.C.G.",39,2015,"Regular",8,"Home","Melbourne","Footscray",39
14652,2015-05-24,"R8","Port Adelaide",5,13,43,"Richmond",11,10,76,"Adelaide Oval",-33,2015,"Regular",8,"Away","Richmond","Port Adelaide",33
14653,2015-05-29,"R9","Sydney",19,8,122,"Carlton",9,8,62,"S.C.G.",60,2015,"Regular",9,"Home","Sydney","Carlton",60
14654,2015-05-30,"R9","Hawthorn",14,9,93,"Gold Coast",6,4,40,"York Park",53,2015,"Regular",9,"Home","Hawthorn","Gold Coast",53
14655,2015-05-30,"R9","Melbourne",8,6,54,"Port Adelaide",18,7,115,"Traeger Park",-61,2015,"Regular",9,"Away","Port Adelaide","Melbourne",61
14656,2015-05-30,"R9","Footscray",16,17,113,"GWS",11,2,68,"Docklands",45,2015,"Regular",9,"Home","Footscray","GWS",45
14657,2015-05-30,"R9","Richmond",10,12,72,"Essendon",8,11,59,"M.C.G.",13,2015,"Regular",9,"Home","Richmond","Essendon",13
14658,2015-05-30,"R9","Adelaide",7,15,57,"Fremantle",10,8,68,"Adelaide Oval",-11,2015,"Regular",9,"Away","Fremantle","Adelaide",11
14659,2015-05-31,"R9","Brisbane Lions",13,8,86,"St Kilda",16,12,108,"Gabba",-22,2015,"Regular",9,"Away","St Kilda","Brisbane Lions",22
14660,2015-05-31,"R9","Collingwood",17,10,112,"North Melbourne",14,11,95,"M.C.G.",17,2015,"Regular",9,"Home","Collingwood","North Melbourne",17
14661,2015-05-31,"R9","West Coast",16,24,120,"Geelong",10,4,64,"Subiaco",56,2015,"Regular",9,"Home","West Coast","Geelong",56
14662,2015-06-05,"R10","Fremantle",10,10,70,"Richmond",15,7,97,"Subiaco",-27,2015,"Regular",10,"Away","Richmond","Fremantle",27
14663,2015-06-06,"R10","Carlton",14,6,90,"Adelaide",14,15,99,"M.C.G.",-9,2015,"Regular",10,"Away","Adelaide","Carlton",9
14664,2015-06-06,"R10","Gold Coast",5,11,41,"Sydney",13,15,93,"Carrara",-52,2015,"Regular",10,"Away","Sydney","Gold Coast",52
14665,2015-06-06,"R10","Essendon",7,11,53,"Geelong",19,8,122,"Docklands",-69,2015,"Regular",10,"Away","Geelong","Essendon",69
14666,2015-06-06,"R10","Port Adelaide",16,4,100,"Footscray",9,8,62,"Adelaide Oval",38,2015,"Regular",10,"Home","Port Adelaide","Footscray",38
14667,2015-06-07,"R10","GWS",14,13,97,"Brisbane Lions",10,7,67,"Sydney Showground",30,2015,"Regular",10,"Home","GWS","Brisbane Lions",30
14668,2015-06-07,"R10","North Melbourne",13,7,85,"West Coast",10,15,75,"Bellerive Oval",10,2015,"Regular",10,"Home","North Melbourne","West Coast",10
14669,2015-06-07,"R10","St Kilda",10,9,69,"Hawthorn",20,12,132,"Docklands",-63,2015,"Regular",10,"Away","Hawthorn","St Kilda",63
14670,2015-06-08,"R10","Melbourne",13,7,85,"Collingwood",17,8,110,"M.C.G.",-25,2015,"Regular",10,"Away","Collingwood","Melbourne",25
14671,2015-06-12,"R11","Port Adelaide",11,3,69,"Geelong",14,8,92,"Adelaide Oval",-23,2015,"Regular",11,"Away","Geelong","Port Adelaide",23
14672,2015-06-13,"R11","Gold Coast",7,4,46,"Fremantle",6,17,53,"Carrara",-7,2015,"Regular",11,"Away","Fremantle","Gold Coast",7
14673,2015-06-13,"R11","West Coast",14,12,96,"Essendon",6,10,46,"Subiaco",50,2015,"Regular",11,"Home","West Coast","Essendon",50
14674,2015-06-13,"R11","North Melbourne",10,15,75,"Sydney",14,7,91,"Docklands",-16,2015,"Regular",11,"Away","Sydney","North Melbourne",16
14675,2015-06-14,"R11","Collingwood",18,11,119,"GWS",11,11,77,"M.C.G.",42,2015,"Regular",11,"Home","Collingwood","GWS",42
14676,2015-06-14,"R11","St Kilda",12,13,85,"Melbourne",12,11,83,"Docklands",2,2015,"Regular",11,"Home","St Kilda","Melbourne",2
14677,2015-06-18,"R12","Adelaide",12,13,85,"Hawthorn",17,12,114,"Adelaide Oval",-29,2015,"Regular",12,"Away","Hawthorn","Adelaide",29
14678,2015-06-19,"R12","Richmond",10,10,70,"West Coast",13,12,90,"M.C.G.",-20,2015,"Regular",12,"Away","West Coast","Richmond",20
14679,2015-06-20,"R12","Carlton",17,8,110,"Port Adelaide",16,10,106,"M.C.G.",4,2015,"Regular",12,"Home","Carlton","Port Adelaide",4
14680,2015-06-20,"R12","GWS",8,13,61,"North Melbourne",18,9,117,"Sydney Showground",-56,2015,"Regular",12,"Away","North Melbourne","GWS",56
14681,2015-06-20,"R12","Footscray",22,14,146,"Brisbane Lions",11,8,74,"Docklands",72,2015,"Regular",12,"Home","Footscray","Brisbane Lions",72
14682,2015-06-21,"R12","Geelong",13,11,89,"Melbourne",18,5,113,"Kardinia Park",-24,2015,"Regular",12,"Away","Melbourne","Geelong",24
14683,2015-06-25,"R13","Fremantle",12,8,80,"Collingwood",11,7,73,"Subiaco",7,2015,"Regular",13,"Home","Fremantle","Collingwood",7
14684,2015-06-26,"R13","Sydney",11,11,77,"Richmond",14,11,95,"S.C.G.",-18,2015,"Regular",13,"Away","Richmond","Sydney",18
14685,2015-06-27,"R13","Hawthorn",16,18,114,"Essendon",11,10,76,"M.C.G.",38,2015,"Regular",13,"Home","Hawthorn","Essendon",38
14686,2015-06-27,"R13","Brisbane Lions",10,9,69,"Adelaide",11,16,82,"Gabba",-13,2015,"Regular",13,"Away","Adelaide","Brisbane Lions",13
14687,2015-06-27,"R13","St Kilda",7,14,56,"Footscray",9,8,62,"Docklands",-6,2015,"Regular",13,"Away","Footscray","St Kilda",6
14688,2015-06-28,"R13","Carlton",14,19,103,"Gold Coast",9,15,69,"Docklands",34,2015,"Regular",13,"Home","Carlton","Gold Coast",34
14689,2015-07-02,"R14","Sydney",14,10,94,"Port Adelaide",12,12,84,"S.C.G.",10,2015,"Regular",14,"Home","Sydney","Port Adelaide",10
14690,2015-07-03,"R14","Collingwood",12,19,91,"Hawthorn",15,11,101,"M.C.G.",-10,2015,"Regular",14,"Away","Hawthorn","Collingwood",10
14691,2015-07-04,"R14","Richmond",10,18,78,"GWS",10,9,69,"M.C.G.",9,2015,"Regular",14,"Home","Richmond","GWS",9
14692,2015-07-04,"R14","Gold Coast",19,11,125,"North Melbourne",10,10,70,"Carrara",55,2015,"Regular",14,"Home","Gold Coast","North Melbourne",55
14693,2015-07-04,"R14","Footscray",9,10,64,"Carlton",7,11,53,"Docklands",11,2015,"Regular",14,"Home","Footscray","Carlton",11
14694,2015-07-04,"R14","Melbourne",9,6,60,"West Coast",16,18,114,"Marrara Oval",-54,2015,"Regular",14,"Away","West Coast","Melbourne",54
14695,2015-07-05,"R14","Essendon",8,4,52,"St Kilda",25,12,162,"Docklands",-110,2015,"Regular",14,"Away","St Kilda","Essendon",110
14696,2015-07-05,"R14","Fremantle",13,6,84,"Brisbane Lions",7,6,48,"Subiaco",36,2015,"Regular",14,"Home","Fremantle","Brisbane Lions",36
14697,2015-07-09,"R15","Port Adelaide",9,12,66,"Collingwood",9,9,63,"Adelaide Oval",3,2015,"Regular",15,"Home","Port Adelaide","Collingwood",3
14698,2015-07-10,"R15","Richmond",10,11,71,"Carlton",5,11,41,"M.C.G.",30,2015,"Regular",15,"Home","Richmond","Carlton",30
14699,2015-07-11,"R15","Essendon",10,9,69,"Melbourne",7,18,60,"M.C.G.",9,2015,"Regular",15,"Home","Essendon","Melbourne",9
14700,2015-07-11,"R15","Footscray",14,11,95,"Gold Coast",11,7,73,"Cazaly's Stadium",22,2015,"Regular",15,"Home","Footscray","Gold Coast",22
14701,2015-07-11,"R15","North Melbourne",18,12,120,"Geelong",11,13,79,"Docklands",41,2015,"Regular",15,"Home","North Melbourne","Geelong",41
14702,2015-07-11,"R15","West Coast",22,15,147,"Adelaide",14,7,91,"Subiaco",56,2015,"Regular",15,"Home","West Coast","Adelaide",56
14703,2015-07-12,"R15","GWS",12,12,84,"St Kilda",6,13,49,"Sydney Showground",35,2015,"Regular",15,"Home","GWS","St Kilda",35
14704,2015-07-12,"R15","Hawthorn",17,13,115,"Fremantle",6,7,43,"York Park",72,2015,"Regular",15,"Home","Hawthorn","Fremantle",72
14705,2015-07-12,"R15","Brisbane Lions",7,7,49,"Sydney",10,10,70,"Gabba",-21,2015,"Regular",15,"Away","Sydney","Brisbane Lions",21
14706,2015-07-17,"R16","North Melbourne",14,9,93,"Essendon",9,14,68,"Docklands",25,2015,"Regular",16,"Home","North Melbourne","Essendon",25
14707,2015-07-18,"R16","Geelong",10,12,72,"Footscray",9,10,64,"Kardinia Park",8,2015,"Regular",16,"Home","Geelong","Footscray",8
14708,2015-07-18,"R16","Gold Coast",12,7,79,"GWS",13,16,94,"Carrara",-15,2015,"Regular",16,"Away","GWS","Gold Coast",15
14709,2015-07-18,"R16","Collingwood",7,14,56,"West Coast",11,21,87,"Docklands",-31,2015,"Regular",16,"Away","West Coast","Collingwood",31
14710,2015-07-18,"R16","Sydney",7,15,57,"Hawthorn",23,8,146,"Stadium Australia",-89,2015,"Regular",16,"Away","Hawthorn","Sydney",89
14711,2015-07-18,"R16","Fremantle",13,17,95,"Carlton",8,5,53,"Subiaco",42,2015,"Regular",16,"Home","Fremantle","Carlton",42
14712,2015-07-19,"R16","Melbourne",8,12,60,"Brisbane Lions",4,12,36,"M.C.G.",24,2015,"Regular",16,"Home","Melbourne","Brisbane Lions",24
14713,2015-07-19,"R16","Port Adelaide",17,11,113,"Adelaide",18,8,116,"Adelaide Oval",-3,2015,"Regular",16,"Away","Adelaide","Port Adelaide",3
14714,2015-07-19,"R16","St Kilda",10,13,73,"Richmond",13,11,89,"Docklands",-16,2015,"Regular",16,"Away","Richmond","St Kilda",16
14715,2015-07-24,"R17","Carlton",4,11,35,"Hawthorn",27,11,173,"Docklands",-138,2015,"Regular",17,"Away","Hawthorn","Carlton",138
14716,2015-07-25,"R17","GWS",6,6,42,"Geelong",9,15,69,"Manuka Oval",-27,2015,"Regular",17,"Away","Geelong","GWS",27
14717,2015-07-25,"R17","Adelaide",19,11,125,"Gold Coast",12,8,80,"Adelaide Oval",45,2015,"Regular",17,"Home","Adelaide","Gold Coast",45
14718,2015-07-25,"R17","Richmond",10,18,78,"Fremantle",12,10,82,"M.C.G.",-4,2015,"Regular",17,"Away","Fremantle","Richmond",4
14719,2015-07-25,"R17","Essendon",17,14,116,"Port Adelaide",20,9,129,"Docklands",-13,2015,"Regular",17,"Away","Port Adelaide","Essendon",13
14720,2015-07-25,"R17","Brisbane Lions",5,8,38,"North Melbourne",16,14,110,"Gabba",-72,2015,"Regular",17,"Away","North Melbourne","Brisbane Lions",72
14721,2015-07-26,"R17","Footscray",15,14,104,"Collingwood",13,8,86,"Docklands",18,2015,"Regular",17,"Home","Footscray","Collingwood",18
14722,2015-07-26,"R17","Melbourne",6,10,46,"St Kilda",12,11,83,"M.C.G.",-37,2015,"Regular",17,"Away","St Kilda","Melbourne",37
14723,2015-07-26,"R17","West Coast",15,13,103,"Sydney",7,9,51,"Subiaco",52,2015,"Regular",17,"Home","West Coast","Sydney",52
14724,2015-07-31,"R18","Hawthorn",7,11,53,"Richmond",10,11,71,"M.C.G.",-18,2015,"Regular",18,"Away","Richmond","Hawthorn",18
14725,2015-08-01,"R18","Geelong",17,11,113,"Brisbane Lions",8,9,57,"Kardinia Park",56,2015,"Regular",18,"Home","Geelong","Brisbane Lions",56
14726,2015-08-01,"R18","Collingwood",7,12,54,"Melbourne",13,13,91,"M.C.G.",-37,2015,"Regular",18,"Away","Melbourne","Collingwood",37
14727,2015-08-01,"R18","Sydney",17,15,117,"Adelaide",9,11,65,"S.C.G.",52,2015,"Regular",18,"Home","Sydney","Adelaide",52
14728,2015-08-01,"R18","Carlton",8,6,54,"North Melbourne",18,10,118,"Docklands",-64,2015,"Regular",18,"Away","North Melbourne","Carlton",64
14729,2015-08-01,"R18","Gold Coast",12,11,83,"West Coast",11,17,83,"Carrara",0,2015,"Regular",18,"Home","Gold Coast","West Coast",0
14730,2015-08-02,"R18","Port Adelaide",17,10,112,"St Kilda",6,13,49,"Adelaide Oval",63,2015,"Regular",18,"Home","Port Adelaide","St Kilda",63
14731,2015-08-02,"R18","Essendon",5,10,40,"Footscray",19,13,127,"Docklands",-87,2015,"Regular",18,"Away","Footscray","Essendon",87
14732,2015-08-02,"R18","Fremantle",12,12,84,"GWS",9,9,63,"Subiaco",21,2015,"Regular",18,"Home","Fremantle","GWS",21
14733,2015-08-07,"R19","Adelaide",11,22,88,"Richmond",8,4,52,"Adelaide Oval",36,2015,"Regular",19,"Home","Adelaide","Richmond",36
14734,2015-08-08,"R19","Collingwood",16,9,105,"Carlton",13,9,87,"M.C.G.",18,2015,"Regular",19,"Home","Collingwood","Carlton",18
14735,2015-08-08,"R19","Footscray",19,14,128,"Port Adelaide",9,10,64,"Docklands",64,2015,"Regular",19,"Home","Footscray","Port Adelaide",64
14736,2015-08-08,"R19","Brisbane Lions",14,16,100,"Gold Coast",17,12,114,"Gabba",-14,2015,"Regular",19,"Away","Gold Coast","Brisbane Lions",14
14737,2015-08-08,"R19","Geelong",14,11,95,"Sydney",9,9,63,"Kardinia Park",32,2015,"Regular",19,"Home","Geelong","Sydney",32
14738,2015-08-08,"R19","West Coast",11,8,74,"Hawthorn",13,10,88,"Subiaco",-14,2015,"Regular",19,"Away","Hawthorn","West Coast",14
14739,2015-08-09,"R19","Melbourne",14,8,92,"North Melbourne",19,13,127,"M.C.G.",-35,2015,"Regular",19,"Away","North Melbourne","Melbourne",35
14740,2015-08-09,"R19","GWS",14,9,93,"Essendon",8,13,61,"Sydney Showground",32,2015,"Regular",19,"Home","GWS","Essendon",32
14741,2015-08-09,"R19","St Kilda",8,11,59,"Fremantle",15,6,96,"Docklands",-37,2015,"Regular",19,"Away","Fremantle","St Kilda",37
14742,2015-08-14,"R20","Sydney",13,9,87,"Collingwood",10,16,76,"S.C.G.",11,2015,"Regular",20,"Home","Sydney","Collingwood",11
14743,2015-08-15,"R20","Essendon",8,11,59,"Adelaide",27,9,171,"Docklands",-112,2015,"Regular",20,"Away","Adelaide","Essendon",112
14744,2015-08-15,"R20","North Melbourne",18,12,120,"St Kilda",11,17,83,"Bellerive Oval",37,2015,"Regular",20,"Home","North Melbourne","St Kilda",37
14745,2015-08-15,"R20","Port Adelaide",16,15,111,"GWS",13,12,90,"Adelaide Oval",21,2015,"Regular",20,"Home","Port Adelaide","GWS",21
14746,2015-08-15,"R20","Brisbane Lions",20,11,131,"Carlton",9,13,67,"Gabba",64,2015,"Regular",20,"Home","Brisbane Lions","Carlton",64
14747,2015-08-15,"R20","Geelong",12,13,85,"Hawthorn",19,7,121,"M.C.G.",-36,2015,"Regular",20,"Away","Hawthorn","Geelong",36
14748,2015-08-16,"R20","Richmond",22,6,138,"Gold Coast",8,7,55,"M.C.G.",83,2015,"Regular",20,"Home","Richmond","Gold Coast",83
14749,2015-08-16,"R20","Footscray",24,9,153,"Melbourne",8,7,55,"Docklands",98,2015,"Regular",20,"Home","Footscray","Melbourne",98
14750,2015-08-16,"R20","Fremantle",11,14,80,"West Coast",15,14,104,"Subiaco",-24,2015,"Regular",20,"Away","West Coast","Fremantle",24
14751,2015-08-21,"R21","Hawthorn",13,8,86,"Port Adelaide",16,12,108,"Docklands",-22,2015,"Regular",21,"Away","Port Adelaide","Hawthorn",22
14752,2015-08-22,"R21","Collingwood",7,14,56,"Richmond",23,9,147,"M.C.G.",-91,2015,"Regular",21,"Away","Richmond","Collingwood",91
14753,2015-08-22,"R21","GWS",6,8,44,"Sydney",20,13,133,"Sydney Showground",-89,2015,"Regular",21,"Away","Sydney","GWS",89
14754,2015-08-22,"R21","Gold Coast",14,13,97,"Essendon",14,11,95,"Carrara",2,2015,"Regular",21,"Home","Gold Coast","Essendon",2
14755,2015-08-22,"R21","St Kilda",14,13,97,"Geelong",15,7,97,"Docklands",0,2015,"Regular",21,"Home","St Kilda","Geelong",0
14756,2015-08-22,"R21","Adelaide",20,11,131,"Brisbane Lions",6,8,44,"Adelaide Oval",87,2015,"Regular",21,"Home","Adelaide","Brisbane Lions",87
14757,2015-08-23,"R21","North Melbourne",14,10,94,"Fremantle",12,11,83,"Docklands",11,2015,"Regular",21,"Home","North Melbourne","Fremantle",11
14758,2015-08-23,"R21","Carlton",12,6,78,"Melbourne",7,13,55,"M.C.G.",23,2015,"Regular",21,"Home","Carlton","Melbourne",23
14759,2015-08-23,"R21","West Coast",25,12,162,"Footscray",13,7,85,"Subiaco",77,2015,"Regular",21,"Home","West Coast","Footscray",77
14760,2015-08-28,"R22","Geelong",9,8,62,"Collingwood",17,8,110,"M.C.G.",-48,2015,"Regular",22,"Away","Collingwood","Geelong",48
14761,2015-08-29,"R22","GWS",20,12,132,"Carlton",7,9,51,"Sydney Showground",81,2015,"Regular",22,"Home","GWS","Carlton",81
14762,2015-08-29,"R22","Hawthorn",21,8,134,"Brisbane Lions",9,8,62,"York Park",72,2015,"Regular",22,"Home","Hawthorn","Brisbane Lions",72
14763,2015-08-29,"R22","North Melbourne",10,13,73,"Footscray",14,12,96,"Docklands",-23,2015,"Regular",22,"Away","Footscray","North Melbourne",23
14764,2015-08-29,"R22","Essendon",7,5,47,"Richmond",10,14,74,"M.C.G.",-27,2015,"Regular",22,"Away","Richmond","Essendon",27
14765,2015-08-29,"R22","Gold Coast",7,9,51,"Port Adelaide",12,16,88,"Carrara",-37,2015,"Regular",22,"Away","Port Adelaide","Gold Coast",37
14766,2015-08-30,"R22","Adelaide",19,12,126,"West Coast",10,9,69,"Adelaide Oval",57,2015,"Regular",22,"Home","Adelaide","West Coast",57
14767,2015-08-30,"R22","St Kilda",4,14,38,"Sydney",20,15,135,"Docklands",-97,2015,"Regular",22,"Away","Sydney","St Kilda",97
14768,2015-08-30,"R22","Fremantle",17,6,108,"Melbourne",8,6,54,"Subiaco",54,2015,"Regular",22,"Home","Fremantle","Melbourne",54
14769,2015-09-04,"R23","Richmond",16,12,108,"North Melbourne",10,7,67,"Docklands",41,2015,"Regular",23,"Home","Richmond","North Melbourne",41
14770,2015-09-05,"R23","Geelong",17,17,119,"Adelaide",11,14,80,"Kardinia Park",39,2015,"Regular",23,"Home","Geelong","Adelaide",39
14771,2015-09-05,"R23","Brisbane Lions",19,16,130,"Footscray",19,8,122,"Gabba",8,2015,"Regular",23,"Home","Brisbane Lions","Footscray",8
14772,2015-09-05,"R23","Port Adelaide",18,14,122,"Fremantle",8,5,53,"Adelaide Oval",69,2015,"Regular",23,"Home","Port Adelaide","Fremantle",69
14773,2015-09-05,"R23","Hawthorn",17,11,113,"Carlton",8,8,56,"M.C.G.",57,2015,"Regular",23,"Home","Hawthorn","Carlton",57
14774,2015-09-05,"R23","Sydney",19,13,127,"Gold Coast",9,10,64,"S.C.G.",63,2015,"Regular",23,"Home","Sydney","Gold Coast",63
14775,2015-09-05,"R23","West Coast",18,17,125,"St Kilda",4,6,30,"Subiaco",95,2015,"Regular",23,"Home","West Coast","St Kilda",95
14776,2015-09-06,"R23","Melbourne",15,13,103,"GWS",11,11,77,"Docklands",26,2015,"Regular",23,"Home","Melbourne","GWS",26
14777,2015-09-06,"R23","Collingwood",14,8,92,"Essendon",14,11,95,"M.C.G.",-3,2015,"Regular",23,"Away","Essendon","Collingwood",3
14778,2015-09-11,"QF","West Coast",14,12,96,"Hawthorn",9,10,64,"Subiaco",32,2015,"Finals",24,"Home","West Coast","Hawthorn",32
14779,2015-09-12,"QF","Fremantle",10,9,69,"Sydney",7,18,60,"Subiaco",9,2015,"Finals",24,"Home","Fremantle","Sydney",9
14780,2015-09-12,"EF","Footscray",14,18,102,"Adelaide",16,13,109,"M.C.G.",-7,2015,"Finals",24,"Away","Adelaide","Footscray",7
14781,2015-09-13,"EF","Richmond",14,4,88,"North Melbourne",15,15,105,"M.C.G.",-17,2015,"Finals",24,"Away","North Melbourne","Richmond",17
14782,2015-09-18,"SF","Hawthorn",21,9,135,"Adelaide",8,13,61,"M.C.G.",74,2015,"Finals",25,"Home","Hawthorn","Adelaide",74
14783,2015-09-19,"SF","Sydney",7,9,51,"North Melbourne",11,11,77,"Stadium Australia",-26,2015,"Finals",25,"Away","North Melbourne","Sydney",26
14784,2015-09-25,"PF","Fremantle",10,7,67,"Hawthorn",15,4,94,"Subiaco",-27,2015,"Finals",26,"Away","Hawthorn","Fremantle",27
14785,2015-09-26,"PF","West Coast",10,20,80,"North Melbourne",7,13,55,"Subiaco",25,2015,"Finals",26,"Home","West Coast","North Melbourne",25
14786,2015-10-03,"GF","West Coast",8,13,61,"Hawthorn",16,11,107,"M.C.G.",-46,2015,"Finals",27,"Away","Hawthorn","West Coast",46
14787,2016-03-24,"R1","Richmond",14,8,92,"Carlton",12,11,83,"M.C.G.",9,2016,"Regular",1,"Home","Richmond","Carlton",9
14788,2016-03-26,"R1","Melbourne",12,8,80,"GWS",10,18,78,"M.C.G.",2,2016,"Regular",1,"Home","Melbourne","GWS",2
14789,2016-03-26,"R1","Gold Coast",17,19,121,"Essendon",9,6,60,"Carrara",61,2016,"Regular",1,"Home","Gold Coast","Essendon",61
14790,2016-03-26,"R1","North Melbourne",16,11,107,"Adelaide",14,13,97,"Docklands",10,2016,"Regular",1,"Home","North Melbourne","Adelaide",10
14791,2016-03-26,"R1","Sydney",18,25,133,"Collingwood",7,11,53,"S.C.G.",80,2016,"Regular",1,"Home","Sydney","Collingwood",80
14792,2016-03-27,"R1","Footscray",15,13,103,"Fremantle",5,8,38,"Docklands",65,2016,"Regular",1,"Home","Footscray","Fremantle",65
14793,2016-03-27,"R1","Port Adelaide",20,13,133,"St Kilda",15,10,100,"Adelaide Oval",33,2016,"Regular",1,"Home","Port Adelaide","St Kilda",33
14794,2016-03-27,"R1","West Coast",26,10,166,"Brisbane Lions",15,12,102,"Subiaco",64,2016,"Regular",1,"Home","West Coast","Brisbane Lions",64
14795,2016-03-28,"R1","Geelong",18,8,116,"Hawthorn",12,14,86,"M.C.G.",30,2016,"Regular",1,"Home","Geelong","Hawthorn",30
14796,2016-04-01,"R2","Collingwood",13,9,87,"Richmond",12,14,86,"M.C.G.",1,2016,"Regular",2,"Home","Collingwood","Richmond",1
14797,2016-04-02,"R2","Adelaide",22,12,144,"Port Adelaide",11,20,86,"Adelaide Oval",58,2016,"Regular",2,"Home","Adelaide","Port Adelaide",58
14798,2016-04-02,"R2","Essendon",11,14,80,"Melbourne",10,7,67,"M.C.G.",13,2016,"Regular",2,"Home","Essendon","Melbourne",13
14799,2016-04-02,"R2","Brisbane Lions",11,17,83,"North Melbourne",17,15,117,"Gabba",-34,2016,"Regular",2,"Away","North Melbourne","Brisbane Lions",34
14800,2016-04-02,"R2","St Kilda",5,6,36,"Footscray",13,15,93,"Docklands",-57,2016,"Regular",2,"Away","Footscray","St Kilda",57
14801,2016-04-02,"R2","Fremantle",14,16,100,"Gold Coast",19,12,126,"Subiaco",-26,2016,"Regular",2,"Away","Gold Coast","Fremantle",26
14802,2016-04-03,"R2","GWS",13,11,89,"Geelong",11,10,76,"Manuka Oval",13,2016,"Regular",2,"Home","GWS","Geelong",13
14803,2016-04-03,"R2","Hawthorn",14,15,99,"West Coast",7,11,53,"M.C.G.",46,2016,"Regular",2,"Home","Hawthorn","West Coast",46
14804,2016-04-03,"R2","Carlton",10,11,71,"Sydney",20,11,131,"Docklands",-60,2016,"Regular",2,"Away","Sydney","Carlton",60
14805,2016-04-08,"R3","Port Adelaide",17,10,112,"Essendon",7,9,51,"Adelaide Oval",61,2016,"Regular",3,"Home","Port Adelaide","Essendon",61
14806,2016-04-09,"R3","St Kilda",18,11,119,"Collingwood",14,6,90,"M.C.G.",29,2016,"Regular",3,"Home","St Kilda","Collingwood",29
14807,2016-04-09,"R3","Richmond",13,14,92,"Adelaide",19,14,128,"Docklands",-36,2016,"Regular",3,"Away","Adelaide","Richmond",36
14808,2016-04-09,"R3","Sydney",14,9,93,"GWS",10,8,68,"S.C.G.",25,2016,"Regular",3,"Home","Sydney","GWS",25
14809,2016-04-09,"R3","Gold Coast",13,17,95,"Carlton",5,11,41,"Carrara",54,2016,"Regular",3,"Home","Gold Coast","Carlton",54
14810,2016-04-09,"R3","West Coast",12,20,92,"Fremantle",8,11,59,"Subiaco",33,2016,"Regular",3,"Home","West Coast","Fremantle",33
14811,2016-04-10,"R3","North Melbourne",21,10,136,"Melbourne",20,11,131,"Bellerive Oval",5,2016,"Regular",3,"Home","North Melbourne","Melbourne",5
14812,2016-04-10,"R3","Footscray",13,12,90,"Hawthorn",14,9,93,"Docklands",-3,2016,"Regular",3,"Away","Hawthorn","Footscray",3
14813,2016-04-10,"R3","Geelong",18,17,125,"Brisbane Lions",7,14,56,"Kardinia Park",69,2016,"Regular",3,"Home","Geelong","Brisbane Lions",69
14814,2016-04-15,"R4","West Coast",18,17,125,"Richmond",9,3,57,"Subiaco",68,2016,"Regular",4,"Home","West Coast","Richmond",68
14815,2016-04-16,"R4","Essendon",6,6,42,"Geelong",9,18,72,"M.C.G.",-30,2016,"Regular",4,"Away","Geelong","Essendon",30
14816,2016-04-16,"R4","Hawthorn",13,9,87,"St Kilda",13,6,84,"York Park",3,2016,"Regular",4,"Home","Hawthorn","St Kilda",3
14817,2016-04-16,"R4","Brisbane Lions",14,23,107,"Gold Coast",14,10,94,"Gabba",13,2016,"Regular",4,"Home","Brisbane Lions","Gold Coast",13
14818,2016-04-16,"R4","Carlton",7,7,49,"Footscray",13,7,85,"Docklands",-36,2016,"Regular",4,"Away","Footscray","Carlton",36
14819,2016-04-16,"R4","Adelaide",16,17,113,"Sydney",15,13,103,"Adelaide Oval",10,2016,"Regular",4,"Home","Adelaide","Sydney",10
14820,2016-04-17,"R4","GWS",22,19,151,"Port Adelaide",9,11,65,"Manuka Oval",86,2016,"Regular",4,"Home","GWS","Port Adelaide",86
14821,2016-04-17,"R4","Collingwood",9,13,67,"Melbourne",16,6,102,"M.C.G.",-35,2016,"Regular",4,"Away","Melbourne","Collingwood",35
14822,2016-04-17,"R4","North Melbourne",20,12,132,"Fremantle",14,17,101,"Docklands",31,2016,"Regular",4,"Home","North Melbourne","Fremantle",31
14823,2016-04-22,"R5","Hawthorn",17,10,112,"Adelaide",17,7,109,"M.C.G.",3,2016,"Regular",5,"Home","Hawthorn","Adelaide",3
14824,2016-04-23,"R5","Sydney",12,16,88,"West Coast",7,7,49,"S.C.G.",39,2016,"Regular",5,"Home","Sydney","West Coast",39
14825,2016-04-23,"R5","Gold Coast",11,15,81,"North Melbourne",18,11,119,"Carrara",-38,2016,"Regular",5,"Away","North Melbourne","Gold Coast",38
14826,2016-04-23,"R5","Footscray",17,18,120,"Brisbane Lions",10,7,67,"Docklands",53,2016,"Regular",5,"Home","Footscray","Brisbane Lions",53
14827,2016-04-23,"R5","Port Adelaide",8,11,59,"Geelong",16,11,107,"Adelaide Oval",-48,2016,"Regular",5,"Away","Geelong","Port Adelaide",48
14828,2016-04-24,"R5","St Kilda",12,7,79,"GWS",19,12,126,"Docklands",-47,2016,"Regular",5,"Away","GWS","St Kilda",47
14829,2016-04-24,"R5","Fremantle",9,14,68,"Carlton",10,12,72,"Subiaco",-4,2016,"Regular",5,"Away","Carlton","Fremantle",4
14830,2016-04-24,"R5","Melbourne",20,9,129,"Richmond",14,12,96,"M.C.G.",33,2016,"Regular",5,"Home","Melbourne","Richmond",33
14831,2016-04-25,"R5","Collingwood",22,10,142,"Essendon",11,7,73,"M.C.G.",69,2016,"Regular",5,"Home","Collingwood","Essendon",69
14832,2016-04-29,"R6","North Melbourne",9,7,61,"Footscray",6,9,45,"Docklands",16,2016,"Regular",6,"Home","North Melbourne","Footscray",16
14833,2016-04-30,"R6","Melbourne",15,6,96,"St Kilda",20,15,135,"Docklands",-39,2016,"Regular",6,"Away","St Kilda","Melbourne",39
14834,2016-04-30,"R6","Adelaide",14,13,97,"Fremantle",8,16,64,"Adelaide Oval",33,2016,"Regular",6,"Home","Adelaide","Fremantle",33
14835,2016-04-30,"R6","GWS",24,14,158,"Hawthorn",12,11,83,"Sydney Showground",75,2016,"Regular",6,"Home","GWS","Hawthorn",75
14836,2016-04-30,"R6","Geelong",25,18,168,"Gold Coast",7,6,48,"Kardinia Park",120,2016,"Regular",6,"Home","Geelong","Gold Coast",120
14837,2016-04-30,"R6","Richmond",8,11,59,"Port Adelaide",13,16,94,"M.C.G.",-35,2016,"Regular",6,"Away","Port Adelaide","Richmond",35
14838,2016-05-01,"R6","Brisbane Lions",14,10,94,"Sydney",15,7,97,"Gabba",-3,2016,"Regular",6,"Away","Sydney","Brisbane Lions",3
14839,2016-05-01,"R6","Carlton",10,12,72,"Essendon",8,9,57,"M.C.G.",15,2016,"Regular",6,"Home","Carlton","Essendon",15
14840,2016-05-01,"R6","West Coast",18,16,124,"Collingwood",9,8,62,"Subiaco",62,2016,"Regular",6,"Home","West Coast","Collingwood",62
14841,2016-05-06,"R7","Richmond",13,12,90,"Hawthorn",21,10,136,"M.C.G.",-46,2016,"Regular",7,"Away","Hawthorn","Richmond",46
14842,2016-05-07,"R7","Collingwood",12,12,84,"Carlton",15,9,99,"M.C.G.",-15,2016,"Regular",7,"Away","Carlton","Collingwood",15
14843,2016-05-07,"R7","Geelong",18,15,123,"West Coast",12,7,79,"Kardinia Park",44,2016,"Regular",7,"Home","Geelong","West Coast",44
14844,2016-05-07,"R7","Sydney",20,15,135,"Essendon",7,12,54,"S.C.G.",81,2016,"Regular",7,"Home","Sydney","Essendon",81
14845,2016-05-07,"R7","Gold Coast",14,3,87,"Melbourne",24,16,160,"Carrara",-73,2016,"Regular",7,"Away","Melbourne","Gold Coast",73
14846,2016-05-07,"R7","Footscray",18,15,123,"Adelaide",17,6,108,"Docklands",15,2016,"Regular",7,"Home","Footscray","Adelaide",15
14847,2016-05-07,"R7","Fremantle",11,11,77,"GWS",14,11,95,"Subiaco",-18,2016,"Regular",7,"Away","GWS","Fremantle",18
14848,2016-05-08,"R7","St Kilda",11,9,75,"North Melbourne",11,16,82,"Docklands",-7,2016,"Regular",7,"Away","North Melbourne","St Kilda",7
14849,2016-05-08,"R7","Port Adelaide",21,10,136,"Brisbane Lions",7,17,59,"Adelaide Oval",77,2016,"Regular",7,"Home","Port Adelaide","Brisbane Lions",77
14850,2016-05-13,"R8","Adelaide",11,6,72,"Geelong",13,20,98,"Adelaide Oval",-26,2016,"Regular",8,"Away","Geelong","Adelaide",26
14851,2016-05-14,"R8","Essendon",8,12,60,"North Melbourne",10,14,74,"Docklands",-14,2016,"Regular",8,"Away","North Melbourne","Essendon",14
14852,2016-05-14,"R8","Hawthorn",17,14,116,"Fremantle",11,9,75,"York Park",41,2016,"Regular",8,"Home","Hawthorn","Fremantle",41
14853,2016-05-14,"R8","GWS",22,17,149,"Gold Coast",9,4,58,"Sydney Showground",91,2016,"Regular",8,"Home","GWS","Gold Coast",91
14854,2016-05-14,"R8","Brisbane Lions",10,5,65,"Collingwood",20,23,143,"Gabba",-78,2016,"Regular",8,"Away","Collingwood","Brisbane Lions",78
14855,2016-05-14,"R8","Richmond",14,17,101,"Sydney",15,10,100,"M.C.G.",1,2016,"Regular",8,"Home","Richmond","Sydney",1
14856,2016-05-15,"R8","Carlton",14,9,93,"Port Adelaide",13,13,91,"Docklands",2,2016,"Regular",8,"Home","Carlton","Port Adelaide",2
14857,2016-05-15,"R8","Melbourne",12,10,82,"Footscray",17,12,114,"M.C.G.",-32,2016,"Regular",8,"Away","Footscray","Melbourne",32
14858,2016-05-15,"R8","West Coast",20,12,132,"St Kilda",3,11,29,"Subiaco",103,2016,"Regular",8,"Home","West Coast","St Kilda",103
14859,2016-05-20,"R9","Hawthorn",7,13,55,"Sydney",10,9,69,"M.C.G.",-14,2016,"Regular",9,"Away","Sydney","Hawthorn",14
14860,2016-05-21,"R9","Collingwood",16,8,104,"Geelong",11,14,80,"M.C.G.",24,2016,"Regular",9,"Home","Collingwood","Geelong",24
14861,2016-05-21,"R9","Gold Coast",11,8,74,"Adelaide",22,17,149,"Carrara",-75,2016,"Regular",9,"Away","Adelaide","Gold Coast",75
14862,2016-05-21,"R9","Port Adelaide",13,8,86,"West Coast",14,10,94,"Adelaide Oval",-8,2016,"Regular",9,"Away","West Coast","Port Adelaide",8
14863,2016-05-21,"R9","North Melbourne",17,11,113,"Carlton",6,10,46,"Docklands",67,2016,"Regular",9,"Home","North Melbourne","Carlton",67
14864,2016-05-21,"R9","Fremantle",6,9,45,"Richmond",11,17,83,"Subiaco",-38,2016,"Regular",9,"Away","Richmond","Fremantle",38
14865,2016-05-22,"R9","Melbourne",19,17,131,"Brisbane Lions",9,14,68,"M.C.G.",63,2016,"Regular",9,"Home","Melbourne","Brisbane Lions",63
14866,2016-05-22,"R9","GWS",15,8,98,"Footscray",10,13,73,"Sydney Showground",25,2016,"Regular",9,"Home","GWS","Footscray",25
14867,2016-05-22,"R9","St Kilda",16,13,109,"Essendon",9,9,63,"Docklands",46,2016,"Regular",9,"Home","St Kilda","Essendon",46
14868,2016-05-27,"R10","Sydney",14,7,91,"North Melbourne",9,11,65,"S.C.G.",26,2016,"Regular",10,"Home","Sydney","North Melbourne",26
14869,2016-05-28,"R10","Brisbane Lions",13,9,87,"Hawthorn",21,9,135,"Gabba",-48,2016,"Regular",10,"Away","Hawthorn","Brisbane Lions",48
14870,2016-05-28,"R10","Melbourne",10,16,76,"Port Adelaide",18,13,121,"Traeger Park",-45,2016,"Regular",10,"Away","Port Adelaide","Melbourne",45
14871,2016-05-28,"R10","St Kilda",15,11,101,"Fremantle",10,7,67,"Docklands",34,2016,"Regular",10,"Home","St Kilda","Fremantle",34
14872,2016-05-28,"R10","Essendon",10,7,67,"Richmond",16,9,105,"M.C.G.",-38,2016,"Regular",10,"Away","Richmond","Essendon",38
14873,2016-05-28,"R10","Adelaide",15,17,107,"GWS",13,7,85,"Adelaide Oval",22,2016,"Regular",10,"Home","Adelaide","GWS",22
14874,2016-05-29,"R10","Carlton",16,8,104,"Geelong",12,13,85,"Docklands",19,2016,"Regular",10,"Home","Carlton","Geelong",19
14875,2016-05-29,"R10","Collingwood",7,11,53,"Footscray",11,8,74,"M.C.G.",-21,2016,"Regular",10,"Away","Footscray","Collingwood",21
14876,2016-05-29,"R10","West Coast",20,12,132,"Gold Coast",7,13,55,"Subiaco",77,2016,"Regular",10,"Home","West Coast","Gold Coast",77
14877,2016-06-03,"R11","North Melbourne",18,16,124,"Richmond",7,12,54,"Bellerive Oval",70,2016,"Regular",11,"Home","North Melbourne","Richmond",70
14878,2016-06-04,"R11","Hawthorn",11,16,82,"Melbourne",10,4,64,"M.C.G.",18,2016,"Regular",11,"Home","Hawthorn","Melbourne",18
14879,2016-06-04,"R11","Carlton",16,6,102,"Brisbane Lions",9,10,64,"Docklands",38,2016,"Regular",11,"Home","Carlton","Brisbane Lions",38
14880,2016-06-04,"R11","Geelong",14,14,98,"GWS",14,4,88,"Kardinia Park",10,2016,"Regular",11,"Home","Geelong","GWS",10
14881,2016-06-04,"R11","Gold Coast",6,5,41,"Sydney",11,13,79,"Carrara",-38,2016,"Regular",11,"Away","Sydney","Gold Coast",38
14882,2016-06-04,"R11","Fremantle",20,6,126,"Essendon",6,11,47,"Subiaco",79,2016,"Regular",11,"Home","Fremantle","Essendon",79
14883,2016-06-05,"R11","Collingwood",7,16,58,"Port Adelaide",19,11,125,"M.C.G.",-67,2016,"Regular",11,"Away","Port Adelaide","Collingwood",67
14884,2016-06-05,"R11","Footscray",12,11,83,"West Coast",11,9,75,"Docklands",8,2016,"Regular",11,"Home","Footscray","West Coast",8
14885,2016-06-05,"R11","Adelaide",19,19,133,"St Kilda",6,9,45,"Adelaide Oval",88,2016,"Regular",11,"Home","Adelaide","St Kilda",88
14886,2016-06-10,"R12","Essendon",6,7,43,"Hawthorn",23,13,151,"Docklands",-108,2016,"Regular",12,"Away","Hawthorn","Essendon",108
14887,2016-06-11,"R12","Port Adelaide",14,13,97,"Footscray",15,10,100,"Adelaide Oval",-3,2016,"Regular",12,"Away","Footscray","Port Adelaide",3
14888,2016-06-11,"R12","Brisbane Lions",9,10,64,"Fremantle",23,9,147,"Gabba",-83,2016,"Regular",12,"Away","Fremantle","Brisbane Lions",83
14889,2016-06-11,"R12","Geelong",15,15,105,"North Melbourne",12,2,74,"Docklands",31,2016,"Regular",12,"Home","Geelong","North Melbourne",31
14890,2016-06-11,"R12","West Coast",11,10,76,"Adelaide",15,15,105,"Subiaco",-29,2016,"Regular",12,"Away","Adelaide","West Coast",29
14891,2016-06-12,"R12","St Kilda",17,8,110,"Carlton",12,6,78,"Docklands",32,2016,"Regular",12,"Home","St Kilda","Carlton",32
14892,2016-06-12,"R12","Richmond",17,12,114,"Gold Coast",15,7,97,"M.C.G.",17,2016,"Regular",12,"Home","Richmond","Gold Coast",17
14893,2016-06-12,"R12","GWS",15,15,105,"Sydney",9,9,63,"Sydney Showground",42,2016,"Regular",12,"Home","GWS","Sydney",42
14894,2016-06-13,"R12","Melbourne",16,8,104,"Collingwood",8,10,58,"M.C.G.",46,2016,"Regular",12,"Home","Melbourne","Collingwood",46
14895,2016-06-17,"R13","North Melbourne",11,18,84,"Hawthorn",14,9,93,"Docklands",-9,2016,"Regular",13,"Away","Hawthorn","North Melbourne",9
14896,2016-06-18,"R13","Brisbane Lions",12,10,82,"West Coast",20,11,131,"Gabba",-49,2016,"Regular",13,"Away","West Coast","Brisbane Lions",49
14897,2016-06-18,"R13","Fremantle",12,14,86,"Port Adelaide",9,15,69,"Subiaco",17,2016,"Regular",13,"Home","Fremantle","Port Adelaide",17
14898,2016-06-18,"R13","Footscray",5,13,43,"Geelong",16,4,100,"Docklands",-57,2016,"Regular",13,"Away","Geelong","Footscray",57
14899,2016-06-19,"R13","Sydney",12,14,86,"Melbourne",4,7,31,"S.C.G.",55,2016,"Regular",13,"Home","Sydney","Melbourne",55
14900,2016-06-19,"R13","Essendon",12,18,90,"GWS",17,15,117,"Docklands",-27,2016,"Regular",13,"Away","GWS","Essendon",27
14901,2016-06-23,"R14","Adelaide",12,28,100,"North Melbourne",10,7,67,"Adelaide Oval",33,2016,"Regular",14,"Home","Adelaide","North Melbourne",33
14902,2016-06-24,"R14","Collingwood",12,13,85,"Fremantle",5,7,37,"M.C.G.",48,2016,"Regular",14,"Home","Collingwood","Fremantle",48
14903,2016-06-25,"R14","Richmond",17,15,117,"Brisbane Lions",11,9,75,"M.C.G.",42,2016,"Regular",14,"Home","Richmond","Brisbane Lions",42
14904,2016-06-25,"R14","GWS",18,19,127,"Carlton",9,11,65,"Sydney Showground",62,2016,"Regular",14,"Home","GWS","Carlton",62
14905,2016-06-25,"R14","St Kilda",14,9,93,"Geelong",13,12,90,"Docklands",3,2016,"Regular",14,"Home","St Kilda","Geelong",3
14906,2016-06-26,"R14","Hawthorn",12,14,86,"Gold Coast",8,12,60,"York Park",26,2016,"Regular",14,"Home","Hawthorn","Gold Coast",26
14907,2016-06-30,"R15","West Coast",20,10,130,"Essendon",7,10,52,"Subiaco",78,2016,"Regular",15,"Home","West Coast","Essendon",78
14908,2016-07-01,"R15","Port Adelaide",14,10,94,"Richmond",8,8,56,"Adelaide Oval",38,2016,"Regular",15,"Home","Port Adelaide","Richmond",38
14909,2016-07-02,"R15","Gold Coast",15,18,108,"St Kilda",8,20,68,"Carrara",40,2016,"Regular",15,"Home","Gold Coast","St Kilda",40
14910,2016-07-02,"R15","Sydney",11,13,79,"Footscray",13,5,83,"S.C.G.",-4,2016,"Regular",15,"Away","Footscray","Sydney",4
14911,2016-07-02,"R15","Carlton",6,9,45,"Collingwood",8,9,57,"M.C.G.",-12,2016,"Regular",15,"Away","Collingwood","Carlton",12
14912,2016-07-03,"R15","Melbourne",15,8,98,"Adelaide",18,12,120,"M.C.G.",-22,2016,"Regular",15,"Away","Adelaide","Melbourne",22
14913,2016-07-07,"R16","Port Adelaide",12,7,79,"Hawthorn",15,11,101,"Adelaide Oval",-22,2016,"Regular",16,"Away","Hawthorn","Port Adelaide",22
14914,2016-07-08,"R16","Geelong",9,6,60,"Sydney",15,8,98,"Kardinia Park",-38,2016,"Regular",16,"Away","Sydney","Geelong",38
14915,2016-07-09,"R16","GWS",14,9,93,"Collingwood",19,11,125,"Sydney Showground",-32,2016,"Regular",16,"Away","Collingwood","GWS",32
14916,2016-07-09,"R16","Gold Coast",22,7,139,"Brisbane Lions",17,11,113,"Carrara",26,2016,"Regular",16,"Home","Gold Coast","Brisbane Lions",26
14917,2016-07-09,"R16","Footscray",12,13,85,"Richmond",11,9,75,"Docklands",10,2016,"Regular",16,"Home","Footscray","Richmond",10
14918,2016-07-09,"R16","Melbourne",12,15,87,"Fremantle",8,7,55,"Marrara Oval",32,2016,"Regular",16,"Home","Melbourne","Fremantle",32
14919,2016-07-10,"R16","Carlton",7,5,47,"Adelaide",16,11,107,"M.C.G.",-60,2016,"Regular",16,"Away","Adelaide","Carlton",60
14920,2016-07-10,"R16","West Coast",16,8,104,"North Melbourne",11,6,72,"Subiaco",32,2016,"Regular",16,"Home","West Coast","North Melbourne",32
14921,2016-07-10,"R16","Essendon",14,14,98,"St Kilda",17,7,109,"Docklands",-11,2016,"Regular",16,"Away","St Kilda","Essendon",11
14922,2016-07-14,"R17","Sydney",10,10,70,"Hawthorn",11,9,75,"S.C.G.",-5,2016,"Regular",17,"Away","Hawthorn","Sydney",5
14923,2016-07-15,"R17","Fremantle",9,7,61,"Geelong",11,12,78,"Subiaco",-17,2016,"Regular",17,"Away","Geelong","Fremantle",17
14924,2016-07-16,"R17","Richmond",16,6,102,"Essendon",11,17,83,"M.C.G.",19,2016,"Regular",17,"Home","Richmond","Essendon",19
14925,2016-07-16,"R17","North Melbourne",10,17,77,"Port Adelaide",16,9,105,"Docklands",-28,2016,"Regular",17,"Away","Port Adelaide","North Melbourne",28
14926,2016-07-16,"R17","Footscray",15,17,107,"Gold Coast",8,11,59,"Cazaly's Stadium",48,2016,"Regular",17,"Home","Footscray","Gold Coast",48
14927,2016-07-16,"R17","Adelaide",14,13,97,"Collingwood",10,9,69,"Adelaide Oval",28,2016,"Regular",17,"Home","Adelaide","Collingwood",28
14928,2016-07-17,"R17","Carlton",11,9,75,"West Coast",12,10,82,"M.C.G.",-7,2016,"Regular",17,"Away","West Coast","Carlton",7
14929,2016-07-17,"R17","St Kilda",15,20,110,"Melbourne",11,8,74,"Docklands",36,2016,"Regular",17,"Home","St Kilda","Melbourne",36
14930,2016-07-17,"R17","Brisbane Lions",9,13,67,"GWS",22,14,146,"Gabba",-79,2016,"Regular",17,"Away","GWS","Brisbane Lions",79
14931,2016-07-22,"R18","Collingwood",12,12,84,"North Melbourne",18,16,124,"Docklands",-40,2016,"Regular",18,"Away","North Melbourne","Collingwood",40
14932,2016-07-23,"R18","Sydney",10,14,74,"Carlton",10,8,68,"S.C.G.",6,2016,"Regular",18,"Home","Sydney","Carlton",6
14933,2016-07-23,"R18","Gold Coast",16,9,105,"Fremantle",12,9,81,"Carrara",24,2016,"Regular",18,"Home","Gold Coast","Fremantle",24
14934,2016-07-23,"R18","West Coast",10,6,66,"Melbourne",8,12,60,"Subiaco",6,2016,"Regular",18,"Home","West Coast","Melbourne",6
14935,2016-07-23,"R18","Geelong",12,13,85,"Adelaide",7,13,55,"Kardinia Park",30,2016,"Regular",18,"Home","Geelong","Adelaide",30
14936,2016-07-23,"R18","Footscray",9,6,60,"St Kilda",11,9,75,"Docklands",-15,2016,"Regular",18,"Away","St Kilda","Footscray",15
14937,2016-07-24,"R18","Essendon",12,19,91,"Brisbane Lions",20,8,128,"Docklands",-37,2016,"Regular",18,"Away","Brisbane Lions","Essendon",37
14938,2016-07-24,"R18","Hawthorn",16,18,114,"Richmond",5,14,44,"M.C.G.",70,2016,"Regular",18,"Home","Hawthorn","Richmond",70
14939,2016-07-24,"R18","Port Adelaide",9,6,60,"GWS",11,13,79,"Adelaide Oval",-19,2016,"Regular",18,"Away","GWS","Port Adelaide",19
14940,2016-07-29,"R19","Geelong",16,7,103,"Footscray",11,12,78,"Kardinia Park",25,2016,"Regular",19,"Home","Geelong","Footscray",25
14941,2016-07-30,"R19","GWS",17,9,111,"Richmond",3,5,23,"Manuka Oval",88,2016,"Regular",19,"Home","GWS","Richmond",88
14942,2016-07-30,"R19","Hawthorn",10,14,74,"Carlton",7,13,55,"York Park",19,2016,"Regular",19,"Home","Hawthorn","Carlton",19
14943,2016-07-30,"R19","Collingwood",13,13,91,"West Coast",11,6,72,"M.C.G.",19,2016,"Regular",19,"Home","Collingwood","West Coast",19
14944,2016-07-30,"R19","North Melbourne",12,13,85,"St Kilda",8,14,62,"Docklands",23,2016,"Regular",19,"Home","North Melbourne","St Kilda",23
14945,2016-07-30,"R19","Brisbane Lions",11,13,79,"Port Adelaide",25,23,173,"Gabba",-94,2016,"Regular",19,"Away","Port Adelaide","Brisbane Lions",94
14946,2016-07-31,"R19","Melbourne",9,12,66,"Gold Coast",9,10,64,"M.C.G.",2,2016,"Regular",19,"Home","Melbourne","Gold Coast",2
14947,2016-07-31,"R19","Fremantle",7,5,47,"Sydney",21,11,137,"Subiaco",-90,2016,"Regular",19,"Away","Sydney","Fremantle",90
14948,2016-07-31,"R19","Adelaide",22,11,143,"Essendon",9,7,61,"Adelaide Oval",82,2016,"Regular",19,"Home","Adelaide","Essendon",82
14949,2016-08-05,"R20","Richmond",14,8,92,"Collingwood",11,11,77,"M.C.G.",15,2016,"Regular",20,"Home","Richmond","Collingwood",15
14950,2016-08-06,"R20","Sydney",14,16,100,"Port Adelaide",4,9,33,"S.C.G.",67,2016,"Regular",20,"Home","Sydney","Port Adelaide",67
14951,2016-08-06,"R20","Melbourne",17,8,110,"Hawthorn",11,15,81,"M.C.G.",29,2016,"Regular",20,"Home","Melbourne","Hawthorn",29
14952,2016-08-06,"R20","Gold Coast",13,6,84,"GWS",14,8,92,"Carrara",-8,2016,"Regular",20,"Away","GWS","Gold Coast",8
14953,2016-08-06,"R20","Footscray",9,7,61,"North Melbourne",7,5,47,"Docklands",14,2016,"Regular",20,"Home","Footscray","North Melbourne",14
14954,2016-08-06,"R20","Adelaide",27,15,177,"Brisbane Lions",6,3,39,"Adelaide Oval",138,2016,"Regular",20,"Home","Adelaide","Brisbane Lions",138
14955,2016-08-07,"R20","Carlton",7,9,51,"St Kilda",19,8,122,"M.C.G.",-71,2016,"Regular",20,"Away","St Kilda","Carlton",71
14956,2016-08-07,"R20","Geelong",15,10,100,"Essendon",4,10,34,"Docklands",66,2016,"Regular",20,"Home","Geelong","Essendon",66
14957,2016-08-07,"R20","Fremantle",9,10,64,"West Coast",17,8,110,"Subiaco",-46,2016,"Regular",20,"Away","West Coast","Fremantle",46
14958,2016-08-12,"R21","Footscray",14,11,95,"Collingwood",14,8,92,"Docklands",3,2016,"Regular",21,"Home","Footscray","Collingwood",3
14959,2016-08-13,"R21","Brisbane Lions",15,9,99,"Carlton",13,17,95,"Gabba",4,2016,"Regular",21,"Home","Brisbane Lions","Carlton",4
14960,2016-08-13,"R21","Hawthorn",14,12,96,"North Melbourne",8,9,57,"M.C.G.",39,2016,"Regular",21,"Home","Hawthorn","North Melbourne",39
14961,2016-08-13,"R21","GWS",14,12,96,"West Coast",14,13,97,"Sydney Showground",-1,2016,"Regular",21,"Away","West Coast","GWS",1
14962,2016-08-13,"R21","St Kilda",11,10,76,"Sydney",23,8,146,"Docklands",-70,2016,"Regular",21,"Away","Sydney","St Kilda",70
14963,2016-08-13,"R21","Port Adelaide",8,6,54,"Melbourne",13,16,94,"Adelaide Oval",-40,2016,"Regular",21,"Away","Melbourne","Port Adelaide",40
14964,2016-08-14,"R21","Essendon",11,9,75,"Gold Coast",9,15,69,"Docklands",6,2016,"Regular",21,"Home","Essendon","Gold Coast",6
14965,2016-08-14,"R21","Richmond",12,6,78,"Geelong",10,22,82,"M.C.G.",-4,2016,"Regular",21,"Away","Geelong","Richmond",4
14966,2016-08-14,"R21","Fremantle",11,4,70,"Adelaide",21,16,142,"Subiaco",-72,2016,"Regular",21,"Away","Adelaide","Fremantle",72
14967,2016-08-19,"R22","West Coast",13,14,92,"Hawthorn",10,7,67,"Subiaco",25,2016,"Regular",22,"Home","West Coast","Hawthorn",25
14968,2016-08-20,"R22","North Melbourne",10,16,76,"Sydney",12,13,85,"Bellerive Oval",-9,2016,"Regular",22,"Away","Sydney","North Melbourne",9
14969,2016-08-20,"R22","Richmond",6,10,46,"St Kilda",7,13,55,"M.C.G.",-9,2016,"Regular",22,"Away","St Kilda","Richmond",9
14970,2016-08-20,"R22","GWS",19,15,129,"Fremantle",5,7,37,"Sydney Showground",92,2016,"Regular",22,"Home","GWS","Fremantle",92
14971,2016-08-20,"R22","Collingwood",16,22,118,"Gold Coast",6,11,47,"Docklands",71,2016,"Regular",22,"Home","Collingwood","Gold Coast",71
14972,2016-08-20,"R22","Port Adelaide",14,10,94,"Adelaide",15,19,109,"Adelaide Oval",-15,2016,"Regular",22,"Away","Adelaide","Port Adelaide",15
14973,2016-08-21,"R22","Carlton",11,12,78,"Melbourne",7,16,58,"M.C.G.",20,2016,"Regular",22,"Home","Carlton","Melbourne",20
14974,2016-08-21,"R22","Brisbane Lions",10,9,69,"Geelong",19,15,129,"Gabba",-60,2016,"Regular",22,"Away","Geelong","Brisbane Lions",60
14975,2016-08-21,"R22","Essendon",7,11,53,"Footscray",14,9,93,"Docklands",-40,2016,"Regular",22,"Away","Footscray","Essendon",40
14976,2016-08-26,"R23","Adelaide",10,11,71,"West Coast",14,16,100,"Adelaide Oval",-29,2016,"Regular",23,"Away","West Coast","Adelaide",29
14977,2016-08-27,"R23","Geelong",24,11,155,"Melbourne",6,8,44,"Kardinia Park",111,2016,"Regular",23,"Home","Geelong","Melbourne",111
14978,2016-08-27,"R23","Essendon",15,13,103,"Carlton",10,19,79,"M.C.G.",24,2016,"Regular",23,"Home","Essendon","Carlton",24
14979,2016-08-27,"R23","Sydney",25,14,164,"Richmond",7,9,51,"S.C.G.",113,2016,"Regular",23,"Home","Sydney","Richmond",113
14980,2016-08-27,"R23","North Melbourne",9,9,63,"GWS",14,16,100,"Docklands",-37,2016,"Regular",23,"Away","GWS","North Melbourne",37
14981,2016-08-27,"R23","Gold Coast",9,12,66,"Port Adelaide",13,11,89,"Carrara",-23,2016,"Regular",23,"Away","Port Adelaide","Gold Coast",23
14982,2016-08-28,"R23","St Kilda",25,11,161,"Brisbane Lions",15,13,103,"Docklands",58,2016,"Regular",23,"Home","St Kilda","Brisbane Lions",58
14983,2016-08-28,"R23","Hawthorn",17,10,112,"Collingwood",17,9,111,"M.C.G.",1,2016,"Regular",23,"Home","Hawthorn","Collingwood",1
14984,2016-08-28,"R23","Fremantle",10,9,69,"Footscray",6,13,49,"Subiaco",20,2016,"Regular",23,"Home","Fremantle","Footscray",20
14985,2016-09-08,"EF","West Coast",7,10,52,"Footscray",14,15,99,"Subiaco",-47,2016,"Finals",24,"Away","Footscray","West Coast",47
14986,2016-09-09,"QF","Geelong",12,13,85,"Hawthorn",12,11,83,"M.C.G.",2,2016,"Finals",24,"Home","Geelong","Hawthorn",2
14987,2016-09-10,"QF","Sydney",7,13,55,"GWS",12,19,91,"Stadium Australia",-36,2016,"Finals",24,"Away","GWS","Sydney",36
14988,2016-09-10,"EF","Adelaide",21,15,141,"North Melbourne",12,7,79,"Adelaide Oval",62,2016,"Finals",24,"Home","Adelaide","North Melbourne",62
14989,2016-09-16,"SF","Hawthorn",12,12,84,"Footscray",16,11,107,"M.C.G.",-23,2016,"Finals",25,"Away","Footscray","Hawthorn",23
14990,2016-09-17,"SF","Sydney",18,10,118,"Adelaide",12,10,82,"S.C.G.",36,2016,"Finals",25,"Home","Sydney","Adelaide",36
14991,2016-09-23,"PF","Geelong",8,12,60,"Sydney",15,7,97,"M.C.G.",-37,2016,"Finals",26,"Away","Sydney","Geelong",37
14992,2016-09-24,"PF","GWS",12,11,83,"Footscray",13,11,89,"Sydney Showground",-6,2016,"Finals",26,"Away","Footscray","GWS",6
14993,2016-10-01,"GF","Sydney",10,7,67,"Footscray",13,11,89,"M.C.G.",-22,2016,"Finals",27,"Away","Footscray","Sydney",22
14994,2017-03-23,"R1","Carlton",14,5,89,"Richmond",20,12,132,"M.C.G.",-43,2017,"Regular",1,"Away","Richmond","Carlton",43
14995,2017-03-24,"R1","Collingwood",12,14,86,"Footscray",15,10,100,"M.C.G.",-14,2017,"Regular",1,"Away","Footscray","Collingwood",14
14996,2017-03-25,"R1","St Kilda",13,12,90,"Melbourne",18,12,120,"Docklands",-30,2017,"Regular",1,"Away","Melbourne","St Kilda",30
14997,2017-03-25,"R1","Sydney",12,10,82,"Port Adelaide",17,8,110,"S.C.G.",-28,2017,"Regular",1,"Away","Port Adelaide","Sydney",28
14998,2017-03-25,"R1","Essendon",17,14,116,"Hawthorn",12,19,91,"M.C.G.",25,2017,"Regular",1,"Home","Essendon","Hawthorn",25
14999,2017-03-25,"R1","Gold Coast",14,12,96,"Brisbane Lions",15,8,98,"Carrara",-2,2017,"Regular",1,"Away","Brisbane Lions","Gold Coast",2
15000,2017-03-26,"R1","North Melbourne",13,15,93,"West Coast",21,10,136,"Docklands",-43,2017,"Regular",1,"Away","West Coast","North Melbourne",43
15001,2017-03-26,"R1","Adelaide",22,15,147,"GWS",14,7,91,"Adelaide Oval",56,2017,"Regular",1,"Home","Adelaide","GWS",56
15002,2017-03-26,"R1","Fremantle",10,13,73,"Geelong",18,7,115,"Subiaco",-42,2017,"Regular",1,"Away","Geelong","Fremantle",42
15003,2017-03-30,"R2","Richmond",14,15,99,"Collingwood",11,14,80,"M.C.G.",19,2017,"Regular",2,"Home","Richmond","Collingwood",19
15004,2017-03-31,"R2","Footscray",16,14,110,"Sydney",13,9,87,"Docklands",23,2017,"Regular",2,"Home","Footscray","Sydney",23
15005,2017-04-01,"R2","Hawthorn",13,11,89,"Adelaide",16,17,113,"M.C.G.",-24,2017,"Regular",2,"Away","Adelaide","Hawthorn",24
15006,2017-04-01,"R2","GWS",24,16,160,"Gold Coast",8,10,58,"Sydney Showground",102,2017,"Regular",2,"Home","GWS","Gold Coast",102
15007,2017-04-01,"R2","Brisbane Lions",12,12,84,"Essendon",17,9,111,"Gabba",-27,2017,"Regular",2,"Away","Essendon","Brisbane Lions",27
15008,2017-04-01,"R2","West Coast",18,8,116,"St Kilda",13,19,97,"Subiaco",19,2017,"Regular",2,"Home","West Coast","St Kilda",19
15009,2017-04-02,"R2","Geelong",17,10,112,"North Melbourne",17,9,111,"Docklands",1,2017,"Regular",2,"Home","Geelong","North Melbourne",1
15010,2017-04-02,"R2","Melbourne",13,8,86,"Carlton",9,10,64,"M.C.G.",22,2017,"Regular",2,"Home","Melbourne","Carlton",22
15011,2017-04-02,"R2","Port Adelaide",22,13,145,"Fremantle",8,8,56,"Adelaide Oval",89,2017,"Regular",2,"Home","Port Adelaide","Fremantle",89
15012,2017-04-07,"R3","Sydney",11,13,79,"Collingwood",11,14,80,"S.C.G.",-1,2017,"Regular",3,"Away","Collingwood","Sydney",1
15013,2017-04-08,"R3","North Melbourne",10,7,67,"GWS",15,19,109,"Bellerive Oval",-42,2017,"Regular",3,"Away","GWS","North Melbourne",42
15014,2017-04-08,"R3","Richmond",11,10,76,"West Coast",8,17,65,"M.C.G.",11,2017,"Regular",3,"Home","Richmond","West Coast",11
15015,2017-04-08,"R3","Geelong",20,6,126,"Melbourne",13,19,97,"Docklands",29,2017,"Regular",3,"Home","Geelong","Melbourne",29
15016,2017-04-08,"R3","Port Adelaide",12,11,83,"Adelaide",15,10,100,"Adelaide Oval",-17,2017,"Regular",3,"Away","Adelaide","Port Adelaide",17
15017,2017-04-08,"R3","Fremantle",13,11,89,"Footscray",10,13,73,"Subiaco",16,2017,"Regular",3,"Home","Fremantle","Footscray",16
15018,2017-04-09,"R3","St Kilda",14,23,107,"Brisbane Lions",11,10,76,"Docklands",31,2017,"Regular",3,"Home","St Kilda","Brisbane Lions",31
15019,2017-04-09,"R3","Carlton",7,15,57,"Essendon",6,6,42,"M.C.G.",15,2017,"Regular",3,"Home","Carlton","Essendon",15
15020,2017-04-09,"R3","Gold Coast",21,13,139,"Hawthorn",7,11,53,"Carrara",86,2017,"Regular",3,"Home","Gold Coast","Hawthorn",86
15021,2017-04-13,"R4","West Coast",13,13,91,"Sydney",10,5,65,"Subiaco",26,2017,"Regular",4,"Home","West Coast","Sydney",26
15022,2017-04-14,"R4","North Melbourne",12,14,86,"Footscray",12,17,89,"Docklands",-3,2017,"Regular",4,"Away","Footscray","North Melbourne",3
15023,2017-04-15,"R4","Melbourne",15,14,104,"Fremantle",16,10,106,"M.C.G.",-2,2017,"Regular",4,"Away","Fremantle","Melbourne",2
15024,2017-04-15,"R4","GWS",16,16,112,"Port Adelaide",11,15,81,"Manuka Oval",31,2017,"Regular",4,"Home","GWS","Port Adelaide",31
15025,2017-04-15,"R4","Carlton",12,10,82,"Gold Coast",17,6,108,"Docklands",-26,2017,"Regular",4,"Away","Gold Coast","Carlton",26
15026,2017-04-15,"R4","Adelaide",24,9,153,"Essendon",13,10,88,"Adelaide Oval",65,2017,"Regular",4,"Home","Adelaide","Essendon",65
15027,2017-04-16,"R4","Collingwood",7,13,55,"St Kilda",9,15,69,"Docklands",-14,2017,"Regular",4,"Away","St Kilda","Collingwood",14
15028,2017-04-16,"R4","Brisbane Lions",10,7,67,"Richmond",17,17,119,"Gabba",-52,2017,"Regular",4,"Away","Richmond","Brisbane Lions",52
15029,2017-04-17,"R4","Hawthorn",6,12,48,"Geelong",20,14,134,"M.C.G.",-86,2017,"Regular",4,"Away","Geelong","Hawthorn",86
15030,2017-04-21,"R5","Port Adelaide",20,17,137,"Carlton",6,11,47,"Adelaide Oval",90,2017,"Regular",5,"Home","Port Adelaide","Carlton",90
15031,2017-04-22,"R5","Footscray",17,20,122,"Brisbane Lions",14,6,90,"Docklands",32,2017,"Regular",5,"Home","Footscray","Brisbane Lions",32
15032,2017-04-22,"R5","Gold Coast",13,8,86,"Adelaide",23,15,153,"Carrara",-67,2017,"Regular",5,"Away","Adelaide","Gold Coast",67
15033,2017-04-22,"R5","Sydney",9,9,63,"GWS",15,15,105,"S.C.G.",-42,2017,"Regular",5,"Away","GWS","Sydney",42
15034,2017-04-22,"R5","Fremantle",9,13,67,"North Melbourne",9,8,62,"Subiaco",5,2017,"Regular",5,"Home","Fremantle","North Melbourne",5
15035,2017-04-23,"R5","St Kilda",13,10,88,"Geelong",19,12,126,"Docklands",-38,2017,"Regular",5,"Away","Geelong","St Kilda",38
15036,2017-04-23,"R5","Hawthorn",19,11,125,"West Coast",11,9,75,"M.C.G.",50,2017,"Regular",5,"Home","Hawthorn","West Coast",50
15037,2017-04-24,"R5","Richmond",12,16,88,"Melbourne",11,9,75,"M.C.G.",13,2017,"Regular",5,"Home","Richmond","Melbourne",13
15038,2017-04-25,"R5","Essendon",15,10,100,"Collingwood",11,16,82,"M.C.G.",18,2017,"Regular",5,"Home","Essendon","Collingwood",18
15039,2017-04-28,"R6","GWS",11,9,75,"Footscray",9,19,73,"Manuka Oval",2,2017,"Regular",6,"Home","GWS","Footscray",2
15040,2017-04-29,"R6","Hawthorn",8,7,55,"St Kilda",19,16,130,"York Park",-75,2017,"Regular",6,"Away","St Kilda","Hawthorn",75
15041,2017-04-29,"R6","Carlton",15,7,97,"Sydney",11,12,78,"M.C.G.",19,2017,"Regular",6,"Home","Carlton","Sydney",19
15042,2017-04-29,"R6","Brisbane Lions",10,7,67,"Port Adelaide",22,18,150,"Gabba",-83,2017,"Regular",6,"Away","Port Adelaide","Brisbane Lions",83
15043,2017-04-29,"R6","North Melbourne",16,11,107,"Gold Coast",14,10,94,"Docklands",13,2017,"Regular",6,"Home","North Melbourne","Gold Coast",13
15044,2017-04-29,"R6","West Coast",16,7,103,"Fremantle",9,8,62,"Subiaco",41,2017,"Regular",6,"Home","West Coast","Fremantle",41
15045,2017-04-30,"R6","Essendon",10,14,74,"Melbourne",17,10,112,"Docklands",-38,2017,"Regular",6,"Away","Melbourne","Essendon",38
15046,2017-04-30,"R6","Geelong",11,12,78,"Collingwood",15,17,107,"M.C.G.",-29,2017,"Regular",6,"Away","Collingwood","Geelong",29
15047,2017-04-30,"R6","Adelaide",21,14,140,"Richmond",10,4,64,"Adelaide Oval",76,2017,"Regular",6,"Home","Adelaide","Richmond",76
15048,2017-05-05,"R7","St Kilda",16,12,108,"GWS",12,13,85,"Docklands",23,2017,"Regular",7,"Home","St Kilda","GWS",23
15049,2017-05-06,"R7","North Melbourne",22,13,145,"Adelaide",13,8,86,"Bellerive Oval",59,2017,"Regular",7,"Home","North Melbourne","Adelaide",59
15050,2017-05-06,"R7","Collingwood",8,8,56,"Carlton",12,7,79,"M.C.G.",-23,2017,"Regular",7,"Away","Carlton","Collingwood",23
15051,2017-05-06,"R7","Port Adelaide",12,15,87,"West Coast",15,7,97,"Adelaide Oval",-10,2017,"Regular",7,"Away","West Coast","Port Adelaide",10
15052,2017-05-06,"R7","Footscray",11,14,80,"Richmond",11,9,75,"Docklands",5,2017,"Regular",7,"Home","Footscray","Richmond",5
15053,2017-05-06,"R7","Gold Coast",18,16,124,"Geelong",15,9,99,"Carrara",25,2017,"Regular",7,"Home","Gold Coast","Geelong",25
15054,2017-05-07,"R7","Sydney",20,15,135,"Brisbane Lions",12,9,81,"S.C.G.",54,2017,"Regular",7,"Home","Sydney","Brisbane Lions",54
15055,2017-05-07,"R7","Melbourne",14,7,91,"Hawthorn",14,10,94,"M.C.G.",-3,2017,"Regular",7,"Away","Hawthorn","Melbourne",3
15056,2017-05-07,"R7","Fremantle",17,14,116,"Essendon",11,13,79,"Subiaco",37,2017,"Regular",7,"Home","Fremantle","Essendon",37
15057,2017-05-12,"R8","West Coast",9,15,69,"Footscray",8,13,61,"Subiaco",8,2017,"Regular",8,"Home","West Coast","Footscray",8
15058,2017-05-13,"R8","Hawthorn",17,11,113,"Brisbane Lions",11,9,75,"York Park",38,2017,"Regular",8,"Home","Hawthorn","Brisbane Lions",38
15059,2017-05-13,"R8","St Kilda",12,13,85,"Carlton",10,6,66,"Docklands",19,2017,"Regular",8,"Home","St Kilda","Carlton",19
15060,2017-05-13,"R8","GWS",15,12,102,"Collingwood",15,9,99,"Sydney Showground",3,2017,"Regular",8,"Home","GWS","Collingwood",3
15061,2017-05-13,"R8","Essendon",17,8,110,"Geelong",13,15,93,"M.C.G.",17,2017,"Regular",8,"Home","Essendon","Geelong",17
15062,2017-05-13,"R8","Adelaide",9,12,66,"Melbourne",17,5,107,"Adelaide Oval",-41,2017,"Regular",8,"Away","Melbourne","Adelaide",41
15063,2017-05-14,"R8","Gold Coast",4,14,38,"Port Adelaide",16,14,110,"Jiangwan Stadium",-72,2017,"Regular",8,"Away","Port Adelaide","Gold Coast",72
15064,2017-05-14,"R8","Richmond",10,10,70,"Fremantle",10,12,72,"M.C.G.",-2,2017,"Regular",8,"Away","Fremantle","Richmond",2
15065,2017-05-14,"R8","North Melbourne",11,12,78,"Sydney",18,12,120,"Docklands",-42,2017,"Regular",8,"Away","Sydney","North Melbourne",42
15066,2017-05-19,"R9","Geelong",16,8,104,"Footscray",12,9,81,"Kardinia Park",23,2017,"Regular",9,"Home","Geelong","Footscray",23
15067,2017-05-20,"R9","St Kilda",10,8,68,"Sydney",18,10,118,"Docklands",-50,2017,"Regular",9,"Away","Sydney","St Kilda",50
15068,2017-05-20,"R9","GWS",11,12,78,"Richmond",10,15,75,"Sydney Showground",3,2017,"Regular",9,"Home","GWS","Richmond",3
15069,2017-05-20,"R9","Brisbane Lions",7,18,60,"Adelaide",21,14,140,"Gabba",-80,2017,"Regular",9,"Away","Adelaide","Brisbane Lions",80
15070,2017-05-20,"R9","Collingwood",13,12,90,"Hawthorn",11,6,72,"M.C.G.",18,2017,"Regular",9,"Home","Collingwood","Hawthorn",18
15071,2017-05-21,"R9","Essendon",19,11,125,"West Coast",8,16,64,"Docklands",61,2017,"Regular",9,"Home","Essendon","West Coast",61
15072,2017-05-21,"R9","Melbourne",13,12,90,"North Melbourne",15,14,104,"M.C.G.",-14,2017,"Regular",9,"Away","North Melbourne","Melbourne",14
15073,2017-05-21,"R9","Fremantle",13,8,86,"Carlton",7,9,51,"Subiaco",35,2017,"Regular",9,"Home","Fremantle","Carlton",35
15074,2017-05-25,"R10","Geelong",11,15,81,"Port Adelaide",11,13,79,"Kardinia Park",2,2017,"Regular",10,"Home","Geelong","Port Adelaide",2
15075,2017-05-26,"R10","Sydney",11,9,75,"Hawthorn",12,9,81,"S.C.G.",-6,2017,"Regular",10,"Away","Hawthorn","Sydney",6
15076,2017-05-27,"R10","Footscray",13,12,90,"St Kilda",7,8,50,"Docklands",40,2017,"Regular",10,"Home","Footscray","St Kilda",40
15077,2017-05-27,"R10","Melbourne",18,14,122,"Gold Coast",13,9,87,"Traeger Park",35,2017,"Regular",10,"Home","Melbourne","Gold Coast",35
15078,2017-05-27,"R10","Richmond",11,15,81,"Essendon",10,6,66,"M.C.G.",15,2017,"Regular",10,"Home","Richmond","Essendon",15
15079,2017-05-27,"R10","Adelaide",20,23,143,"Fremantle",6,7,43,"Adelaide Oval",100,2017,"Regular",10,"Home","Adelaide","Fremantle",100
15080,2017-05-28,"R10","Collingwood",18,21,129,"Brisbane Lions",13,6,84,"M.C.G.",45,2017,"Regular",10,"Home","Collingwood","Brisbane Lions",45
15081,2017-05-28,"R10","Carlton",15,6,96,"North Melbourne",17,11,113,"Docklands",-17,2017,"Regular",10,"Away","North Melbourne","Carlton",17
15082,2017-05-28,"R10","West Coast",14,6,90,"GWS",14,14,98,"Subiaco",-8,2017,"Regular",10,"Away","GWS","West Coast",8
15083,2017-06-01,"R11","Port Adelaide",13,20,98,"Hawthorn",7,5,47,"Adelaide Oval",51,2017,"Regular",11,"Home","Port Adelaide","Hawthorn",51
15084,2017-06-02,"R11","Geelong",13,18,96,"Adelaide",10,14,74,"Kardinia Park",22,2017,"Regular",11,"Home","Geelong","Adelaide",22
15085,2017-06-03,"R11","Gold Coast",11,14,80,"West Coast",11,11,77,"Carrara",3,2017,"Regular",11,"Home","Gold Coast","West Coast",3
15086,2017-06-03,"R11","GWS",18,9,117,"Essendon",15,11,101,"Sydney Showground",16,2017,"Regular",11,"Home","GWS","Essendon",16
15087,2017-06-03,"R11","North Melbourne",9,12,66,"Richmond",14,17,101,"Docklands",-35,2017,"Regular",11,"Away","Richmond","North Melbourne",35
15088,2017-06-04,"R11","Fremantle",12,13,85,"Collingwood",15,15,105,"Subiaco",-20,2017,"Regular",11,"Away","Collingwood","Fremantle",20
15089,2017-06-08,"R12","Sydney",12,16,88,"Footscray",6,6,42,"S.C.G.",46,2017,"Regular",12,"Home","Sydney","Footscray",46
15090,2017-06-09,"R12","Adelaide",16,15,111,"St Kilda",7,12,54,"Adelaide Oval",57,2017,"Regular",12,"Home","Adelaide","St Kilda",57
15091,2017-06-10,"R12","Hawthorn",12,7,79,"Gold Coast",13,17,95,"M.C.G.",-16,2017,"Regular",12,"Away","Gold Coast","Hawthorn",16
15092,2017-06-10,"R12","Brisbane Lions",18,13,121,"Fremantle",9,10,64,"Gabba",57,2017,"Regular",12,"Home","Brisbane Lions","Fremantle",57
15093,2017-06-10,"R12","Essendon",19,17,131,"Port Adelaide",8,13,61,"Docklands",70,2017,"Regular",12,"Home","Essendon","Port Adelaide",70
15094,2017-06-11,"R12","Carlton",10,11,71,"GWS",9,16,70,"Docklands",1,2017,"Regular",12,"Home","Carlton","GWS",1
15095,2017-06-12,"R12","Melbourne",15,14,104,"Collingwood",15,10,100,"M.C.G.",4,2017,"Regular",12,"Home","Melbourne","Collingwood",4
15096,2017-06-15,"R13","West Coast",11,17,83,"Geelong",10,10,70,"Subiaco",13,2017,"Regular",13,"Home","West Coast","Geelong",13
15097,2017-06-16,"R13","North Melbourne",10,12,72,"St Kilda",12,17,89,"Docklands",-17,2017,"Regular",13,"Away","St Kilda","North Melbourne",17
15098,2017-06-17,"R13","Richmond",10,11,71,"Sydney",12,8,80,"M.C.G.",-9,2017,"Regular",13,"Away","Sydney","Richmond",9
15099,2017-06-17,"R13","Port Adelaide",18,13,121,"Brisbane Lions",12,9,81,"Adelaide Oval",40,2017,"Regular",13,"Home","Port Adelaide","Brisbane Lions",40
15100,2017-06-17,"R13","Gold Coast",11,7,73,"Carlton",12,11,83,"Carrara",-10,2017,"Regular",13,"Away","Carlton","Gold Coast",10
15101,2017-06-18,"R13","Footscray",8,8,56,"Melbourne",17,11,113,"Docklands",-57,2017,"Regular",13,"Away","Melbourne","Footscray",57
15102,2017-06-22,"R14","Adelaide",12,10,82,"Hawthorn",14,12,96,"Adelaide Oval",-14,2017,"Regular",14,"Away","Hawthorn","Adelaide",14
15103,2017-06-23,"R14","Sydney",11,20,86,"Essendon",12,13,85,"S.C.G.",1,2017,"Regular",14,"Home","Sydney","Essendon",1
15104,2017-06-24,"R14","Collingwood",9,8,62,"Port Adelaide",13,15,93,"M.C.G.",-31,2017,"Regular",14,"Away","Port Adelaide","Collingwood",31
15105,2017-06-24,"R14","Brisbane Lions",12,14,86,"GWS",22,14,146,"Gabba",-60,2017,"Regular",14,"Away","GWS","Brisbane Lions",60
15106,2017-06-24,"R14","Footscray",15,17,107,"North Melbourne",16,10,106,"Docklands",1,2017,"Regular",14,"Home","Footscray","North Melbourne",1
15107,2017-06-24,"R14","West Coast",14,12,96,"Melbourne",15,9,99,"Subiaco",-3,2017,"Regular",14,"Away","Melbourne","West Coast",3
15108,2017-06-25,"R14","Geelong",10,14,74,"Fremantle",11,6,72,"Kardinia Park",2,2017,"Regular",14,"Home","Geelong","Fremantle",2
15109,2017-06-25,"R14","Richmond",11,18,84,"Carlton",8,10,58,"M.C.G.",26,2017,"Regular",14,"Home","Richmond","Carlton",26
15110,2017-06-25,"R14","St Kilda",14,19,103,"Gold Coast",10,12,72,"Docklands",31,2017,"Regular",14,"Home","St Kilda","Gold Coast",31
15111,2017-06-30,"R15","Melbourne",7,8,50,"Sydney",11,19,85,"M.C.G.",-35,2017,"Regular",15,"Away","Sydney","Melbourne",35
15112,2017-07-01,"R15","Footscray",11,14,80,"West Coast",12,15,87,"Docklands",-7,2017,"Regular",15,"Away","West Coast","Footscray",7
15113,2017-07-01,"R15","Carlton",12,5,77,"Adelaide",13,11,89,"M.C.G.",-12,2017,"Regular",15,"Away","Adelaide","Carlton",12
15114,2017-07-01,"R15","Gold Coast",18,10,118,"North Melbourne",14,15,99,"Carrara",19,2017,"Regular",15,"Home","Gold Coast","North Melbourne",19
15115,2017-07-01,"R15","GWS",10,8,68,"Geelong",10,8,68,"Sydney Showground",0,2017,"Regular",15,"Home","GWS","Geelong",0
15116,2017-07-01,"R15","Port Adelaide",8,15,63,"Richmond",11,10,76,"Adelaide Oval",-13,2017,"Regular",15,"Away","Richmond","Port Adelaide",13
15117,2017-07-02,"R15","Essendon",11,16,82,"Brisbane Lions",13,12,90,"Docklands",-8,2017,"Regular",15,"Away","Brisbane Lions","Essendon",8
15118,2017-07-02,"R15","Hawthorn",18,10,118,"Collingwood",14,10,94,"M.C.G.",24,2017,"Regular",15,"Home","Hawthorn","Collingwood",24
15119,2017-07-02,"R15","Fremantle",12,8,80,"St Kilda",12,17,89,"Subiaco",-9,2017,"Regular",15,"Away","St Kilda","Fremantle",9
15120,2017-07-07,"R16","Adelaide",16,8,104,"Footscray",5,15,45,"Adelaide Oval",59,2017,"Regular",16,"Home","Adelaide","Footscray",59
15121,2017-07-08,"R16","Hawthorn",14,13,97,"GWS",15,7,97,"York Park",0,2017,"Regular",16,"Home","Hawthorn","GWS",0
15122,2017-07-08,"R16","Collingwood",12,8,80,"Essendon",18,9,117,"M.C.G.",-37,2017,"Regular",16,"Away","Essendon","Collingwood",37
15123,2017-07-08,"R16","Sydney",17,16,118,"Gold Coast",7,9,51,"S.C.G.",67,2017,"Regular",16,"Home","Sydney","Gold Coast",67
15124,2017-07-08,"R16","Brisbane Lions",11,12,78,"Geelong",25,13,163,"Gabba",-85,2017,"Regular",16,"Away","Geelong","Brisbane Lions",85
15125,2017-07-08,"R16","St Kilda",21,12,138,"Richmond",10,11,71,"Docklands",67,2017,"Regular",16,"Home","St Kilda","Richmond",67
15126,2017-07-09,"R16","North Melbourne",12,10,82,"Fremantle",13,8,86,"Docklands",-4,2017,"Regular",16,"Away","Fremantle","North Melbourne",4
15127,2017-07-09,"R16","Carlton",12,10,82,"Melbourne",14,6,90,"M.C.G.",-8,2017,"Regular",16,"Away","Melbourne","Carlton",8
15128,2017-07-09,"R16","West Coast",13,10,88,"Port Adelaide",18,12,120,"Subiaco",-32,2017,"Regular",16,"Away","Port Adelaide","West Coast",32
15129,2017-07-14,"R17","St Kilda",7,15,57,"Essendon",17,16,118,"Docklands",-61,2017,"Regular",17,"Away","Essendon","St Kilda",61
15130,2017-07-15,"R17","Geelong",13,10,88,"Hawthorn",12,13,85,"M.C.G.",3,2017,"Regular",17,"Home","Geelong","Hawthorn",3
15131,2017-07-15,"R17","Port Adelaide",19,13,127,"North Melbourne",8,9,57,"Adelaide Oval",70,2017,"Regular",17,"Home","Port Adelaide","North Melbourne",70
15132,2017-07-15,"R17","Gold Coast",13,10,88,"Collingwood",15,13,103,"Carrara",-15,2017,"Regular",17,"Away","Collingwood","Gold Coast",15
15133,2017-07-15,"R17","GWS",12,11,83,"Sydney",14,12,96,"Sydney Showground",-13,2017,"Regular",17,"Away","Sydney","GWS",13
15134,2017-07-15,"R17","Melbourne",10,10,70,"Adelaide",17,14,116,"Marrara Oval",-46,2017,"Regular",17,"Away","Adelaide","Melbourne",46
15135,2017-07-16,"R17","Richmond",16,16,112,"Brisbane Lions",12,9,81,"Docklands",31,2017,"Regular",17,"Home","Richmond","Brisbane Lions",31
15136,2017-07-16,"R17","Carlton",9,8,62,"Footscray",12,10,82,"M.C.G.",-20,2017,"Regular",17,"Away","Footscray","Carlton",20
15137,2017-07-16,"R17","Fremantle",5,14,44,"West Coast",11,8,74,"Subiaco",-30,2017,"Regular",17,"Away","West Coast","Fremantle",30
15138,2017-07-21,"R18","Adelaide",13,13,91,"Geelong",10,10,70,"Adelaide Oval",21,2017,"Regular",18,"Home","Adelaide","Geelong",21
15139,2017-07-22,"R18","Essendon",20,12,132,"North Melbourne",16,9,105,"Docklands",27,2017,"Regular",18,"Home","Essendon","North Melbourne",27
15140,2017-07-22,"R18","Melbourne",13,10,88,"Port Adelaide",9,11,65,"M.C.G.",23,2017,"Regular",18,"Home","Melbourne","Port Adelaide",23
15141,2017-07-22,"R18","Footscray",16,14,110,"Gold Coast",8,8,56,"Cazaly's Stadium",54,2017,"Regular",18,"Home","Footscray","Gold Coast",54
15142,2017-07-22,"R18","Sydney",14,17,101,"St Kilda",9,5,59,"S.C.G.",42,2017,"Regular",18,"Home","Sydney","St Kilda",42
15143,2017-07-22,"R18","Fremantle",7,6,48,"Hawthorn",15,10,100,"Subiaco",-52,2017,"Regular",18,"Away","Hawthorn","Fremantle",52
15144,2017-07-23,"R18","Richmond",9,10,64,"GWS",6,9,45,"M.C.G.",19,2017,"Regular",18,"Home","Richmond","GWS",19
15145,2017-07-23,"R18","Collingwood",13,15,93,"West Coast",13,7,85,"Docklands",8,2017,"Regular",18,"Home","Collingwood","West Coast",8
15146,2017-07-23,"R18","Brisbane Lions",17,10,112,"Carlton",11,16,82,"Gabba",30,2017,"Regular",18,"Home","Brisbane Lions","Carlton",30
15147,2017-07-28,"R19","Hawthorn",10,12,72,"Sydney",9,12,66,"M.C.G.",6,2017,"Regular",19,"Home","Hawthorn","Sydney",6
15148,2017-07-29,"R19","North Melbourne",11,10,76,"Melbourne",10,12,72,"Bellerive Oval",4,2017,"Regular",19,"Home","North Melbourne","Melbourne",4
15149,2017-07-29,"R19","GWS",13,20,98,"Fremantle",13,8,86,"Sydney Showground",12,2017,"Regular",19,"Home","GWS","Fremantle",12
15150,2017-07-29,"R19","Port Adelaide",9,9,63,"St Kilda",8,13,61,"Adelaide Oval",2,2017,"Regular",19,"Home","Port Adelaide","St Kilda",2
15151,2017-07-29,"R19","Carlton",8,10,58,"Geelong",18,15,123,"Docklands",-65,2017,"Regular",19,"Away","Geelong","Carlton",65
15152,2017-07-29,"R19","Gold Coast",10,5,65,"Richmond",14,14,98,"Carrara",-33,2017,"Regular",19,"Away","Richmond","Gold Coast",33
15153,2017-07-30,"R19","Footscray",19,13,127,"Essendon",13,19,97,"Docklands",30,2017,"Regular",19,"Home","Footscray","Essendon",30
15154,2017-07-30,"R19","Collingwood",15,13,103,"Adelaide",16,7,103,"M.C.G.",0,2017,"Regular",19,"Home","Collingwood","Adelaide",0
15155,2017-07-30,"R19","West Coast",17,11,113,"Brisbane Lions",6,9,45,"Subiaco",68,2017,"Regular",19,"Home","West Coast","Brisbane Lions",68
15156,2017-08-04,"R20","Geelong",8,13,61,"Sydney",16,11,107,"Kardinia Park",-46,2017,"Regular",20,"Away","Sydney","Geelong",46
15157,2017-08-05,"R20","GWS",14,13,97,"Melbourne",10,2,62,"Manuka Oval",35,2017,"Regular",20,"Home","GWS","Melbourne",35
15158,2017-08-05,"R20","Essendon",11,18,84,"Carlton",11,10,76,"M.C.G.",8,2017,"Regular",20,"Home","Essendon","Carlton",8
15159,2017-08-05,"R20","Brisbane Lions",13,11,89,"Footscray",14,19,103,"Gabba",-14,2017,"Regular",20,"Away","Footscray","Brisbane Lions",14
15160,2017-08-05,"R20","North Melbourne",7,15,57,"Collingwood",16,15,111,"Docklands",-54,2017,"Regular",20,"Away","Collingwood","North Melbourne",54
15161,2017-08-05,"R20","Fremantle",12,18,90,"Gold Coast",10,7,67,"Subiaco",23,2017,"Regular",20,"Home","Fremantle","Gold Coast",23
15162,2017-08-06,"R20","St Kilda",15,13,103,"West Coast",14,11,95,"Docklands",8,2017,"Regular",20,"Home","St Kilda","West Coast",8
15163,2017-08-06,"R20","Richmond",13,15,93,"Hawthorn",9,10,64,"M.C.G.",29,2017,"Regular",20,"Home","Richmond","Hawthorn",29
15164,2017-08-06,"R20","Adelaide",18,22,130,"Port Adelaide",7,4,46,"Adelaide Oval",84,2017,"Regular",20,"Home","Adelaide","Port Adelaide",84
15165,2017-08-11,"R21","Footscray",7,15,57,"GWS",16,9,105,"Docklands",-48,2017,"Regular",21,"Away","GWS","Footscray",48
15166,2017-08-12,"R21","Sydney",22,11,143,"Fremantle",5,9,39,"S.C.G.",104,2017,"Regular",21,"Home","Sydney","Fremantle",104
15167,2017-08-12,"R21","Geelong",11,14,80,"Richmond",9,12,66,"Kardinia Park",14,2017,"Regular",21,"Home","Geelong","Richmond",14
15168,2017-08-12,"R21","Brisbane Lions",22,10,142,"Gold Coast",12,12,84,"Gabba",58,2017,"Regular",21,"Home","Brisbane Lions","Gold Coast",58
15169,2017-08-12,"R21","Essendon",12,8,80,"Adelaide",18,15,123,"Docklands",-43,2017,"Regular",21,"Away","Adelaide","Essendon",43
15170,2017-08-12,"R21","West Coast",15,10,100,"Carlton",12,11,83,"Subiaco",17,2017,"Regular",21,"Home","West Coast","Carlton",17
15171,2017-08-13,"R21","Melbourne",14,12,96,"St Kilda",10,12,72,"M.C.G.",24,2017,"Regular",21,"Home","Melbourne","St Kilda",24
15172,2017-08-13,"R21","Hawthorn",18,8,116,"North Melbourne",14,5,89,"York Park",27,2017,"Regular",21,"Home","Hawthorn","North Melbourne",27
15173,2017-08-13,"R21","Port Adelaide",14,14,98,"Collingwood",10,11,71,"Adelaide Oval",27,2017,"Regular",21,"Home","Port Adelaide","Collingwood",27
15174,2017-08-18,"R22","Adelaide",11,14,80,"Sydney",13,5,83,"Adelaide Oval",-3,2017,"Regular",22,"Away","Sydney","Adelaide",3
15175,2017-08-19,"R22","Footscray",11,13,79,"Port Adelaide",14,12,96,"Eureka Stadium",-17,2017,"Regular",22,"Away","Port Adelaide","Footscray",17
15176,2017-08-19,"R22","Collingwood",9,5,59,"Geelong",10,10,70,"M.C.G.",-11,2017,"Regular",22,"Away","Geelong","Collingwood",11
15177,2017-08-19,"R22","GWS",12,9,81,"West Coast",9,6,60,"Sydney Showground",21,2017,"Regular",22,"Home","GWS","West Coast",21
15178,2017-08-19,"R22","Carlton",12,5,77,"Hawthorn",10,10,70,"Docklands",7,2017,"Regular",22,"Home","Carlton","Hawthorn",7
15179,2017-08-19,"R22","Gold Coast",9,3,57,"Essendon",12,18,90,"Carrara",-33,2017,"Regular",22,"Away","Essendon","Gold Coast",33
15180,2017-08-20,"R22","Melbourne",16,8,104,"Brisbane Lions",14,7,91,"M.C.G.",13,2017,"Regular",22,"Home","Melbourne","Brisbane Lions",13
15181,2017-08-20,"R22","St Kilda",18,19,127,"North Melbourne",12,6,78,"Docklands",49,2017,"Regular",22,"Home","St Kilda","North Melbourne",49
15182,2017-08-20,"R22","Fremantle",7,9,51,"Richmond",25,5,155,"Subiaco",-104,2017,"Regular",22,"Away","Richmond","Fremantle",104
15183,2017-08-25,"R23","Hawthorn",15,9,99,"Footscray",13,12,90,"Docklands",9,2017,"Regular",23,"Home","Hawthorn","Footscray",9
15184,2017-08-26,"R23","Collingwood",14,15,99,"Melbourne",12,11,83,"M.C.G.",16,2017,"Regular",23,"Home","Collingwood","Melbourne",16
15185,2017-08-26,"R23","Brisbane Lions",11,13,79,"North Melbourne",19,16,130,"Gabba",-51,2017,"Regular",23,"Away","North Melbourne","Brisbane Lions",51
15186,2017-08-26,"R23","Sydney",21,12,138,"Carlton",8,9,57,"S.C.G.",81,2017,"Regular",23,"Home","Sydney","Carlton",81
15187,2017-08-26,"R23","Geelong",15,13,103,"GWS",8,11,59,"Kardinia Park",44,2017,"Regular",23,"Home","Geelong","GWS",44
15188,2017-08-26,"R23","Port Adelaide",20,15,135,"Gold Coast",3,2,20,"Adelaide Oval",115,2017,"Regular",23,"Home","Port Adelaide","Gold Coast",115
15189,2017-08-27,"R23","Essendon",16,11,107,"Fremantle",14,8,92,"Docklands",15,2017,"Regular",23,"Home","Essendon","Fremantle",15
15190,2017-08-27,"R23","Richmond",19,8,122,"St Kilda",12,9,81,"M.C.G.",41,2017,"Regular",23,"Home","Richmond","St Kilda",41
15191,2017-08-27,"R23","West Coast",15,10,100,"Adelaide",10,11,71,"Subiaco",29,2017,"Regular",23,"Home","West Coast","Adelaide",29
15192,2017-09-07,"QF","Adelaide",12,12,84,"GWS",6,12,48,"Adelaide Oval",36,2017,"Finals",24,"Home","Adelaide","GWS",36
15193,2017-09-08,"QF","Geelong",5,10,40,"Richmond",13,13,91,"M.C.G.",-51,2017,"Finals",24,"Away","Richmond","Geelong",51
15194,2017-09-09,"EF","Sydney",19,7,121,"Essendon",8,8,56,"S.C.G.",65,2017,"Finals",24,"Home","Sydney","Essendon",65
15195,2017-09-09,"EF","Port Adelaide",10,16,76,"West Coast",12,6,78,"Adelaide Oval",-2,2017,"Finals",24,"Away","West Coast","Port Adelaide",2
15196,2017-09-15,"SF","Geelong",15,8,98,"Sydney",5,9,39,"M.C.G.",59,2017,"Finals",25,"Home","Geelong","Sydney",59
15197,2017-09-16,"SF","GWS",19,11,125,"West Coast",9,4,58,"Sydney Showground",67,2017,"Finals",25,"Home","GWS","West Coast",67
15198,2017-09-22,"PF","Adelaide",21,10,136,"Geelong",10,15,75,"Adelaide Oval",61,2017,"Finals",26,"Home","Adelaide","Geelong",61
15199,2017-09-23,"PF","Richmond",15,13,103,"GWS",9,13,67,"M.C.G.",36,2017,"Finals",26,"Home","Richmond","GWS",36
15200,2017-09-30,"GF","Adelaide",8,12,60,"Richmond",16,12,108,"M.C.G.",-48,2017,"Finals",27,"Away","Richmond","Adelaide",48
15201,2018-03-22,"R1","Richmond",17,19,121,"Carlton",15,5,95,"M.C.G.",26,2018,"Regular",1,"Home","Richmond","Carlton",26
15202,2018-03-23,"R1","Essendon",14,15,99,"Adelaide",12,15,87,"Docklands",12,2018,"Regular",1,"Home","Essendon","Adelaide",12
15203,2018-03-24,"R1","St Kilda",16,11,107,"Brisbane Lions",12,10,82,"Docklands",25,2018,"Regular",1,"Home","St Kilda","Brisbane Lions",25
15204,2018-03-24,"R1","Port Adelaide",16,14,110,"Fremantle",9,6,60,"Adelaide Oval",50,2018,"Regular",1,"Home","Port Adelaide","Fremantle",50
15205,2018-03-24,"R1","Hawthorn",15,11,101,"Collingwood",9,13,67,"M.C.G.",34,2018,"Regular",1,"Home","Hawthorn","Collingwood",34
15206,2018-03-24,"R1","Gold Coast",7,13,55,"North Melbourne",5,9,39,"Cazaly's Stadium",16,2018,"Regular",1,"Home","Gold Coast","North Melbourne",16
15207,2018-03-25,"R1","GWS",20,13,133,"Footscray",7,9,51,"Manuka Oval",82,2018,"Regular",1,"Home","GWS","Footscray",82
15208,2018-03-25,"R1","Melbourne",13,16,94,"Geelong",14,13,97,"M.C.G.",-3,2018,"Regular",1,"Away","Geelong","Melbourne",3
15209,2018-03-25,"R1","West Coast",13,8,86,"Sydney",18,7,115,"Perth Stadium",-29,2018,"Regular",1,"Away","Sydney","West Coast",29
15210,2018-03-29,"R2","Adelaide",18,10,118,"Richmond",12,10,82,"Adelaide Oval",36,2018,"Regular",2,"Home","Adelaide","Richmond",36
15211,2018-03-30,"R2","North Melbourne",13,17,95,"St Kilda",5,13,43,"Docklands",52,2018,"Regular",2,"Home","North Melbourne","St Kilda",52
15212,2018-03-31,"R2","Carlton",9,13,67,"Gold Coast",15,11,101,"Docklands",-34,2018,"Regular",2,"Away","Gold Coast","Carlton",34
15213,2018-03-31,"R2","Collingwood",12,7,79,"GWS",15,5,95,"M.C.G.",-16,2018,"Regular",2,"Away","GWS","Collingwood",16
15214,2018-03-31,"R2","Brisbane Lions",10,14,74,"Melbourne",14,16,100,"Gabba",-26,2018,"Regular",2,"Away","Melbourne","Brisbane Lions",26
15215,2018-03-31,"R2","Fremantle",16,10,106,"Essendon",14,6,90,"Perth Stadium",16,2018,"Regular",2,"Home","Fremantle","Essendon",16
15216,2018-04-01,"R2","Footscray",9,16,70,"West Coast",18,13,121,"Docklands",-51,2018,"Regular",2,"Away","West Coast","Footscray",51
15217,2018-04-01,"R2","Sydney",10,11,71,"Port Adelaide",14,10,94,"S.C.G.",-23,2018,"Regular",2,"Away","Port Adelaide","Sydney",23
15218,2018-04-02,"R2","Geelong",18,9,117,"Hawthorn",17,16,118,"M.C.G.",-1,2018,"Regular",2,"Away","Hawthorn","Geelong",1
15219,2018-04-06,"R3","Carlton",11,10,76,"Collingwood",16,4,100,"M.C.G.",-24,2018,"Regular",3,"Away","Collingwood","Carlton",24
15220,2018-04-07,"R3","Port Adelaide",14,13,97,"Brisbane Lions",14,8,92,"Adelaide Oval",5,2018,"Regular",3,"Home","Port Adelaide","Brisbane Lions",5
15221,2018-04-07,"R3","Melbourne",18,15,123,"North Melbourne",13,8,86,"M.C.G.",37,2018,"Regular",3,"Home","Melbourne","North Melbourne",37
15222,2018-04-07,"R3","Gold Coast",10,8,68,"Fremantle",13,18,96,"Perth Stadium",-28,2018,"Regular",3,"Away","Fremantle","Gold Coast",28
15223,2018-04-07,"R3","St Kilda",7,13,55,"Adelaide",15,14,104,"Docklands",-49,2018,"Regular",3,"Away","Adelaide","St Kilda",49
15224,2018-04-07,"R3","Sydney",16,7,103,"GWS",12,15,87,"S.C.G.",16,2018,"Regular",3,"Home","Sydney","GWS",16
15225,2018-04-08,"R3","Richmond",15,12,102,"Hawthorn",13,11,89,"M.C.G.",13,2018,"Regular",3,"Home","Richmond","Hawthorn",13
15226,2018-04-08,"R3","Footscray",14,20,104,"Essendon",12,11,83,"Docklands",21,2018,"Regular",3,"Home","Footscray","Essendon",21
15227,2018-04-08,"R3","West Coast",14,11,95,"Geelong",11,14,80,"Perth Stadium",15,2018,"Regular",3,"Home","West Coast","Geelong",15
15228,2018-04-13,"R4","Adelaide",9,4,58,"Collingwood",16,10,106,"Adelaide Oval",-48,2018,"Regular",4,"Away","Collingwood","Adelaide",48
15229,2018-04-14,"R4","GWS",11,16,82,"Fremantle",7,9,51,"Manuka Oval",31,2018,"Regular",4,"Home","GWS","Fremantle",31
15230,2018-04-14,"R4","Richmond",16,14,110,"Brisbane Lions",2,5,17,"M.C.G.",93,2018,"Regular",4,"Home","Richmond","Brisbane Lions",93
15231,2018-04-14,"R4","Footscray",11,13,79,"Sydney",13,8,86,"Docklands",-7,2018,"Regular",4,"Away","Sydney","Footscray",7
15232,2018-04-14,"R4","North Melbourne",18,8,116,"Carlton",4,6,30,"Bellerive Oval",86,2018,"Regular",4,"Home","North Melbourne","Carlton",86
15233,2018-04-14,"R4","West Coast",21,13,139,"Gold Coast",9,5,59,"Perth Stadium",80,2018,"Regular",4,"Home","West Coast","Gold Coast",80
15234,2018-04-15,"R4","Essendon",16,10,106,"Port Adelaide",12,12,84,"Docklands",22,2018,"Regular",4,"Home","Essendon","Port Adelaide",22
15235,2018-04-15,"R4","Hawthorn",18,7,115,"Melbourne",6,12,48,"M.C.G.",67,2018,"Regular",4,"Home","Hawthorn","Melbourne",67
15236,2018-04-15,"R4","Geelong",15,13,103,"St Kilda",7,14,56,"Kardinia Park",47,2018,"Regular",4,"Home","Geelong","St Kilda",47
15237,2018-04-20,"R5","Sydney",10,15,75,"Adelaide",12,13,85,"S.C.G.",-10,2018,"Regular",5,"Away","Adelaide","Sydney",10
15238,2018-04-21,"R5","St Kilda",10,13,73,"GWS",9,19,73,"Docklands",0,2018,"Regular",5,"Home","St Kilda","GWS",0
15239,2018-04-21,"R5","Carlton",10,9,69,"West Coast",10,19,79,"M.C.G.",-10,2018,"Regular",5,"Away","West Coast","Carlton",10
15240,2018-04-21,"R5","Port Adelaide",7,8,50,"Geelong",12,12,84,"Adelaide Oval",-34,2018,"Regular",5,"Away","Geelong","Port Adelaide",34
15241,2018-04-21,"R5","Fremantle",16,12,108,"Footscray",8,6,54,"Perth Stadium",54,2018,"Regular",5,"Home","Fremantle","Footscray",54
15242,2018-04-22,"R5","North Melbourne",14,14,98,"Hawthorn",11,4,70,"Docklands",28,2018,"Regular",5,"Home","North Melbourne","Hawthorn",28
15243,2018-04-22,"R5","Brisbane Lions",10,11,71,"Gold Coast",11,10,76,"Gabba",-5,2018,"Regular",5,"Away","Gold Coast","Brisbane Lions",5
15244,2018-04-24,"R5","Melbourne",8,8,56,"Richmond",15,12,102,"M.C.G.",-46,2018,"Regular",5,"Away","Richmond","Melbourne",46
15245,2018-04-25,"R5","Collingwood",14,17,101,"Essendon",7,10,52,"M.C.G.",49,2018,"Regular",5,"Home","Collingwood","Essendon",49
15246,2018-04-27,"R6","Footscray",11,14,80,"Carlton",8,11,59,"Docklands",21,2018,"Regular",6,"Home","Footscray","Carlton",21
15247,2018-04-28,"R6","Geelong",10,9,69,"Sydney",12,14,86,"Kardinia Park",-17,2018,"Regular",6,"Away","Sydney","Geelong",17
15248,2018-04-28,"R6","North Melbourne",10,9,69,"Port Adelaide",15,12,102,"Docklands",-33,2018,"Regular",6,"Away","Port Adelaide","North Melbourne",33
15249,2018-04-28,"R6","GWS",10,17,77,"Brisbane Lions",5,13,43,"Sydney Showground",34,2018,"Regular",6,"Home","GWS","Brisbane Lions",34
15250,2018-04-28,"R6","Hawthorn",13,11,89,"St Kilda",7,12,54,"York Park",35,2018,"Regular",6,"Home","Hawthorn","St Kilda",35
15251,2018-04-28,"R6","Adelaide",16,14,110,"Gold Coast",9,8,62,"Adelaide Oval",48,2018,"Regular",6,"Home","Adelaide","Gold Coast",48
15252,2018-04-29,"R6","Essendon",10,12,72,"Melbourne",16,12,108,"Docklands",-36,2018,"Regular",6,"Away","Melbourne","Essendon",36
15253,2018-04-29,"R6","Collingwood",10,10,70,"Richmond",16,17,113,"M.C.G.",-43,2018,"Regular",6,"Away","Richmond","Collingwood",43
15254,2018-04-29,"R6","Fremantle",12,9,81,"West Coast",13,11,89,"Perth Stadium",-8,2018,"Regular",6,"Away","West Coast","Fremantle",8
15255,2018-05-04,"R7","Geelong",14,9,93,"GWS",4,8,32,"Kardinia Park",61,2018,"Regular",7,"Home","Geelong","GWS",61
15256,2018-05-05,"R7","Footscray",11,15,81,"Gold Coast",10,12,72,"Eureka Stadium",9,2018,"Regular",7,"Home","Footscray","Gold Coast",9
15257,2018-05-05,"R7","Essendon",10,7,67,"Hawthorn",13,12,90,"M.C.G.",-23,2018,"Regular",7,"Away","Hawthorn","Essendon",23
15258,2018-05-05,"R7","West Coast",16,6,102,"Port Adelaide",9,6,60,"Perth Stadium",42,2018,"Regular",7,"Home","West Coast","Port Adelaide",42
15259,2018-05-05,"R7","Sydney",9,12,66,"North Melbourne",9,14,68,"S.C.G.",-2,2018,"Regular",7,"Away","North Melbourne","Sydney",2
15260,2018-05-05,"R7","Adelaide",19,11,125,"Carlton",10,10,70,"Adelaide Oval",55,2018,"Regular",7,"Home","Adelaide","Carlton",55
15261,2018-05-06,"R7","Richmond",15,20,110,"Fremantle",4,9,33,"M.C.G.",77,2018,"Regular",7,"Home","Richmond","Fremantle",77
15262,2018-05-06,"R7","St Kilda",9,13,67,"Melbourne",16,10,106,"Docklands",-39,2018,"Regular",7,"Away","Melbourne","St Kilda",39
15263,2018-05-06,"R7","Brisbane Lions",18,6,114,"Collingwood",19,7,121,"Gabba",-7,2018,"Regular",7,"Away","Collingwood","Brisbane Lions",7
15264,2018-05-11,"R8","Hawthorn",10,11,71,"Sydney",12,7,79,"M.C.G.",-8,2018,"Regular",8,"Away","Sydney","Hawthorn",8
15265,2018-05-12,"R8","GWS",8,13,61,"West Coast",12,14,86,"Sydney Showground",-25,2018,"Regular",8,"Away","West Coast","GWS",25
15266,2018-05-12,"R8","Carlton",14,7,91,"Essendon",10,18,78,"M.C.G.",13,2018,"Regular",8,"Home","Carlton","Essendon",13
15267,2018-05-12,"R8","Gold Coast",11,11,77,"Melbourne",21,20,146,"Gabba",-69,2018,"Regular",8,"Away","Melbourne","Gold Coast",69
15268,2018-05-12,"R8","Port Adelaide",14,11,95,"Adelaide",14,6,90,"Adelaide Oval",5,2018,"Regular",8,"Home","Port Adelaide","Adelaide",5
15269,2018-05-12,"R8","Footscray",16,11,107,"Brisbane Lions",14,9,93,"Docklands",14,2018,"Regular",8,"Home","Footscray","Brisbane Lions",14
15270,2018-05-12,"R8","Fremantle",13,11,89,"St Kilda",8,11,59,"Perth Stadium",30,2018,"Regular",8,"Home","Fremantle","St Kilda",30
15271,2018-05-13,"R8","North Melbourne",11,6,72,"Richmond",12,10,82,"Docklands",-10,2018,"Regular",8,"Away","Richmond","North Melbourne",10
15272,2018-05-13,"R8","Collingwood",5,15,45,"Geelong",9,12,66,"M.C.G.",-21,2018,"Regular",8,"Away","Geelong","Collingwood",21
15273,2018-05-18,"R9","Adelaide",9,9,63,"Footscray",2,14,26,"Adelaide Oval",37,2018,"Regular",9,"Home","Adelaide","Footscray",37
15274,2018-05-19,"R9","Gold Coast",6,6,42,"Port Adelaide",11,16,82,"Jiangwan Stadium",-40,2018,"Regular",9,"Away","Port Adelaide","Gold Coast",40
15275,2018-05-19,"R9","North Melbourne",17,10,112,"GWS",9,15,69,"Bellerive Oval",43,2018,"Regular",9,"Home","North Melbourne","GWS",43
15276,2018-05-19,"R9","Essendon",12,12,84,"Geelong",7,8,50,"M.C.G.",34,2018,"Regular",9,"Home","Essendon","Geelong",34
15277,2018-05-19,"R9","St Kilda",10,12,72,"Collingwood",15,10,100,"Docklands",-28,2018,"Regular",9,"Away","Collingwood","St Kilda",28
15278,2018-05-19,"R9","Sydney",17,9,111,"Fremantle",7,10,52,"S.C.G.",59,2018,"Regular",9,"Home","Sydney","Fremantle",59
15279,2018-05-20,"R9","Carlton",7,8,50,"Melbourne",25,9,159,"M.C.G.",-109,2018,"Regular",9,"Away","Melbourne","Carlton",109
15280,2018-05-20,"R9","Brisbane Lions",20,9,129,"Hawthorn",11,7,73,"Gabba",56,2018,"Regular",9,"Home","Brisbane Lions","Hawthorn",56
15281,2018-05-20,"R9","West Coast",20,10,130,"Richmond",12,11,83,"Perth Stadium",47,2018,"Regular",9,"Home","West Coast","Richmond",47
15282,2018-05-25,"R10","Collingwood",13,12,90,"Footscray",8,7,55,"Docklands",35,2018,"Regular",10,"Home","Collingwood","Footscray",35
15283,2018-05-26,"R10","Richmond",15,15,105,"St Kilda",12,5,77,"M.C.G.",28,2018,"Regular",10,"Home","Richmond","St Kilda",28
15284,2018-05-26,"R10","Brisbane Lions",6,13,49,"Sydney",10,7,67,"Gabba",-18,2018,"Regular",10,"Away","Sydney","Brisbane Lions",18
15285,2018-05-26,"R10","Geelong",11,7,73,"Carlton",5,15,45,"Kardinia Park",28,2018,"Regular",10,"Home","Geelong","Carlton",28
15286,2018-05-26,"R10","GWS",8,12,60,"Essendon",14,11,95,"Sydney Showground",-35,2018,"Regular",10,"Away","Essendon","GWS",35
15287,2018-05-27,"R10","Hawthorn",9,6,60,"West Coast",11,9,75,"Docklands",-15,2018,"Regular",10,"Away","West Coast","Hawthorn",15
15288,2018-05-27,"R10","Melbourne",23,8,146,"Adelaide",8,7,55,"Traeger Park",91,2018,"Regular",10,"Home","Melbourne","Adelaide",91
15289,2018-05-27,"R10","Fremantle",8,10,58,"North Melbourne",12,14,86,"Perth Stadium",-28,2018,"Regular",10,"Away","North Melbourne","Fremantle",28
15290,2018-06-01,"R11","Sydney",13,13,91,"Carlton",9,7,61,"S.C.G.",30,2018,"Regular",11,"Home","Sydney","Carlton",30
15291,2018-06-02,"R11","Footscray",7,9,51,"Melbourne",15,10,100,"Docklands",-49,2018,"Regular",11,"Away","Melbourne","Footscray",49
15292,2018-06-02,"R11","Hawthorn",9,10,64,"Port Adelaide",9,7,61,"York Park",3,2018,"Regular",11,"Home","Hawthorn","Port Adelaide",3
15293,2018-06-02,"R11","Gold Coast",4,12,36,"Geelong",17,19,121,"Carrara",-85,2018,"Regular",11,"Away","Geelong","Gold Coast",85
15294,2018-06-02,"R11","Essendon",6,7,43,"Richmond",17,12,114,"M.C.G.",-71,2018,"Regular",11,"Away","Richmond","Essendon",71
15295,2018-06-02,"R11","West Coast",16,5,101,"St Kilda",14,4,88,"Perth Stadium",13,2018,"Regular",11,"Home","West Coast","St Kilda",13
15296,2018-06-03,"R11","North Melbourne",21,15,141,"Brisbane Lions",12,15,87,"Docklands",54,2018,"Regular",11,"Home","North Melbourne","Brisbane Lions",54
15297,2018-06-03,"R11","Collingwood",21,12,138,"Fremantle",12,5,77,"M.C.G.",61,2018,"Regular",11,"Home","Collingwood","Fremantle",61
15298,2018-06-03,"R11","Adelaide",11,15,81,"GWS",14,13,97,"Adelaide Oval",-16,2018,"Regular",11,"Away","GWS","Adelaide",16
15299,2018-06-08,"R12","Port Adelaide",10,12,72,"Richmond",8,10,58,"Adelaide Oval",14,2018,"Regular",12,"Home","Port Adelaide","Richmond",14
15300,2018-06-09,"R12","Geelong",14,12,96,"North Melbourne",8,11,59,"Kardinia Park",37,2018,"Regular",12,"Home","Geelong","North Melbourne",37
15301,2018-06-09,"R12","GWS",20,14,134,"Gold Coast",4,2,26,"Sydney Showground",108,2018,"Regular",12,"Home","GWS","Gold Coast",108
15302,2018-06-09,"R12","St Kilda",7,13,55,"Sydney",19,12,126,"Docklands",-71,2018,"Regular",12,"Away","Sydney","St Kilda",71
15303,2018-06-10,"R12","Brisbane Lions",8,14,62,"Essendon",12,12,84,"Gabba",-22,2018,"Regular",12,"Away","Essendon","Brisbane Lions",22
15304,2018-06-10,"R12","Fremantle",10,11,71,"Adelaide",9,14,68,"Perth Stadium",3,2018,"Regular",12,"Home","Fremantle","Adelaide",3
15305,2018-06-11,"R12","Melbourne",14,7,91,"Collingwood",20,13,133,"M.C.G.",-42,2018,"Regular",12,"Away","Collingwood","Melbourne",42
15306,2018-06-14,"R13","Port Adelaide",20,12,132,"Footscray",11,9,75,"Adelaide Oval",57,2018,"Regular",13,"Home","Port Adelaide","Footscray",57
15307,2018-06-15,"R13","Sydney",10,12,72,"West Coast",7,15,57,"S.C.G.",15,2018,"Regular",13,"Home","Sydney","West Coast",15
15308,2018-06-16,"R13","Carlton",6,10,46,"Fremantle",15,13,103,"Docklands",-57,2018,"Regular",13,"Away","Fremantle","Carlton",57
15309,2018-06-16,"R13","Gold Coast",11,12,78,"St Kilda",11,14,80,"Carrara",-2,2018,"Regular",13,"Away","St Kilda","Gold Coast",2
15310,2018-06-16,"R13","Hawthorn",12,16,88,"Adelaide",4,8,32,"M.C.G.",56,2018,"Regular",13,"Home","Hawthorn","Adelaide",56
15311,2018-06-17,"R13","Geelong",9,11,65,"Richmond",12,11,83,"M.C.G.",-18,2018,"Regular",13,"Away","Richmond","Geelong",18
15312,2018-06-21,"R14","West Coast",6,16,52,"Essendon",12,8,80,"Perth Stadium",-28,2018,"Regular",14,"Away","Essendon","West Coast",28
15313,2018-06-22,"R14","Port Adelaide",11,9,75,"Melbourne",9,11,65,"Adelaide Oval",10,2018,"Regular",14,"Home","Port Adelaide","Melbourne",10
15314,2018-06-23,"R14","Hawthorn",13,18,96,"Gold Coast",5,13,43,"York Park",53,2018,"Regular",14,"Home","Hawthorn","Gold Coast",53
15315,2018-06-23,"R14","Brisbane Lions",12,10,82,"GWS",16,13,109,"Gabba",-27,2018,"Regular",14,"Away","GWS","Brisbane Lions",27
15316,2018-06-23,"R14","Footscray",11,9,75,"North Melbourne",12,5,77,"Docklands",-2,2018,"Regular",14,"Away","North Melbourne","Footscray",2
15317,2018-06-24,"R14","Collingwood",11,13,79,"Carlton",9,5,59,"M.C.G.",20,2018,"Regular",14,"Home","Collingwood","Carlton",20
15318,2018-06-28,"R15","Richmond",14,9,93,"Sydney",11,1,67,"Docklands",26,2018,"Regular",15,"Home","Richmond","Sydney",26
15319,2018-06-29,"R15","Footscray",16,7,103,"Geelong",15,11,101,"Docklands",2,2018,"Regular",15,"Home","Footscray","Geelong",2
15320,2018-06-30,"R15","Carlton",10,9,69,"Port Adelaide",13,12,90,"M.C.G.",-21,2018,"Regular",15,"Away","Port Adelaide","Carlton",21
15321,2018-06-30,"R15","Adelaide",12,16,88,"West Coast",12,6,78,"Adelaide Oval",10,2018,"Regular",15,"Home","Adelaide","West Coast",10
15322,2018-06-30,"R15","Gold Coast",8,12,60,"Collingwood",14,15,99,"Carrara",-39,2018,"Regular",15,"Away","Collingwood","Gold Coast",39
15323,2018-06-30,"R15","GWS",13,17,95,"Hawthorn",13,6,84,"Sydney Showground",11,2018,"Regular",15,"Home","GWS","Hawthorn",11
15324,2018-07-01,"R15","Melbourne",18,9,117,"St Kilda",18,11,119,"M.C.G.",-2,2018,"Regular",15,"Away","St Kilda","Melbourne",2
15325,2018-07-01,"R15","Essendon",19,11,125,"North Melbourne",16,12,108,"Docklands",17,2018,"Regular",15,"Home","Essendon","North Melbourne",17
15326,2018-07-01,"R15","Fremantle",9,10,64,"Brisbane Lions",18,11,119,"Perth Stadium",-55,2018,"Regular",15,"Away","Brisbane Lions","Fremantle",55
15327,2018-07-05,"R16","Sydney",9,5,59,"Geelong",8,23,71,"S.C.G.",-12,2018,"Regular",16,"Away","Geelong","Sydney",12
15328,2018-07-06,"R16","Richmond",15,13,103,"Adelaide",8,8,56,"M.C.G.",47,2018,"Regular",16,"Home","Richmond","Adelaide",47
15329,2018-07-07,"R16","Brisbane Lions",18,12,120,"Carlton",7,13,55,"Gabba",65,2018,"Regular",16,"Home","Brisbane Lions","Carlton",65
15330,2018-07-07,"R16","Port Adelaide",12,14,86,"St Kilda",7,8,50,"Adelaide Oval",36,2018,"Regular",16,"Home","Port Adelaide","St Kilda",36
15331,2018-07-07,"R16","Footscray",9,5,59,"Hawthorn",19,8,122,"Docklands",-63,2018,"Regular",16,"Away","Hawthorn","Footscray",63
15332,2018-07-07,"R16","Melbourne",13,24,102,"Fremantle",7,6,48,"Marrara Oval",54,2018,"Regular",16,"Home","Melbourne","Fremantle",54
15333,2018-07-08,"R16","North Melbourne",14,11,95,"Gold Coast",8,10,58,"Docklands",37,2018,"Regular",16,"Home","North Melbourne","Gold Coast",37
15334,2018-07-08,"R16","Essendon",9,8,62,"Collingwood",12,6,78,"M.C.G.",-16,2018,"Regular",16,"Away","Collingwood","Essendon",16
15335,2018-07-08,"R16","West Coast",13,8,86,"GWS",10,15,75,"Perth Stadium",11,2018,"Regular",16,"Home","West Coast","GWS",11
15336,2018-07-12,"R17","Adelaide",16,16,112,"Geelong",14,13,97,"Adelaide Oval",15,2018,"Regular",17,"Home","Adelaide","Geelong",15
15337,2018-07-13,"R17","St Kilda",16,20,116,"Carlton",7,10,52,"Docklands",64,2018,"Regular",17,"Home","St Kilda","Carlton",64
15338,2018-07-14,"R17","Hawthorn",9,11,65,"Brisbane Lions",15,8,98,"York Park",-33,2018,"Regular",17,"Away","Brisbane Lions","Hawthorn",33
15339,2018-07-14,"R17","Melbourne",18,11,119,"Footscray",10,9,69,"M.C.G.",50,2018,"Regular",17,"Home","Melbourne","Footscray",50
15340,2018-07-14,"R17","Gold Coast",6,15,51,"Essendon",13,17,95,"Carrara",-44,2018,"Regular",17,"Away","Essendon","Gold Coast",44
15341,2018-07-14,"R17","GWS",11,13,79,"Richmond",10,17,77,"Sydney Showground",2,2018,"Regular",17,"Home","GWS","Richmond",2
15342,2018-07-15,"R17","Collingwood",9,13,67,"West Coast",15,12,102,"M.C.G.",-35,2018,"Regular",17,"Away","West Coast","Collingwood",35
15343,2018-07-15,"R17","North Melbourne",15,8,98,"Sydney",16,8,104,"Docklands",-6,2018,"Regular",17,"Away","Sydney","North Melbourne",6
15344,2018-07-15,"R17","Fremantle",8,11,59,"Port Adelaide",7,8,50,"Perth Stadium",9,2018,"Regular",17,"Home","Fremantle","Port Adelaide",9
15345,2018-07-20,"R18","St Kilda",8,9,57,"Richmond",16,15,111,"Docklands",-54,2018,"Regular",18,"Away","Richmond","St Kilda",54
15346,2018-07-21,"R18","Collingwood",20,10,130,"North Melbourne",9,10,64,"M.C.G.",66,2018,"Regular",18,"Home","Collingwood","North Melbourne",66
15347,2018-07-21,"R18","Sydney",8,16,64,"Gold Coast",12,16,88,"S.C.G.",-24,2018,"Regular",18,"Away","Gold Coast","Sydney",24
15348,2018-07-21,"R18","Essendon",13,21,99,"Fremantle",11,4,70,"Docklands",29,2018,"Regular",18,"Home","Essendon","Fremantle",29
15349,2018-07-21,"R18","Brisbane Lions",13,10,88,"Adelaide",13,15,93,"Gabba",-5,2018,"Regular",18,"Away","Adelaide","Brisbane Lions",5
15350,2018-07-21,"R18","Geelong",16,4,100,"Melbourne",14,14,98,"Kardinia Park",2,2018,"Regular",18,"Home","Geelong","Melbourne",2
15351,2018-07-22,"R18","Carlton",7,10,52,"Hawthorn",18,16,124,"Docklands",-72,2018,"Regular",18,"Away","Hawthorn","Carlton",72
15352,2018-07-22,"R18","West Coast",14,16,100,"Footscray",6,10,46,"Perth Stadium",54,2018,"Regular",18,"Home","West Coast","Footscray",54
15353,2018-07-22,"R18","Port Adelaide",8,10,58,"GWS",11,14,80,"Adelaide Oval",-22,2018,"Regular",18,"Away","GWS","Port Adelaide",22
15354,2018-07-27,"R19","Essendon",15,19,109,"Sydney",10,6,66,"Docklands",43,2018,"Regular",19,"Home","Essendon","Sydney",43
15355,2018-07-28,"R19","Richmond",16,9,105,"Collingwood",12,5,77,"M.C.G.",28,2018,"Regular",19,"Home","Richmond","Collingwood",28
15356,2018-07-28,"R19","Geelong",18,12,120,"Brisbane Lions",11,12,78,"Kardinia Park",42,2018,"Regular",19,"Home","Geelong","Brisbane Lions",42
15357,2018-07-28,"R19","GWS",13,8,86,"St Kilda",8,13,61,"Sydney Showground",25,2018,"Regular",19,"Home","GWS","St Kilda",25
15358,2018-07-28,"R19","Gold Coast",5,14,44,"Carlton",12,7,79,"Carrara",-35,2018,"Regular",19,"Away","Carlton","Gold Coast",35
15359,2018-07-28,"R19","Adelaide",10,17,77,"Melbourne",13,12,90,"Adelaide Oval",-13,2018,"Regular",19,"Away","Melbourne","Adelaide",13
15360,2018-07-29,"R19","North Melbourne",12,9,81,"West Coast",6,5,41,"Bellerive Oval",40,2018,"Regular",19,"Home","North Melbourne","West Coast",40
15361,2018-07-29,"R19","Footscray",5,4,34,"Port Adelaide",11,12,78,"Eureka Stadium",-44,2018,"Regular",19,"Away","Port Adelaide","Footscray",44
15362,2018-07-29,"R19","Fremantle",7,11,53,"Hawthorn",17,10,112,"Perth Stadium",-59,2018,"Regular",19,"Away","Hawthorn","Fremantle",59
15363,2018-08-03,"R20","Richmond",12,13,85,"Geelong",12,10,82,"M.C.G.",3,2018,"Regular",20,"Home","Richmond","Geelong",3
15364,2018-08-04,"R20","Hawthorn",16,11,107,"Essendon",16,7,103,"M.C.G.",4,2018,"Regular",20,"Home","Hawthorn","Essendon",4
15365,2018-08-04,"R20","Brisbane Lions",16,8,104,"North Melbourne",16,11,107,"Gabba",-3,2018,"Regular",20,"Away","North Melbourne","Brisbane Lions",3
15366,2018-08-04,"R20","Adelaide",13,18,96,"Port Adelaide",14,9,93,"Adelaide Oval",3,2018,"Regular",20,"Home","Adelaide","Port Adelaide",3
15367,2018-08-04,"R20","Sydney",11,7,73,"Collingwood",10,11,71,"S.C.G.",2,2018,"Regular",20,"Home","Sydney","Collingwood",2
15368,2018-08-04,"R20","St Kilda",9,14,68,"Footscray",15,13,103,"Docklands",-35,2018,"Regular",20,"Away","Footscray","St Kilda",35
15369,2018-08-05,"R20","Carlton",7,4,46,"GWS",23,13,151,"Docklands",-105,2018,"Regular",20,"Away","GWS","Carlton",105
15370,2018-08-05,"R20","Melbourne",21,17,143,"Gold Coast",7,5,47,"M.C.G.",96,2018,"Regular",20,"Home","Melbourne","Gold Coast",96
15371,2018-08-05,"R20","West Coast",21,16,142,"Fremantle",13,6,84,"Perth Stadium",58,2018,"Regular",20,"Home","West Coast","Fremantle",58
15372,2018-08-10,"R21","Essendon",18,14,122,"St Kilda",11,13,79,"Docklands",43,2018,"Regular",21,"Home","Essendon","St Kilda",43
15373,2018-08-11,"R21","Hawthorn",10,11,71,"Geelong",8,12,60,"M.C.G.",11,2018,"Regular",21,"Home","Hawthorn","Geelong",11
15374,2018-08-11,"R21","Gold Coast",7,9,51,"Richmond",19,11,125,"Carrara",-74,2018,"Regular",21,"Away","Richmond","Gold Coast",74
15375,2018-08-11,"R21","Port Adelaide",9,4,58,"West Coast",9,8,62,"Adelaide Oval",-4,2018,"Regular",21,"Away","West Coast","Port Adelaide",4
15376,2018-08-11,"R21","GWS",15,16,106,"Adelaide",13,14,92,"Manuka Oval",14,2018,"Regular",21,"Home","GWS","Adelaide",14
15377,2018-08-11,"R21","Collingwood",14,20,104,"Brisbane Lions",11,7,73,"Docklands",31,2018,"Regular",21,"Home","Collingwood","Brisbane Lions",31
15378,2018-08-12,"R21","North Melbourne",12,13,85,"Footscray",13,14,92,"Docklands",-7,2018,"Regular",21,"Away","Footscray","North Melbourne",7
15379,2018-08-12,"R21","Melbourne",10,18,78,"Sydney",13,9,87,"M.C.G.",-9,2018,"Regular",21,"Away","Sydney","Melbourne",9
15380,2018-08-12,"R21","Fremantle",15,11,101,"Carlton",10,12,72,"Perth Stadium",29,2018,"Regular",21,"Home","Fremantle","Carlton",29
15381,2018-08-17,"R22","Richmond",12,9,81,"Essendon",11,7,73,"M.C.G.",8,2018,"Regular",22,"Home","Richmond","Essendon",8
15382,2018-08-18,"R22","Collingwood",17,13,115,"Port Adelaide",10,4,64,"M.C.G.",51,2018,"Regular",22,"Home","Collingwood","Port Adelaide",51
15383,2018-08-18,"R22","Geelong",24,14,158,"Fremantle",3,7,25,"Kardinia Park",133,2018,"Regular",22,"Home","Geelong","Fremantle",133
15384,2018-08-18,"R22","GWS",8,12,60,"Sydney",11,14,80,"Sydney Showground",-20,2018,"Regular",22,"Away","Sydney","GWS",20
15385,2018-08-18,"R22","St Kilda",11,10,76,"Hawthorn",12,8,80,"Docklands",-4,2018,"Regular",22,"Away","Hawthorn","St Kilda",4
15386,2018-08-18,"R22","Gold Coast",11,8,74,"Brisbane Lions",10,18,78,"Carrara",-4,2018,"Regular",22,"Away","Brisbane Lions","Gold Coast",4
15387,2018-08-19,"R22","Carlton",7,7,49,"Footscray",10,6,66,"Docklands",-17,2018,"Regular",22,"Away","Footscray","Carlton",17
15388,2018-08-19,"R22","West Coast",14,7,91,"Melbourne",16,12,108,"Perth Stadium",-17,2018,"Regular",22,"Away","Melbourne","West Coast",17
15389,2018-08-19,"R22","Adelaide",12,14,86,"North Melbourne",11,11,77,"Adelaide Oval",9,2018,"Regular",22,"Home","Adelaide","North Melbourne",9
15390,2018-08-24,"R23","Port Adelaide",13,11,89,"Essendon",17,9,111,"Adelaide Oval",-22,2018,"Regular",23,"Away","Essendon","Port Adelaide",22
15391,2018-08-25,"R23","Geelong",22,10,142,"Gold Coast",5,10,40,"Kardinia Park",102,2018,"Regular",23,"Home","Geelong","Gold Coast",102
15392,2018-08-25,"R23","Richmond",15,8,98,"Footscray",14,11,95,"M.C.G.",3,2018,"Regular",23,"Home","Richmond","Footscray",3
15393,2018-08-25,"R23","Fremantle",9,13,67,"Collingwood",11,10,76,"Perth Stadium",-9,2018,"Regular",23,"Away","Collingwood","Fremantle",9
15394,2018-08-25,"R23","Carlton",8,13,61,"Adelaide",26,9,165,"Docklands",-104,2018,"Regular",23,"Away","Adelaide","Carlton",104
15395,2018-08-25,"R23","Sydney",10,14,74,"Hawthorn",12,11,83,"S.C.G.",-9,2018,"Regular",23,"Away","Hawthorn","Sydney",9
15396,2018-08-26,"R23","Brisbane Lions",11,6,72,"West Coast",14,14,98,"Gabba",-26,2018,"Regular",23,"Away","West Coast","Brisbane Lions",26
15397,2018-08-26,"R23","Melbourne",15,12,102,"GWS",8,9,57,"M.C.G.",45,2018,"Regular",23,"Home","Melbourne","GWS",45
15398,2018-08-26,"R23","St Kilda",14,10,94,"North Melbourne",17,15,117,"Docklands",-23,2018,"Regular",23,"Away","North Melbourne","St Kilda",23
15399,2018-09-06,"QF","Richmond",13,17,95,"Hawthorn",9,10,64,"M.C.G.",31,2018,"Finals",24,"Home","Richmond","Hawthorn",31
15400,2018-09-07,"EF","Melbourne",10,15,75,"Geelong",6,10,46,"M.C.G.",29,2018,"Finals",24,"Home","Melbourne","Geelong",29
15401,2018-09-08,"EF","Sydney",4,6,30,"GWS",10,19,79,"S.C.G.",-49,2018,"Finals",24,"Away","GWS","Sydney",49
15402,2018-09-08,"QF","West Coast",12,14,86,"Collingwood",10,10,70,"Perth Stadium",16,2018,"Finals",24,"Home","West Coast","Collingwood",16
15403,2018-09-14,"SF","Hawthorn",10,11,71,"Melbourne",16,8,104,"M.C.G.",-33,2018,"Finals",25,"Away","Melbourne","Hawthorn",33
15404,2018-09-15,"SF","Collingwood",9,15,69,"GWS",9,5,59,"M.C.G.",10,2018,"Finals",25,"Home","Collingwood","GWS",10
15405,2018-09-21,"PF","Richmond",8,10,58,"Collingwood",15,7,97,"M.C.G.",-39,2018,"Finals",26,"Away","Collingwood","Richmond",39
15406,2018-09-22,"PF","West Coast",18,13,121,"Melbourne",7,13,55,"Perth Stadium",66,2018,"Finals",26,"Home","West Coast","Melbourne",66
15407,2018-09-29,"GF","West Coast",11,13,79,"Collingwood",11,8,74,"M.C.G.",5,2018,"Finals",27,"Home","West Coast","Collingwood",5
15408,2019-03-21,"R1","Carlton",9,10,64,"Richmond",14,13,97,"M.C.G.",-33,2019,"Regular",1,"Away","Richmond","Carlton",33
15409,2019-03-22,"R1","Collingwood",9,11,65,"Geelong",10,12,72,"M.C.G.",-7,2019,"Regular",1,"Away","Geelong","Collingwood",7
15410,2019-03-23,"R1","Melbourne",9,7,61,"Port Adelaide",12,15,87,"M.C.G.",-26,2019,"Regular",1,"Away","Port Adelaide","Melbourne",26
15411,2019-03-23,"R1","Adelaide",7,13,55,"Hawthorn",12,15,87,"Adelaide Oval",-32,2019,"Regular",1,"Away","Hawthorn","Adelaide",32
15412,2019-03-23,"R1","Footscray",11,16,82,"Sydney",9,11,65,"Docklands",17,2019,"Regular",1,"Home","Footscray","Sydney",17
15413,2019-03-23,"R1","Brisbane Lions",15,12,102,"West Coast",8,10,58,"Gabba",44,2019,"Regular",1,"Home","Brisbane Lions","West Coast",44
15414,2019-03-24,"R1","St Kilda",13,7,85,"Gold Coast",13,6,84,"Docklands",1,2019,"Regular",1,"Home","St Kilda","Gold Coast",1
15415,2019-03-24,"R1","GWS",16,16,112,"Essendon",5,10,40,"Sydney Showground",72,2019,"Regular",1,"Home","GWS","Essendon",72
15416,2019-03-24,"R1","Fremantle",21,15,141,"North Melbourne",9,5,59,"Perth Stadium",82,2019,"Regular",1,"Home","Fremantle","North Melbourne",82
15417,2019-03-28,"R2","Richmond",10,6,66,"Collingwood",17,8,110,"M.C.G.",-44,2019,"Regular",2,"Away","Collingwood","Richmond",44
15418,2019-03-29,"R2","Sydney",8,14,62,"Adelaide",12,16,88,"S.C.G.",-26,2019,"Regular",2,"Away","Adelaide","Sydney",26
15419,2019-03-30,"R2","Port Adelaide",13,10,88,"Carlton",11,6,72,"Adelaide Oval",16,2019,"Regular",2,"Home","Port Adelaide","Carlton",16
15420,2019-03-30,"R2","Essendon",9,11,65,"St Kilda",10,16,76,"Docklands",-11,2019,"Regular",2,"Away","St Kilda","Essendon",11
15421,2019-03-30,"R2","Geelong",20,6,126,"Melbourne",6,10,46,"Kardinia Park",80,2019,"Regular",2,"Home","Geelong","Melbourne",80
15422,2019-03-30,"R2","West Coast",16,8,104,"GWS",7,10,52,"Perth Stadium",52,2019,"Regular",2,"Home","West Coast","GWS",52
15423,2019-03-31,"R2","North Melbourne",13,9,87,"Brisbane Lions",16,11,107,"Docklands",-20,2019,"Regular",2,"Away","Brisbane Lions","North Melbourne",20
15424,2019-03-31,"R2","Hawthorn",13,9,87,"Footscray",16,10,106,"M.C.G.",-19,2019,"Regular",2,"Away","Footscray","Hawthorn",19
15425,2019-03-31,"R2","Gold Coast",7,19,61,"Fremantle",8,10,58,"Carrara",3,2019,"Regular",2,"Home","Gold Coast","Fremantle",3
15426,2019-04-04,"R3","Adelaide",10,15,75,"Geelong",14,15,99,"Adelaide Oval",-24,2019,"Regular",3,"Away","Geelong","Adelaide",24
15427,2019-04-05,"R3","Melbourne",18,4,112,"Essendon",20,10,130,"M.C.G.",-18,2019,"Regular",3,"Away","Essendon","Melbourne",18
15428,2019-04-06,"R3","Carlton",10,14,74,"Sydney",14,9,93,"Docklands",-19,2019,"Regular",3,"Away","Sydney","Carlton",19
15429,2019-04-06,"R3","GWS",19,11,125,"Richmond",10,16,76,"Sydney Showground",49,2019,"Regular",3,"Home","GWS","Richmond",49
15430,2019-04-06,"R3","Collingwood",11,10,76,"West Coast",15,8,98,"M.C.G.",-22,2019,"Regular",3,"Away","West Coast","Collingwood",22
15431,2019-04-06,"R3","Brisbane Lions",16,11,107,"Port Adelaide",13,12,90,"Gabba",17,2019,"Regular",3,"Home","Brisbane Lions","Port Adelaide",17
15432,2019-04-07,"R3","Footscray",9,14,68,"Gold Coast",10,13,73,"Docklands",-5,2019,"Regular",3,"Away","Gold Coast","Footscray",5
15433,2019-04-07,"R3","Hawthorn",13,9,87,"North Melbourne",10,11,71,"M.C.G.",16,2019,"Regular",3,"Home","Hawthorn","North Melbourne",16
15434,2019-04-07,"R3","Fremantle",11,5,71,"St Kilda",9,12,66,"Perth Stadium",5,2019,"Regular",3,"Home","Fremantle","St Kilda",5
15435,2019-04-11,"R4","Sydney",11,12,78,"Melbourne",15,10,100,"S.C.G.",-22,2019,"Regular",4,"Away","Melbourne","Sydney",22
15436,2019-04-12,"R4","Collingwood",11,12,78,"Footscray",9,10,64,"M.C.G.",14,2019,"Regular",4,"Home","Collingwood","Footscray",14
15437,2019-04-13,"R4","Geelong",11,9,75,"GWS",11,13,79,"Kardinia Park",-4,2019,"Regular",4,"Away","GWS","Geelong",4
15438,2019-04-13,"R4","Essendon",17,10,112,"Brisbane Lions",9,11,65,"M.C.G.",47,2019,"Regular",4,"Home","Essendon","Brisbane Lions",47
15439,2019-04-13,"R4","Port Adelaide",14,8,92,"Richmond",15,9,99,"Adelaide Oval",-7,2019,"Regular",4,"Away","Richmond","Port Adelaide",7
15440,2019-04-13,"R4","North Melbourne",9,17,71,"Adelaide",8,11,59,"Docklands",12,2019,"Regular",4,"Home","North Melbourne","Adelaide",12
15441,2019-04-13,"R4","West Coast",10,9,69,"Fremantle",7,14,56,"Perth Stadium",13,2019,"Regular",4,"Home","West Coast","Fremantle",13
15442,2019-04-14,"R4","Gold Coast",8,11,59,"Carlton",8,9,57,"Carrara",2,2019,"Regular",4,"Home","Gold Coast","Carlton",2
15443,2019-04-14,"R4","St Kilda",10,14,74,"Hawthorn",10,9,69,"Docklands",5,2019,"Regular",4,"Home","St Kilda","Hawthorn",5
15444,2019-04-18,"R5","Brisbane Lions",8,13,61,"Collingwood",18,15,123,"Gabba",-62,2019,"Regular",5,"Away","Collingwood","Brisbane Lions",62
15445,2019-04-19,"R5","North Melbourne",7,16,58,"Essendon",17,14,116,"Docklands",-58,2019,"Regular",5,"Away","Essendon","North Melbourne",58
15446,2019-04-19,"R5","West Coast",8,5,53,"Port Adelaide",13,17,95,"Perth Stadium",-42,2019,"Regular",5,"Away","Port Adelaide","West Coast",42
15447,2019-04-20,"R5","GWS",11,16,82,"Fremantle",16,10,106,"Manuka Oval",-24,2019,"Regular",5,"Away","Fremantle","GWS",24
15448,2019-04-20,"R5","Melbourne",7,13,55,"St Kilda",15,5,95,"M.C.G.",-40,2019,"Regular",5,"Away","St Kilda","Melbourne",40
15449,2019-04-20,"R5","Richmond",13,11,89,"Sydney",10,7,67,"Docklands",22,2019,"Regular",5,"Home","Richmond","Sydney",22
15450,2019-04-21,"R5","Footscray",7,15,57,"Carlton",15,11,101,"Docklands",-44,2019,"Regular",5,"Away","Carlton","Footscray",44
15451,2019-04-21,"R5","Adelaide",18,11,119,"Gold Coast",6,10,46,"Adelaide Oval",73,2019,"Regular",5,"Home","Adelaide","Gold Coast",73
15452,2019-04-22,"R5","Hawthorn",13,12,90,"Geelong",17,11,113,"M.C.G.",-23,2019,"Regular",5,"Away","Geelong","Hawthorn",23
15453,2019-04-24,"R6","Richmond",12,13,85,"Melbourne",6,6,42,"M.C.G.",43,2019,"Regular",6,"Home","Richmond","Melbourne",43
15454,2019-04-25,"R6","Essendon",10,9,69,"Collingwood",10,13,73,"M.C.G.",-4,2019,"Regular",6,"Away","Collingwood","Essendon",4
15455,2019-04-26,"R6","Port Adelaide",12,16,88,"North Melbourne",11,6,72,"Adelaide Oval",16,2019,"Regular",6,"Home","Port Adelaide","North Melbourne",16
15456,2019-04-27,"R6","Gold Coast",9,8,62,"Brisbane Lions",16,15,111,"Carrara",-49,2019,"Regular",6,"Away","Brisbane Lions","Gold Coast",49
15457,2019-04-27,"R6","St Kilda",10,8,68,"Adelaide",15,7,97,"Docklands",-29,2019,"Regular",6,"Away","Adelaide","St Kilda",29
15458,2019-04-27,"R6","Sydney",12,7,79,"GWS",18,12,120,"S.C.G.",-41,2019,"Regular",6,"Away","GWS","Sydney",41
15459,2019-04-27,"R6","Fremantle",13,10,88,"Footscray",9,15,69,"Perth Stadium",19,2019,"Regular",6,"Home","Fremantle","Footscray",19
15460,2019-04-28,"R6","Hawthorn",13,15,93,"Carlton",13,10,88,"York Park",5,2019,"Regular",6,"Home","Hawthorn","Carlton",5
15461,2019-04-28,"R6","Geelong",15,14,104,"West Coast",7,4,46,"Kardinia Park",58,2019,"Regular",6,"Home","Geelong","West Coast",58
15462,2019-05-03,"R7","Collingwood",15,18,108,"Port Adelaide",10,9,69,"Docklands",39,2019,"Regular",7,"Home","Collingwood","Port Adelaide",39
15463,2019-05-04,"R7","Melbourne",11,13,79,"Hawthorn",11,8,74,"M.C.G.",5,2019,"Regular",7,"Home","Melbourne","Hawthorn",5
15464,2019-05-04,"R7","GWS",18,6,114,"St Kilda",10,10,70,"Manuka Oval",44,2019,"Regular",7,"Home","GWS","St Kilda",44
15465,2019-05-04,"R7","Brisbane Lions",14,19,103,"Sydney",12,9,81,"Gabba",22,2019,"Regular",7,"Home","Brisbane Lions","Sydney",22
15466,2019-05-04,"R7","Footscray",15,9,99,"Richmond",7,10,52,"Docklands",47,2019,"Regular",7,"Home","Footscray","Richmond",47
15467,2019-05-04,"R7","West Coast",11,14,80,"Gold Coast",8,9,57,"Perth Stadium",23,2019,"Regular",7,"Home","West Coast","Gold Coast",23
15468,2019-05-05,"R7","Carlton",8,14,62,"North Melbourne",18,12,120,"Docklands",-58,2019,"Regular",7,"Away","North Melbourne","Carlton",58
15469,2019-05-05,"R7","Geelong",13,8,86,"Essendon",7,12,54,"M.C.G.",32,2019,"Regular",7,"Home","Geelong","Essendon",32
15470,2019-05-05,"R7","Adelaide",7,9,51,"Fremantle",5,4,34,"Adelaide Oval",17,2019,"Regular",7,"Home","Adelaide","Fremantle",17
15471,2019-05-10,"R8","Sydney",11,11,77,"Essendon",10,12,72,"S.C.G.",5,2019,"Regular",8,"Home","Sydney","Essendon",5
15472,2019-05-11,"R8","Carlton",13,9,87,"Collingwood",16,10,106,"M.C.G.",-19,2019,"Regular",8,"Away","Collingwood","Carlton",19
15473,2019-05-11,"R8","Footscray",13,14,92,"Brisbane Lions",11,10,76,"Eureka Stadium",16,2019,"Regular",8,"Home","Footscray","Brisbane Lions",16
15474,2019-05-11,"R8","Gold Coast",9,6,60,"Melbourne",8,13,61,"Carrara",-1,2019,"Regular",8,"Away","Melbourne","Gold Coast",1
15475,2019-05-11,"R8","St Kilda",10,10,70,"West Coast",12,16,88,"Docklands",-18,2019,"Regular",8,"Away","West Coast","St Kilda",18
15476,2019-05-11,"R8","Port Adelaide",9,14,68,"Adelaide",13,10,88,"Adelaide Oval",-20,2019,"Regular",8,"Away","Adelaide","Port Adelaide",20
15477,2019-05-12,"R8","North Melbourne",11,14,80,"Geelong",16,8,104,"Docklands",-24,2019,"Regular",8,"Away","Geelong","North Melbourne",24
15478,2019-05-12,"R8","Hawthorn",10,11,71,"GWS",5,8,38,"M.C.G.",33,2019,"Regular",8,"Home","Hawthorn","GWS",33
15479,2019-05-12,"R8","Fremantle",12,14,86,"Richmond",17,9,111,"Perth Stadium",-25,2019,"Regular",8,"Away","Richmond","Fremantle",25
15480,2019-05-17,"R9","West Coast",13,7,85,"Melbourne",9,15,69,"Perth Stadium",16,2019,"Regular",9,"Home","West Coast","Melbourne",16
15481,2019-05-18,"R9","Collingwood",17,10,112,"St Kilda",10,11,71,"M.C.G.",41,2019,"Regular",9,"Home","Collingwood","St Kilda",41
15482,2019-05-18,"R9","Brisbane Lions",13,15,93,"Adelaide",13,14,92,"Gabba",1,2019,"Regular",9,"Home","Brisbane Lions","Adelaide",1
15483,2019-05-18,"R9","Geelong",21,7,133,"Footscray",13,11,89,"Kardinia Park",44,2019,"Regular",9,"Home","Geelong","Footscray",44
15484,2019-05-18,"R9","Essendon",8,12,60,"Fremantle",7,11,53,"Docklands",7,2019,"Regular",9,"Home","Essendon","Fremantle",7
15485,2019-05-18,"R9","North Melbourne",10,12,72,"Sydney",11,11,77,"Bellerive Oval",-5,2019,"Regular",9,"Away","Sydney","North Melbourne",5
15486,2019-05-19,"R9","Port Adelaide",13,11,89,"Gold Coast",7,9,51,"Adelaide Oval",38,2019,"Regular",9,"Home","Port Adelaide","Gold Coast",38
15487,2019-05-19,"R9","Richmond",14,11,95,"Hawthorn",8,11,59,"M.C.G.",36,2019,"Regular",9,"Home","Richmond","Hawthorn",36
15488,2019-05-19,"R9","GWS",20,18,138,"Carlton",7,3,45,"Sydney Showground",93,2019,"Regular",9,"Home","GWS","Carlton",93
15489,2019-05-24,"R10","Sydney",11,7,73,"Collingwood",11,14,80,"S.C.G.",-7,2019,"Regular",10,"Away","Collingwood","Sydney",7
15490,2019-05-25,"R10","Hawthorn",12,8,80,"Port Adelaide",6,13,49,"York Park",31,2019,"Regular",10,"Home","Hawthorn","Port Adelaide",31
15491,2019-05-25,"R10","Footscray",13,12,90,"North Melbourne",18,7,115,"Docklands",-25,2019,"Regular",10,"Away","North Melbourne","Footscray",25
15492,2019-05-25,"R10","Adelaide",10,13,73,"West Coast",13,7,85,"Adelaide Oval",-12,2019,"Regular",10,"Away","West Coast","Adelaide",12
15493,2019-05-25,"R10","Richmond",10,13,73,"Essendon",6,14,50,"M.C.G.",23,2019,"Regular",10,"Home","Richmond","Essendon",23
15494,2019-05-25,"R10","Gold Coast",9,10,64,"Geelong",13,13,91,"Carrara",-27,2019,"Regular",10,"Away","Geelong","Gold Coast",27
15495,2019-05-26,"R10","Melbourne",10,8,68,"GWS",14,10,94,"M.C.G.",-26,2019,"Regular",10,"Away","GWS","Melbourne",26
15496,2019-05-26,"R10","St Kilda",9,14,68,"Carlton",8,7,55,"Docklands",13,2019,"Regular",10,"Home","St Kilda","Carlton",13
15497,2019-05-26,"R10","Fremantle",10,13,73,"Brisbane Lions",10,12,72,"Perth Stadium",1,2019,"Regular",10,"Home","Fremantle","Brisbane Lions",1
15498,2019-05-31,"R11","North Melbourne",15,9,99,"Richmond",9,8,62,"Docklands",37,2019,"Regular",11,"Home","North Melbourne","Richmond",37
15499,2019-06-01,"R11","Collingwood",11,9,75,"Fremantle",11,13,79,"M.C.G.",-4,2019,"Regular",11,"Away","Fremantle","Collingwood",4
15500,2019-06-01,"R11","GWS",19,12,126,"Gold Coast",6,7,43,"Sydney Showground",83,2019,"Regular",11,"Home","GWS","Gold Coast",83
15501,2019-06-01,"R11","Geelong",13,7,85,"Sydney",8,15,63,"Kardinia Park",22,2019,"Regular",11,"Home","Geelong","Sydney",22
15502,2019-06-01,"R11","Brisbane Lions",12,13,85,"Hawthorn",10,6,66,"Gabba",19,2019,"Regular",11,"Home","Brisbane Lions","Hawthorn",19
15503,2019-06-01,"R11","Melbourne",12,16,88,"Adelaide",14,6,90,"Marrara Oval",-2,2019,"Regular",11,"Away","Adelaide","Melbourne",2
15504,2019-06-02,"R11","St Kilda",9,15,69,"Port Adelaide",22,7,139,"Jiangwan Stadium",-70,2019,"Regular",11,"Away","Port Adelaide","St Kilda",70
15505,2019-06-02,"R11","Essendon",11,8,74,"Carlton",4,9,33,"M.C.G.",41,2019,"Regular",11,"Home","Essendon","Carlton",41
15506,2019-06-02,"R11","West Coast",21,7,133,"Footscray",10,12,72,"Perth Stadium",61,2019,"Regular",11,"Home","West Coast","Footscray",61
15507,2019-06-07,"R12","Richmond",5,7,37,"Geelong",16,8,104,"M.C.G.",-67,2019,"Regular",12,"Away","Geelong","Richmond",67
15508,2019-06-08,"R12","Carlton",11,12,78,"Brisbane Lions",9,9,63,"Docklands",15,2019,"Regular",12,"Home","Carlton","Brisbane Lions",15
15509,2019-06-08,"R12","Gold Coast",11,6,72,"North Melbourne",14,15,99,"Carrara",-27,2019,"Regular",12,"Away","North Melbourne","Gold Coast",27
15510,2019-06-08,"R12","Adelaide",12,10,82,"GWS",9,7,61,"Adelaide Oval",21,2019,"Regular",12,"Home","Adelaide","GWS",21
15511,2019-06-09,"R12","Sydney",18,8,116,"West Coast",10,11,71,"S.C.G.",45,2019,"Regular",12,"Home","Sydney","West Coast",45
15512,2019-06-10,"R12","Collingwood",15,8,98,"Melbourne",7,15,57,"M.C.G.",41,2019,"Regular",12,"Home","Collingwood","Melbourne",41
15513,2019-06-13,"R13","Adelaide",15,11,101,"Richmond",9,14,68,"Adelaide Oval",33,2019,"Regular",13,"Home","Adelaide","Richmond",33
15514,2019-06-14,"R13","Essendon",14,12,96,"Hawthorn",11,11,77,"Docklands",19,2019,"Regular",13,"Home","Essendon","Hawthorn",19
15515,2019-06-15,"R13","Gold Coast",11,10,76,"St Kilda",11,14,80,"Riverway Stadium",-4,2019,"Regular",13,"Away","St Kilda","Gold Coast",4
15516,2019-06-15,"R13","Fremantle",15,10,100,"Port Adelaide",12,7,79,"Perth Stadium",21,2019,"Regular",13,"Home","Fremantle","Port Adelaide",21
15517,2019-06-15,"R13","Carlton",15,10,100,"Footscray",15,13,103,"Docklands",-3,2019,"Regular",13,"Away","Footscray","Carlton",3
15518,2019-06-16,"R13","North Melbourne",10,8,68,"GWS",14,7,91,"Bellerive Oval",-23,2019,"Regular",13,"Away","GWS","North Melbourne",23
15519,2019-06-20,"R14","West Coast",14,22,106,"Essendon",11,5,71,"Perth Stadium",35,2019,"Regular",14,"Home","West Coast","Essendon",35
15520,2019-06-21,"R14","Sydney",12,10,82,"Hawthorn",9,9,63,"S.C.G.",19,2019,"Regular",14,"Home","Sydney","Hawthorn",19
15521,2019-06-22,"R14","Melbourne",13,7,85,"Fremantle",11,5,71,"M.C.G.",14,2019,"Regular",14,"Home","Melbourne","Fremantle",14
15522,2019-06-22,"R14","St Kilda",8,11,59,"Brisbane Lions",17,13,115,"Docklands",-56,2019,"Regular",14,"Away","Brisbane Lions","St Kilda",56
15523,2019-06-22,"R14","Port Adelaide",9,13,67,"Geelong",8,8,56,"Adelaide Oval",11,2019,"Regular",14,"Home","Port Adelaide","Geelong",11
15524,2019-06-23,"R14","Footscray",10,13,73,"Collingwood",13,4,82,"Docklands",-9,2019,"Regular",14,"Away","Collingwood","Footscray",9
15525,2019-06-27,"R15","Essendon",12,5,77,"GWS",10,11,71,"Docklands",6,2019,"Regular",15,"Home","Essendon","GWS",6
15526,2019-06-28,"R15","Geelong",14,12,96,"Adelaide",10,9,69,"Kardinia Park",27,2019,"Regular",15,"Home","Geelong","Adelaide",27
15527,2019-06-29,"R15","Hawthorn",9,17,71,"West Coast",11,11,77,"M.C.G.",-6,2019,"Regular",15,"Away","West Coast","Hawthorn",6
15528,2019-06-29,"R15","Sydney",14,9,93,"Gold Coast",7,9,51,"S.C.G.",42,2019,"Regular",15,"Home","Sydney","Gold Coast",42
15529,2019-06-29,"R15","Collingwood",5,7,37,"North Melbourne",11,15,81,"Docklands",-44,2019,"Regular",15,"Away","North Melbourne","Collingwood",44
15530,2019-06-29,"R15","Port Adelaide",5,11,41,"Footscray",10,6,66,"Adelaide Oval",-25,2019,"Regular",15,"Away","Footscray","Port Adelaide",25
15531,2019-06-30,"R15","St Kilda",10,10,70,"Richmond",16,7,103,"Docklands",-33,2019,"Regular",15,"Away","Richmond","St Kilda",33
15532,2019-06-30,"R15","Brisbane Lions",15,17,107,"Melbourne",11,8,74,"Gabba",33,2019,"Regular",15,"Home","Brisbane Lions","Melbourne",33
15533,2019-06-30,"R15","Fremantle",11,9,75,"Carlton",11,13,79,"Perth Stadium",-4,2019,"Regular",15,"Away","Carlton","Fremantle",4
15534,2019-07-05,"R16","Hawthorn",9,13,67,"Collingwood",9,9,63,"M.C.G.",4,2019,"Regular",16,"Home","Hawthorn","Collingwood",4
15535,2019-07-06,"R16","Essendon",11,10,76,"Sydney",9,12,66,"M.C.G.",10,2019,"Regular",16,"Home","Essendon","Sydney",10
15536,2019-07-06,"R16","Gold Coast",9,4,58,"Richmond",23,12,150,"Carrara",-92,2019,"Regular",16,"Away","Richmond","Gold Coast",92
15537,2019-07-06,"R16","Adelaide",5,14,44,"Port Adelaide",15,11,101,"Adelaide Oval",-57,2019,"Regular",16,"Away","Port Adelaide","Adelaide",57
15538,2019-07-06,"R16","Footscray",10,11,71,"Geelong",7,13,55,"Docklands",16,2019,"Regular",16,"Home","Footscray","Geelong",16
15539,2019-07-06,"R16","Fremantle",2,19,31,"West Coast",19,8,122,"Perth Stadium",-91,2019,"Regular",16,"Away","West Coast","Fremantle",91
15540,2019-07-07,"R16","Carlton",15,10,100,"Melbourne",15,15,105,"M.C.G.",-5,2019,"Regular",16,"Away","Melbourne","Carlton",5
15541,2019-07-07,"R16","North Melbourne",17,10,112,"St Kilda",11,7,73,"Bellerive Oval",39,2019,"Regular",16,"Home","North Melbourne","St Kilda",39
15542,2019-07-07,"R16","GWS",11,8,74,"Brisbane Lions",14,10,94,"Sydney Showground",-20,2019,"Regular",16,"Away","Brisbane Lions","GWS",20
15543,2019-07-12,"R17","West Coast",12,5,77,"Collingwood",11,12,78,"Perth Stadium",-1,2019,"Regular",17,"Away","Collingwood","West Coast",1
15544,2019-07-13,"R17","Sydney",8,14,62,"Carlton",9,15,69,"S.C.G.",-7,2019,"Regular",17,"Away","Carlton","Sydney",7
15545,2019-07-13,"R17","Hawthorn",12,12,84,"Fremantle",8,5,53,"York Park",31,2019,"Regular",17,"Home","Hawthorn","Fremantle",31
15546,2019-07-13,"R17","Essendon",12,14,86,"North Melbourne",12,9,81,"Docklands",5,2019,"Regular",17,"Home","Essendon","North Melbourne",5
15547,2019-07-13,"R17","Gold Coast",8,8,56,"Adelaide",23,13,151,"Carrara",-95,2019,"Regular",17,"Away","Adelaide","Gold Coast",95
15548,2019-07-13,"R17","Geelong",12,12,84,"St Kilda",8,9,57,"Kardinia Park",27,2019,"Regular",17,"Home","Geelong","St Kilda",27
15549,2019-07-14,"R17","Richmond",13,16,94,"GWS",9,13,67,"M.C.G.",27,2019,"Regular",17,"Home","Richmond","GWS",27
15550,2019-07-14,"R17","Footscray",10,14,74,"Melbourne",9,12,66,"Docklands",8,2019,"Regular",17,"Home","Footscray","Melbourne",8
15551,2019-07-14,"R17","Port Adelaide",6,13,49,"Brisbane Lions",14,13,97,"Adelaide Oval",-48,2019,"Regular",17,"Away","Brisbane Lions","Port Adelaide",48
15552,2019-07-19,"R18","Adelaide",10,15,75,"Essendon",15,6,96,"Adelaide Oval",-21,2019,"Regular",18,"Away","Essendon","Adelaide",21
15553,2019-07-20,"R18","Richmond",15,11,101,"Port Adelaide",9,9,63,"M.C.G.",38,2019,"Regular",18,"Home","Richmond","Port Adelaide",38
15554,2019-07-20,"R18","Carlton",15,9,99,"Gold Coast",11,9,75,"Docklands",24,2019,"Regular",18,"Home","Carlton","Gold Coast",24
15555,2019-07-20,"R18","GWS",19,8,122,"Collingwood",11,9,75,"Sydney Showground",47,2019,"Regular",18,"Home","GWS","Collingwood",47
15556,2019-07-20,"R18","Brisbane Lions",12,15,87,"North Melbourne",12,3,75,"Gabba",12,2019,"Regular",18,"Home","Brisbane Lions","North Melbourne",12
15557,2019-07-20,"R18","Fremantle",7,10,52,"Sydney",7,9,51,"Perth Stadium",1,2019,"Regular",18,"Home","Fremantle","Sydney",1
15558,2019-07-21,"R18","Geelong",8,13,61,"Hawthorn",12,13,85,"M.C.G.",-24,2019,"Regular",18,"Away","Hawthorn","Geelong",24
15559,2019-07-21,"R18","Melbourne",11,12,78,"West Coast",14,7,91,"Traeger Park",-13,2019,"Regular",18,"Away","West Coast","Melbourne",13
15560,2019-07-21,"R18","St Kilda",17,14,116,"Footscray",14,5,89,"Docklands",27,2019,"Regular",18,"Home","St Kilda","Footscray",27
15561,2019-07-26,"R19","Collingwood",9,12,66,"Richmond",14,14,98,"M.C.G.",-32,2019,"Regular",19,"Away","Richmond","Collingwood",32
15562,2019-07-27,"R19","Hawthorn",7,18,60,"Brisbane Lions",13,9,87,"York Park",-27,2019,"Regular",19,"Away","Brisbane Lions","Hawthorn",27
15563,2019-07-27,"R19","Carlton",13,9,87,"Adelaide",9,6,60,"M.C.G.",27,2019,"Regular",19,"Home","Carlton","Adelaide",27
15564,2019-07-27,"R19","West Coast",18,13,121,"North Melbourne",10,12,72,"Perth Stadium",49,2019,"Regular",19,"Home","West Coast","North Melbourne",49
15565,2019-07-27,"R19","St Kilda",15,14,104,"Melbourne",13,7,85,"Docklands",19,2019,"Regular",19,"Home","St Kilda","Melbourne",19
15566,2019-07-27,"R19","Port Adelaide",7,13,55,"GWS",8,8,56,"Adelaide Oval",-1,2019,"Regular",19,"Away","GWS","Port Adelaide",1
15567,2019-07-28,"R19","Footscray",16,17,113,"Fremantle",9,12,66,"Docklands",47,2019,"Regular",19,"Home","Footscray","Fremantle",47
15568,2019-07-28,"R19","Sydney",12,8,80,"Geelong",16,11,107,"S.C.G.",-27,2019,"Regular",19,"Away","Geelong","Sydney",27
15569,2019-07-28,"R19","Gold Coast",15,6,96,"Essendon",16,10,106,"Carrara",-10,2019,"Regular",19,"Away","Essendon","Gold Coast",10
15570,2019-08-02,"R20","North Melbourne",12,14,86,"Hawthorn",9,10,64,"Docklands",22,2019,"Regular",20,"Home","North Melbourne","Hawthorn",22
15571,2019-08-03,"R20","Essendon",9,13,67,"Port Adelaide",19,12,126,"Docklands",-59,2019,"Regular",20,"Away","Port Adelaide","Essendon",59
15572,2019-08-03,"R20","GWS",12,11,83,"Sydney",12,9,81,"Sydney Showground",2,2019,"Regular",20,"Home","GWS","Sydney",2
15573,2019-08-03,"R20","Fremantle",14,11,95,"Geelong",9,7,61,"Perth Stadium",34,2019,"Regular",20,"Home","Fremantle","Geelong",34
15574,2019-08-03,"R20","Melbourne",9,6,60,"Richmond",13,15,93,"M.C.G.",-33,2019,"Regular",20,"Away","Richmond","Melbourne",33
15575,2019-08-03,"R20","Adelaide",14,8,92,"St Kilda",10,10,70,"Adelaide Oval",22,2019,"Regular",20,"Home","Adelaide","St Kilda",22
15576,2019-08-04,"R20","Collingwood",18,12,120,"Gold Coast",8,3,51,"M.C.G.",69,2019,"Regular",20,"Home","Collingwood","Gold Coast",69
15577,2019-08-04,"R20","Carlton",11,9,75,"West Coast",15,9,99,"Docklands",-24,2019,"Regular",20,"Away","West Coast","Carlton",24
15578,2019-08-04,"R20","Brisbane Lions",14,14,98,"Footscray",11,14,80,"Gabba",18,2019,"Regular",20,"Home","Brisbane Lions","Footscray",18
15579,2019-08-09,"R21","GWS",4,5,29,"Hawthorn",13,7,85,"Manuka Oval",-56,2019,"Regular",21,"Away","Hawthorn","GWS",56
15580,2019-08-10,"R21","Melbourne",7,11,53,"Collingwood",10,10,70,"M.C.G.",-17,2019,"Regular",21,"Away","Collingwood","Melbourne",17
15581,2019-08-10,"R21","Port Adelaide",15,13,103,"Sydney",7,14,56,"Adelaide Oval",47,2019,"Regular",21,"Home","Port Adelaide","Sydney",47
15582,2019-08-10,"R21","Brisbane Lions",22,12,144,"Gold Coast",8,5,53,"Gabba",91,2019,"Regular",21,"Home","Brisbane Lions","Gold Coast",91
15583,2019-08-10,"R21","Essendon",4,9,33,"Footscray",21,11,137,"Docklands",-104,2019,"Regular",21,"Away","Footscray","Essendon",104
15584,2019-08-10,"R21","Geelong",9,15,69,"North Melbourne",1,8,14,"Kardinia Park",55,2019,"Regular",21,"Home","Geelong","North Melbourne",55
15585,2019-08-11,"R21","St Kilda",10,12,72,"Fremantle",10,9,69,"Docklands",3,2019,"Regular",21,"Home","St Kilda","Fremantle",3
15586,2019-08-11,"R21","Richmond",11,7,73,"Carlton",6,9,45,"M.C.G.",28,2019,"Regular",21,"Home","Richmond","Carlton",28
15587,2019-08-11,"R21","West Coast",13,12,90,"Adelaide",12,8,80,"Perth Stadium",10,2019,"Regular",21,"Home","West Coast","Adelaide",10
15588,2019-08-16,"R22","Melbourne",5,12,42,"Sydney",15,5,95,"M.C.G.",-53,2019,"Regular",22,"Away","Sydney","Melbourne",53
15589,2019-08-17,"R22","Carlton",11,12,78,"St Kilda",10,8,68,"M.C.G.",10,2019,"Regular",22,"Home","Carlton","St Kilda",10
15590,2019-08-17,"R22","Brisbane Lions",10,15,75,"Geelong",10,14,74,"Gabba",1,2019,"Regular",22,"Home","Brisbane Lions","Geelong",1
15591,2019-08-17,"R22","Adelaide",6,12,48,"Collingwood",17,12,114,"Adelaide Oval",-66,2019,"Regular",22,"Away","Collingwood","Adelaide",66
15592,2019-08-17,"R22","North Melbourne",22,12,144,"Port Adelaide",8,10,58,"Docklands",86,2019,"Regular",22,"Home","North Melbourne","Port Adelaide",86
15593,2019-08-17,"R22","Fremantle",7,13,55,"Essendon",13,9,87,"Perth Stadium",-32,2019,"Regular",22,"Away","Essendon","Fremantle",32
15594,2019-08-18,"R22","Richmond",13,10,88,"West Coast",13,4,82,"M.C.G.",6,2019,"Regular",22,"Home","Richmond","West Coast",6
15595,2019-08-18,"R22","GWS",9,11,65,"Footscray",19,12,126,"Sydney Showground",-61,2019,"Regular",22,"Away","Footscray","GWS",61
15596,2019-08-18,"R22","Hawthorn",18,10,118,"Gold Coast",7,6,48,"Docklands",70,2019,"Regular",22,"Home","Hawthorn","Gold Coast",70
15597,2019-08-23,"R23","Collingwood",10,16,76,"Essendon",10,5,65,"M.C.G.",11,2019,"Regular",23,"Home","Collingwood","Essendon",11
15598,2019-08-24,"R23","Sydney",17,7,109,"St Kilda",8,16,64,"S.C.G.",45,2019,"Regular",23,"Home","Sydney","St Kilda",45
15599,2019-08-24,"R23","North Melbourne",13,10,88,"Melbourne",12,11,83,"Bellerive Oval",5,2019,"Regular",23,"Home","North Melbourne","Melbourne",5
15600,2019-08-24,"R23","Geelong",19,15,129,"Carlton",8,13,61,"Kardinia Park",68,2019,"Regular",23,"Home","Geelong","Carlton",68
15601,2019-08-24,"R23","Gold Coast",7,13,55,"GWS",20,7,127,"Carrara",-72,2019,"Regular",23,"Away","GWS","Gold Coast",72
15602,2019-08-24,"R23","West Coast",9,13,67,"Hawthorn",16,9,105,"Perth Stadium",-38,2019,"Regular",23,"Away","Hawthorn","West Coast",38
15603,2019-08-25,"R23","Footscray",18,13,121,"Adelaide",13,9,87,"Eureka Stadium",34,2019,"Regular",23,"Home","Footscray","Adelaide",34
15604,2019-08-25,"R23","Richmond",12,10,82,"Brisbane Lions",8,7,55,"M.C.G.",27,2019,"Regular",23,"Home","Richmond","Brisbane Lions",27
15605,2019-08-25,"R23","Port Adelaide",15,20,110,"Fremantle",10,7,67,"Adelaide Oval",43,2019,"Regular",23,"Home","Port Adelaide","Fremantle",43
15606,2019-09-05,"EF","West Coast",17,14,116,"Essendon",9,7,61,"Perth Stadium",55,2019,"Finals",24,"Home","West Coast","Essendon",55
15607,2019-09-06,"QF","Geelong",7,9,51,"Collingwood",9,7,61,"M.C.G.",-10,2019,"Finals",24,"Away","Collingwood","Geelong",10
15608,2019-09-07,"EF","GWS",16,17,113,"Footscray",8,7,55,"Sydney Showground",58,2019,"Finals",24,"Home","GWS","Footscray",58
15609,2019-09-07,"QF","Brisbane Lions",8,17,65,"Richmond",18,4,112,"Gabba",-47,2019,"Finals",24,"Away","Richmond","Brisbane Lions",47
15610,2019-09-13,"SF","Geelong",13,10,88,"West Coast",10,8,68,"M.C.G.",20,2019,"Finals",25,"Home","Geelong","West Coast",20
15611,2019-09-14,"SF","Brisbane Lions",11,14,80,"GWS",12,11,83,"Gabba",-3,2019,"Finals",25,"Away","GWS","Brisbane Lions",3
15612,2019-09-20,"PF","Richmond",12,13,85,"Geelong",9,12,66,"M.C.G.",19,2019,"Finals",26,"Home","Richmond","Geelong",19
15613,2019-09-21,"PF","Collingwood",7,10,52,"GWS",8,8,56,"M.C.G.",-4,2019,"Finals",26,"Away","GWS","Collingwood",4
15614,2019-09-28,"GF","Richmond",17,12,114,"GWS",3,7,25,"M.C.G.",89,2019,"Finals",27,"Home","Richmond","GWS",89
15615,2020-03-19,"R1","Richmond",16,9,105,"Carlton",12,9,81,"M.C.G.",24,2020,"Regular",1,"Home","Richmond","Carlton",24
15616,2020-03-20,"R1","Footscray",5,4,34,"Collingwood",13,8,86,"Docklands",-52,2020,"Regular",1,"Away","Collingwood","Footscray",52
15617,2020-03-21,"R1","Essendon",9,9,63,"Fremantle",8,9,57,"Docklands",6,2020,"Regular",1,"Home","Essendon","Fremantle",6
15618,2020-03-21,"R1","Adelaide",11,5,71,"Sydney",11,8,74,"Adelaide Oval",-3,2020,"Regular",1,"Away","Sydney","Adelaide",3
15619,2020-03-21,"R1","GWS",17,3,105,"Geelong",11,7,73,"Sydney Showground",32,2020,"Regular",1,"Home","GWS","Geelong",32
15620,2020-03-21,"R1","Gold Coast",4,5,29,"Port Adelaide",10,16,76,"Carrara",-47,2020,"Regular",1,"Away","Port Adelaide","Gold Coast",47
15621,2020-03-22,"R1","North Melbourne",8,8,56,"St Kilda",7,12,54,"Docklands",2,2020,"Regular",1,"Home","North Melbourne","St Kilda",2
15622,2020-03-22,"R1","Hawthorn",14,6,90,"Brisbane Lions",9,8,62,"M.C.G.",28,2020,"Regular",1,"Home","Hawthorn","Brisbane Lions",28
15623,2020-03-22,"R1","West Coast",12,6,78,"Melbourne",7,9,51,"Perth Stadium",27,2020,"Regular",1,"Home","West Coast","Melbourne",27
15624,2020-06-11,"R2","Collingwood",5,6,36,"Richmond",5,6,36,"M.C.G.",0,2020,"Regular",2,"Home","Collingwood","Richmond",0
15625,2020-06-12,"R2","Geelong",17,6,108,"Hawthorn",7,5,47,"Kardinia Park",61,2020,"Regular",2,"Home","Geelong","Hawthorn",61
15626,2020-06-13,"R2","Brisbane Lions",12,9,81,"Fremantle",10,9,69,"Gabba",12,2020,"Regular",2,"Home","Brisbane Lions","Fremantle",12
15627,2020-06-13,"R2","Carlton",7,11,53,"Melbourne",8,6,54,"Docklands",-1,2020,"Regular",2,"Away","Melbourne","Carlton",1
15628,2020-06-13,"R2","Port Adelaide",17,8,110,"Adelaide",5,5,35,"Adelaide Oval",75,2020,"Regular",2,"Home","Port Adelaide","Adelaide",75
15629,2020-06-13,"R2","Gold Coast",14,6,90,"West Coast",6,10,46,"Carrara",44,2020,"Regular",2,"Home","Gold Coast","West Coast",44
15630,2020-06-14,"R2","GWS",8,12,60,"North Melbourne",12,8,80,"Sydney Showground",-20,2020,"Regular",2,"Away","North Melbourne","GWS",20
15631,2020-06-14,"R2","Sydney",11,7,73,"Essendon",12,7,79,"S.C.G.",-6,2020,"Regular",2,"Away","Essendon","Sydney",6
15632,2020-06-14,"R2","St Kilda",14,4,88,"Footscray",7,7,49,"Docklands",39,2020,"Regular",2,"Home","St Kilda","Footscray",39
15633,2020-06-18,"R3","Richmond",5,9,39,"Hawthorn",11,5,71,"M.C.G.",-32,2020,"Regular",3,"Away","Hawthorn","Richmond",32
15634,2020-06-19,"R3","Footscray",8,9,57,"GWS",4,9,33,"Docklands",24,2020,"Regular",3,"Home","Footscray","GWS",24
15635,2020-06-20,"R3","North Melbourne",8,12,60,"Sydney",10,11,71,"Docklands",-11,2020,"Regular",3,"Away","Sydney","North Melbourne",11
15636,2020-06-20,"R3","Collingwood",12,9,81,"St Kilda",5,7,37,"M.C.G.",44,2020,"Regular",3,"Home","Collingwood","St Kilda",44
15637,2020-06-20,"R3","Geelong",11,11,77,"Carlton",12,7,79,"Kardinia Park",-2,2020,"Regular",3,"Away","Carlton","Geelong",2
15638,2020-06-20,"R3","Brisbane Lions",10,14,74,"West Coast",6,8,44,"Gabba",30,2020,"Regular",3,"Home","Brisbane Lions","West Coast",30
15639,2020-06-21,"R3","Gold Coast",12,10,82,"Adelaide",4,5,29,"Carrara",53,2020,"Regular",3,"Home","Gold Coast","Adelaide",53
15640,2020-06-21,"R3","Fremantle",6,5,41,"Port Adelaide",10,10,70,"Carrara",-29,2020,"Regular",3,"Away","Port Adelaide","Fremantle",29
15641,2020-06-25,"R4","Sydney",5,9,39,"Footscray",10,7,67,"S.C.G.",-28,2020,"Regular",4,"Away","Footscray","Sydney",28
15642,2020-06-26,"R4","GWS",10,6,66,"Collingwood",9,10,64,"Sydney Showground",2,2020,"Regular",4,"Home","GWS","Collingwood",2
15643,2020-06-27,"R4","Port Adelaide",13,11,89,"West Coast",6,5,41,"Carrara",48,2020,"Regular",4,"Home","Port Adelaide","West Coast",48
15644,2020-06-27,"R4","St Kilda",15,3,93,"Richmond",10,7,67,"Docklands",26,2020,"Regular",4,"Home","St Kilda","Richmond",26
15645,2020-06-27,"R4","Essendon",8,3,51,"Carlton",7,10,52,"M.C.G.",-1,2020,"Regular",4,"Away","Carlton","Essendon",1
15646,2020-06-27,"R4","Gold Coast",10,4,64,"Fremantle",8,3,51,"Carrara",13,2020,"Regular",4,"Home","Gold Coast","Fremantle",13
15647,2020-06-28,"R4","Brisbane Lions",10,23,83,"Adelaide",7,4,46,"Gabba",37,2020,"Regular",4,"Home","Brisbane Lions","Adelaide",37
15648,2020-06-28,"R4","Melbourne",6,8,44,"Geelong",7,5,47,"M.C.G.",-3,2020,"Regular",4,"Away","Geelong","Melbourne",3
15649,2020-06-28,"R4","Hawthorn",8,10,58,"North Melbourne",8,6,54,"Docklands",4,2020,"Regular",4,"Home","Hawthorn","North Melbourne",4
15650,2020-07-02,"R5","Carlton",8,7,55,"St Kilda",11,7,73,"Docklands",-18,2020,"Regular",5,"Away","St Kilda","Carlton",18
15651,2020-07-03,"R5","Collingwood",7,6,48,"Essendon",10,3,63,"M.C.G.",-15,2020,"Regular",5,"Away","Essendon","Collingwood",15
15652,2020-07-04,"R5","West Coast",11,11,77,"Sydney",6,7,43,"Carrara",34,2020,"Regular",5,"Home","West Coast","Sydney",34
15653,2020-07-04,"R5","Geelong",13,11,89,"Gold Coast",8,4,52,"Kardinia Park",37,2020,"Regular",5,"Home","Geelong","Gold Coast",37
15654,2020-07-04,"R5","Footscray",13,9,87,"North Melbourne",5,8,38,"Docklands",49,2020,"Regular",5,"Home","Footscray","North Melbourne",49
15655,2020-07-04,"R5","Brisbane Lions",12,13,85,"Port Adelaide",6,12,48,"Gabba",37,2020,"Regular",5,"Home","Brisbane Lions","Port Adelaide",37
15656,2020-07-05,"R5","Adelaide",4,10,34,"Fremantle",8,6,54,"Carrara",-20,2020,"Regular",5,"Away","Fremantle","Adelaide",20
15657,2020-07-05,"R5","Melbourne",8,4,52,"Richmond",12,7,79,"M.C.G.",-27,2020,"Regular",5,"Away","Richmond","Melbourne",27
15658,2020-07-05,"R5","GWS",13,5,83,"Hawthorn",7,7,49,"Sydney Showground",34,2020,"Regular",5,"Home","GWS","Hawthorn",34
15659,2020-07-09,"R6","Geelong",11,7,73,"Brisbane Lions",6,10,46,"S.C.G.",27,2020,"Regular",6,"Home","Geelong","Brisbane Lions",27
15660,2020-07-10,"R6","Collingwood",8,11,59,"Hawthorn",3,9,27,"Sydney Showground",32,2020,"Regular",6,"Home","Collingwood","Hawthorn",32
15661,2020-07-11,"R6","Fremantle",12,7,79,"St Kilda",11,7,73,"Carrara",6,2020,"Regular",6,"Home","Fremantle","St Kilda",6
15662,2020-07-11,"R6","West Coast",10,7,67,"Adelaide",5,4,34,"Gabba",33,2020,"Regular",6,"Home","West Coast","Adelaide",33
15663,2020-07-11,"R6","Melbourne",12,8,80,"Gold Coast",9,9,63,"Sydney Showground",17,2020,"Regular",6,"Home","Melbourne","Gold Coast",17
15664,2020-07-11,"R6","Essendon",9,13,67,"North Melbourne",7,11,53,"Carrara",14,2020,"Regular",6,"Home","Essendon","North Melbourne",14
15665,2020-07-12,"R6","Port Adelaide",9,9,63,"GWS",6,10,46,"Carrara",17,2020,"Regular",6,"Home","Port Adelaide","GWS",17
15666,2020-07-12,"R6","Richmond",4,10,34,"Sydney",3,8,26,"Gabba",8,2020,"Regular",6,"Home","Richmond","Sydney",8
15667,2020-07-12,"R6","Carlton",16,7,103,"Footscray",7,9,51,"Carrara",52,2020,"Regular",6,"Home","Carlton","Footscray",52
15668,2020-07-16,"R7","Geelong",5,5,35,"Collingwood",8,9,57,"Perth Stadium",-22,2020,"Regular",7,"Away","Collingwood","Geelong",22
15669,2020-07-17,"R7","Essendon",7,9,51,"Footscray",14,9,93,"Carrara",-42,2020,"Regular",7,"Away","Footscray","Essendon",42
15670,2020-07-18,"R7","GWS",10,8,68,"Brisbane Lions",13,10,88,"Sydney Showground",-20,2020,"Regular",7,"Away","Brisbane Lions","GWS",20
15671,2020-07-18,"R7","Sydney",9,6,60,"Gold Coast",13,14,92,"S.C.G.",-32,2020,"Regular",7,"Away","Gold Coast","Sydney",32
15672,2020-07-18,"R7","Richmond",11,11,77,"North Melbourne",2,11,23,"Carrara",54,2020,"Regular",7,"Home","Richmond","North Melbourne",54
15673,2020-07-19,"R7","Carlton",9,7,61,"Port Adelaide",9,10,64,"Gabba",-3,2020,"Regular",7,"Away","Port Adelaide","Carlton",3
15674,2020-07-19,"R7","Hawthorn",7,6,48,"Melbourne",14,7,91,"Sydney Showground",-43,2020,"Regular",7,"Away","Melbourne","Hawthorn",43
15675,2020-07-19,"R7","Fremantle",5,2,32,"West Coast",9,8,62,"Perth Stadium",-30,2020,"Regular",7,"Away","West Coast","Fremantle",30
15676,2020-07-20,"R7","Adelaide",8,7,55,"St Kilda",12,6,78,"Adelaide Oval",-23,2020,"Regular",7,"Away","St Kilda","Adelaide",23
15677,2020-07-23,"R8","Gold Coast",6,10,46,"Footscray",7,9,51,"Carrara",-5,2020,"Regular",8,"Away","Footscray","Gold Coast",5
15678,2020-07-24,"R8","GWS",9,8,62,"Richmond",6,14,50,"Sydney Showground",12,2020,"Regular",8,"Home","GWS","Richmond",12
15679,2020-07-25,"R8","North Melbourne",9,3,57,"Carlton",9,10,64,"Gabba",-7,2020,"Regular",8,"Away","Carlton","North Melbourne",7
15680,2020-07-25,"R8","Sydney",9,6,60,"Hawthorn",7,11,53,"S.C.G.",7,2020,"Regular",8,"Home","Sydney","Hawthorn",7
15681,2020-07-25,"R8","Port Adelaide",6,8,44,"St Kilda",12,1,73,"Adelaide Oval",-29,2020,"Regular",8,"Away","St Kilda","Port Adelaide",29
15682,2020-07-26,"R8","Adelaide",8,11,59,"Essendon",9,8,62,"Adelaide Oval",-3,2020,"Regular",8,"Away","Essendon","Adelaide",3
15683,2020-07-26,"R8","West Coast",18,3,111,"Collingwood",6,9,45,"Perth Stadium",66,2020,"Regular",8,"Home","West Coast","Collingwood",66
15684,2020-07-26,"R8","Melbourne",7,7,49,"Brisbane Lions",7,11,53,"Carrara",-4,2020,"Regular",8,"Away","Brisbane Lions","Melbourne",4
15685,2020-07-27,"R8","Fremantle",2,4,16,"Geelong",6,12,48,"Perth Stadium",-32,2020,"Regular",8,"Away","Geelong","Fremantle",32
15686,2020-07-29,"R9","Footscray",7,7,49,"Richmond",13,12,90,"Carrara",-41,2020,"Regular",9,"Away","Richmond","Footscray",41
15687,2020-07-30,"R9","Melbourne",4,8,32,"Port Adelaide",12,11,83,"Gabba",-51,2020,"Regular",9,"Away","Port Adelaide","Melbourne",51
15688,2020-07-31,"R9","Carlton",9,4,58,"Hawthorn",14,5,89,"Perth Stadium",-31,2020,"Regular",9,"Away","Hawthorn","Carlton",31
15689,2020-07-31,"R9","Essendon",3,10,28,"Brisbane Lions",14,7,91,"Carrara",-63,2020,"Regular",9,"Away","Brisbane Lions","Essendon",63
15690,2020-08-01,"R9","North Melbourne",19,5,119,"Adelaide",7,8,50,"Carrara",69,2020,"Regular",9,"Home","North Melbourne","Adelaide",69
15691,2020-08-01,"R9","St Kilda",15,11,101,"Sydney",6,12,48,"Gabba",53,2020,"Regular",9,"Home","St Kilda","Sydney",53
15692,2020-08-01,"R9","West Coast",11,7,73,"Geelong",10,4,64,"Perth Stadium",9,2020,"Regular",9,"Home","West Coast","Geelong",9
15693,2020-08-02,"R9","Gold Coast",4,11,35,"GWS",9,7,61,"Carrara",-26,2020,"Regular",9,"Away","GWS","Gold Coast",26
15694,2020-08-02,"R9","Fremantle",10,1,61,"Collingwood",7,7,49,"Perth Stadium",12,2020,"Regular",9,"Home","Fremantle","Collingwood",12
15695,2020-08-03,"R10","Port Adelaide",8,7,55,"Footscray",5,12,42,"Adelaide Oval",13,2020,"Regular",10,"Home","Port Adelaide","Footscray",13
15696,2020-08-04,"R10","Richmond",12,10,82,"Brisbane Lions",4,17,41,"Carrara",41,2020,"Regular",10,"Home","Richmond","Brisbane Lions",41
15697,2020-08-05,"R10","Geelong",13,12,90,"North Melbourne",9,3,57,"Gabba",33,2020,"Regular",10,"Home","Geelong","North Melbourne",33
15698,2020-08-05,"R10","Adelaide",5,7,37,"Melbourne",13,10,88,"Adelaide Oval",-51,2020,"Regular",10,"Away","Melbourne","Adelaide",51
15699,2020-08-06,"R10","Collingwood",6,14,50,"Sydney",6,5,41,"Gabba",9,2020,"Regular",10,"Home","Collingwood","Sydney",9
15700,2020-08-06,"R10","Gold Coast",11,8,74,"St Kilda",12,6,78,"Carrara",-4,2020,"Regular",10,"Away","St Kilda","Gold Coast",4
15701,2020-08-07,"R10","Essendon",8,7,55,"GWS",8,11,59,"Carrara",-4,2020,"Regular",10,"Away","GWS","Essendon",4
15702,2020-08-08,"R11","Port Adelaide",13,15,93,"Richmond",11,6,72,"Adelaide Oval",21,2020,"Regular",11,"Home","Port Adelaide","Richmond",21
15703,2020-08-08,"R11","Brisbane Lions",14,12,96,"Footscray",11,6,72,"Gabba",24,2020,"Regular",11,"Home","Brisbane Lions","Footscray",24
15704,2020-08-09,"R11","West Coast",11,6,72,"Carlton",7,8,50,"Perth Stadium",22,2020,"Regular",11,"Home","West Coast","Carlton",22
15705,2020-08-09,"R11","Melbourne",13,14,92,"North Melbourne",5,5,35,"Adelaide Oval",57,2020,"Regular",11,"Home","Melbourne","North Melbourne",57
15706,2020-08-10,"R11","St Kilda",4,10,34,"Geelong",14,9,93,"Gabba",-59,2020,"Regular",11,"Away","Geelong","St Kilda",59
15707,2020-08-10,"R11","Fremantle",7,6,48,"Hawthorn",4,8,32,"Perth Stadium",16,2020,"Regular",11,"Home","Fremantle","Hawthorn",16
15708,2020-08-11,"R11","Adelaide",5,8,38,"Collingwood",10,2,62,"Adelaide Oval",-24,2020,"Regular",11,"Away","Collingwood","Adelaide",24
15709,2020-08-12,"R11","Gold Coast",11,7,73,"Essendon",11,7,73,"Carrara",0,2020,"Regular",11,"Home","Gold Coast","Essendon",0
15710,2020-08-13,"R12","Sydney",10,6,66,"GWS",3,7,25,"Perth Stadium",41,2020,"Regular",12,"Home","Sydney","GWS",41
15711,2020-08-14,"R12","Geelong",14,7,91,"Port Adelaide",4,7,31,"Carrara",60,2020,"Regular",12,"Home","Geelong","Port Adelaide",60
15712,2020-08-15,"R12","North Melbourne",8,4,52,"Brisbane Lions",7,11,53,"Carrara",-1,2020,"Regular",12,"Away","Brisbane Lions","North Melbourne",1
15713,2020-08-15,"R12","Melbourne",16,4,100,"Collingwood",6,8,44,"Gabba",56,2020,"Regular",12,"Home","Melbourne","Collingwood",56
15714,2020-08-15,"R12","Fremantle",5,6,36,"Carlton",5,10,40,"Perth Stadium",-4,2020,"Regular",12,"Away","Carlton","Fremantle",4
15715,2020-08-16,"R12","Footscray",16,15,111,"Adelaide",8,6,54,"Carrara",57,2020,"Regular",12,"Home","Footscray","Adelaide",57
15716,2020-08-16,"R12","St Kilda",10,8,68,"Essendon",5,3,33,"Gabba",35,2020,"Regular",12,"Home","St Kilda","Essendon",35
15717,2020-08-16,"R12","West Coast",12,9,81,"Hawthorn",7,7,49,"Perth Stadium",32,2020,"Regular",12,"Home","West Coast","Hawthorn",32
15718,2020-08-17,"R12","Richmond",8,5,53,"Gold Coast",4,8,32,"Gabba",21,2020,"Regular",12,"Home","Richmond","Gold Coast",21
15719,2020-08-21,"R13","Gold Coast",4,3,27,"Carlton",7,18,60,"Marrara Oval",-33,2020,"Regular",13,"Away","Carlton","Gold Coast",33
15720,2020-08-22,"R13","Footscray",12,8,80,"Melbourne",7,10,52,"Carrara",28,2020,"Regular",13,"Home","Footscray","Melbourne",28
15721,2020-08-22,"R13","Port Adelaide",9,14,68,"Hawthorn",9,4,58,"Adelaide Oval",10,2020,"Regular",13,"Home","Port Adelaide","Hawthorn",10
15722,2020-08-22,"R13","Essendon",10,1,61,"Richmond",10,13,73,"Marrara Oval",-12,2020,"Regular",13,"Away","Richmond","Essendon",12
15723,2020-08-22,"R13","Fremantle",7,8,50,"Sydney",2,7,19,"Perth Stadium",31,2020,"Regular",13,"Home","Fremantle","Sydney",31
15724,2020-08-23,"R13","Adelaide",5,7,37,"Geelong",9,11,65,"Adelaide Oval",-28,2020,"Regular",13,"Away","Geelong","Adelaide",28
15725,2020-08-23,"R13","Brisbane Lions",6,14,50,"St Kilda",7,6,48,"Gabba",2,2020,"Regular",13,"Home","Brisbane Lions","St Kilda",2
15726,2020-08-23,"R13","West Coast",9,7,61,"GWS",7,7,49,"Perth Stadium",12,2020,"Regular",13,"Home","West Coast","GWS",12
15727,2020-08-24,"R13","Collingwood",10,5,65,"North Melbourne",5,5,35,"Gabba",30,2020,"Regular",13,"Home","Collingwood","North Melbourne",30
15728,2020-08-27,"R14","Hawthorn",10,11,71,"Essendon",13,9,87,"Adelaide Oval",-16,2020,"Regular",14,"Away","Essendon","Hawthorn",16
15729,2020-08-27,"R14","Richmond",14,4,88,"West Coast",9,7,61,"Carrara",27,2020,"Regular",14,"Home","Richmond","West Coast",27
15730,2020-08-28,"R14","Footscray",9,7,61,"Geelong",10,12,72,"Carrara",-11,2020,"Regular",14,"Away","Geelong","Footscray",11
15731,2020-08-29,"R14","Port Adelaide",11,7,73,"Sydney",7,5,47,"Adelaide Oval",26,2020,"Regular",14,"Home","Port Adelaide","Sydney",26
15732,2020-08-29,"R14","Fremantle",8,5,53,"GWS",14,7,91,"Perth Stadium",-38,2020,"Regular",14,"Away","GWS","Fremantle",38
15733,2020-08-29,"R14","Melbourne",8,4,52,"St Kilda",7,7,49,"Traeger Park",3,2020,"Regular",14,"Home","Melbourne","St Kilda",3
15734,2020-08-30,"R14","Carlton",7,6,48,"Collingwood",10,12,72,"Gabba",-24,2020,"Regular",14,"Away","Collingwood","Carlton",24
15735,2020-08-30,"R14","Gold Coast",12,19,91,"North Melbourne",4,4,28,"Carrara",63,2020,"Regular",14,"Home","Gold Coast","North Melbourne",63
15736,2020-09-01,"R15","Hawthorn",7,6,48,"Adelaide",12,11,83,"Adelaide Oval",-35,2020,"Regular",15,"Away","Adelaide","Hawthorn",35
15737,2020-09-01,"R15","West Coast",9,6,60,"Essendon",6,9,45,"Gabba",15,2020,"Regular",15,"Home","West Coast","Essendon",15
15738,2020-09-02,"R15","Richmond",8,8,56,"Fremantle",4,5,29,"Carrara",27,2020,"Regular",15,"Home","Richmond","Fremantle",27
15739,2020-09-03,"R15","Sydney",10,7,67,"Melbourne",6,10,46,"Cazaly's Stadium",21,2020,"Regular",15,"Home","Sydney","Melbourne",21
15740,2020-09-03,"R15","GWS",6,12,48,"Carlton",5,9,39,"Carrara",9,2020,"Regular",15,"Home","GWS","Carlton",9
15741,2020-09-04,"R15","Brisbane Lions",6,6,42,"Collingwood",5,4,34,"Gabba",8,2020,"Regular",15,"Home","Brisbane Lions","Collingwood",8
15742,2020-09-05,"R16","North Melbourne",6,6,42,"Port Adelaide",11,12,78,"Carrara",-36,2020,"Regular",16,"Away","Port Adelaide","North Melbourne",36
15743,2020-09-06,"R16","St Kilda",11,14,80,"Hawthorn",9,12,66,"Carrara",14,2020,"Regular",16,"Home","St Kilda","Hawthorn",14
15744,2020-09-06,"R16","Geelong",17,6,108,"Essendon",5,12,42,"Gabba",66,2020,"Regular",16,"Home","Geelong","Essendon",66
15745,2020-09-06,"R16","Footscray",6,13,49,"West Coast",7,5,47,"Carrara",2,2020,"Regular",16,"Home","Footscray","West Coast",2
15746,2020-09-07,"R16","Melbourne",4,9,33,"Fremantle",6,11,47,"Cazaly's Stadium",-14,2020,"Regular",16,"Away","Fremantle","Melbourne",14
15747,2020-09-08,"R16","Adelaide",8,11,59,"GWS",7,5,47,"Adelaide Oval",12,2020,"Regular",16,"Home","Adelaide","GWS",12
15748,2020-09-08,"R16","Carlton",8,9,57,"Sydney",8,4,52,"Carrara",5,2020,"Regular",16,"Home","Carlton","Sydney",5
15749,2020-09-09,"R16","Brisbane Lions",13,10,88,"Gold Coast",6,7,43,"Gabba",45,2020,"Regular",16,"Home","Brisbane Lions","Gold Coast",45
15750,2020-09-10,"R17","St Kilda",6,14,50,"West Coast",9,11,65,"Gabba",-15,2020,"Regular",17,"Away","West Coast","St Kilda",15
15751,2020-09-11,"R17","Geelong",4,7,31,"Richmond",7,15,57,"Carrara",-26,2020,"Regular",17,"Away","Richmond","Geelong",26
15752,2020-09-12,"R17","North Melbourne",5,5,35,"Fremantle",15,9,99,"Carrara",-64,2020,"Regular",17,"Away","Fremantle","North Melbourne",64
15753,2020-09-12,"R17","Port Adelaide",11,13,79,"Essendon",4,5,29,"Adelaide Oval",50,2020,"Regular",17,"Home","Port Adelaide","Essendon",50
15754,2020-09-12,"R17","GWS",11,8,74,"Melbourne",12,7,79,"Gabba",-5,2020,"Regular",17,"Away","Melbourne","GWS",5
15755,2020-09-13,"R17","Carlton",8,8,56,"Adelaide",10,12,72,"Carrara",-16,2020,"Regular",17,"Away","Adelaide","Carlton",16
15756,2020-09-13,"R17","Hawthorn",6,4,40,"Footscray",11,10,76,"Adelaide Oval",-36,2020,"Regular",17,"Away","Footscray","Hawthorn",36
15757,2020-09-13,"R17","Sydney",6,5,41,"Brisbane Lions",11,7,73,"Cazaly's Stadium",-32,2020,"Regular",17,"Away","Brisbane Lions","Sydney",32
15758,2020-09-14,"R17","Collingwood",10,8,68,"Gold Coast",6,10,46,"Gabba",22,2020,"Regular",17,"Home","Collingwood","Gold Coast",22
15759,2020-09-17,"R18","North Melbourne",4,10,34,"West Coast",7,7,49,"Carrara",-15,2020,"Regular",18,"Away","West Coast","North Melbourne",15
15760,2020-09-18,"R18","St Kilda",12,10,82,"GWS",3,12,30,"Gabba",52,2020,"Regular",18,"Home","St Kilda","GWS",52
15761,2020-09-19,"R18","Essendon",7,7,49,"Melbourne",10,8,68,"Carrara",-19,2020,"Regular",18,"Away","Melbourne","Essendon",19
15762,2020-09-19,"R18","Adelaide",4,9,33,"Richmond",12,5,77,"Adelaide Oval",-44,2020,"Regular",18,"Away","Richmond","Adelaide",44
15763,2020-09-19,"R18","Brisbane Lions",11,12,78,"Carlton",10,1,61,"Gabba",17,2020,"Regular",18,"Home","Brisbane Lions","Carlton",17
15764,2020-09-20,"R18","Hawthorn",17,6,108,"Gold Coast",8,9,57,"Adelaide Oval",51,2020,"Regular",18,"Home","Hawthorn","Gold Coast",51
15765,2020-09-20,"R18","Sydney",9,9,63,"Geelong",10,9,69,"Carrara",-6,2020,"Regular",18,"Away","Geelong","Sydney",6
15766,2020-09-20,"R18","Fremantle",6,8,44,"Footscray",11,8,74,"Cazaly's Stadium",-30,2020,"Regular",18,"Away","Footscray","Fremantle",30
15767,2020-09-21,"R18","Collingwood",7,3,45,"Port Adelaide",9,7,61,"Gabba",-16,2020,"Regular",18,"Away","Port Adelaide","Collingwood",16
15768,2020-10-01,"QF","Port Adelaide",9,4,58,"Geelong",5,12,42,"Adelaide Oval",16,2020,"Finals",19,"Home","Port Adelaide","Geelong",16
15769,2020-10-02,"QF","Brisbane Lions",10,9,69,"Richmond",8,6,54,"Gabba",15,2020,"Finals",19,"Home","Brisbane Lions","Richmond",15
15770,2020-10-03,"EF","St Kilda",10,7,67,"Footscray",9,10,64,"Gabba",3,2020,"Finals",19,"Home","St Kilda","Footscray",3
15771,2020-10-03,"EF","West Coast",11,9,75,"Collingwood",12,4,76,"Perth Stadium",-1,2020,"Finals",19,"Away","Collingwood","West Coast",1
15772,2020-10-09,"SF","Richmond",12,8,80,"St Kilda",6,13,49,"Carrara",31,2020,"Finals",20,"Home","Richmond","St Kilda",31
15773,2020-10-10,"SF","Geelong",15,10,100,"Collingwood",5,2,32,"Gabba",68,2020,"Finals",20,"Home","Geelong","Collingwood",68
15774,2020-10-16,"PF","Port Adelaide",6,4,40,"Richmond",6,10,46,"Adelaide Oval",-6,2020,"Finals",21,"Away","Richmond","Port Adelaide",6
15775,2020-10-17,"PF","Brisbane Lions",6,6,42,"Geelong",11,16,82,"Gabba",-40,2020,"Finals",21,"Away","Geelong","Brisbane Lions",40
15776,2020-10-24,"GF","Richmond",12,9,81,"Geelong",7,8,50,"Gabba",31,2020,"Finals",22,"Home","Richmond","Geelong",31
15777,2021-03-18,"R1","Richmond",15,15,105,"Carlton",11,14,80,"M.C.G.",25,2021,"Regular",1,"Home","Richmond","Carlton",25
15778,2021-03-19,"R1","Collingwood",7,11,53,"Footscray",10,9,69,"M.C.G.",-16,2021,"Regular",1,"Away","Footscray","Collingwood",16
15779,2021-03-20,"R1","Melbourne",11,14,80,"Fremantle",8,10,58,"M.C.G.",22,2021,"Regular",1,"Home","Melbourne","Fremantle",22
15780,2021-03-20,"R1","Adelaide",15,13,103,"Geelong",13,13,91,"Adelaide Oval",12,2021,"Regular",1,"Home","Adelaide","Geelong",12
15781,2021-03-20,"R1","Essendon",13,13,91,"Hawthorn",14,8,92,"Docklands",-1,2021,"Regular",1,"Away","Hawthorn","Essendon",1
15782,2021-03-20,"R1","Brisbane Lions",14,10,94,"Sydney",19,11,125,"Gabba",-31,2021,"Regular",1,"Away","Sydney","Brisbane Lions",31
15783,2021-03-21,"R1","North Melbourne",9,11,65,"Port Adelaide",17,15,117,"Docklands",-52,2021,"Regular",1,"Away","Port Adelaide","North Melbourne",52
15784,2021-03-21,"R1","GWS",11,12,78,"St Kilda",13,8,86,"Sydney Showground",-8,2021,"Regular",1,"Away","St Kilda","GWS",8
15785,2021-03-21,"R1","West Coast",12,11,83,"Gold Coast",8,10,58,"Perth Stadium",25,2021,"Regular",1,"Home","West Coast","Gold Coast",25
15786,2021-03-25,"R2","Carlton",13,7,85,"Collingwood",16,10,106,"M.C.G.",-21,2021,"Regular",2,"Away","Collingwood","Carlton",21
15787,2021-03-26,"R2","Geelong",12,9,81,"Brisbane Lions",11,14,80,"Kardinia Park",1,2021,"Regular",2,"Home","Geelong","Brisbane Lions",1
15788,2021-03-27,"R2","Sydney",18,13,121,"Adelaide",11,22,88,"S.C.G.",33,2021,"Regular",2,"Home","Sydney","Adelaide",33
15789,2021-03-27,"R2","Port Adelaide",18,11,119,"Essendon",9,11,65,"Adelaide Oval",54,2021,"Regular",2,"Home","Port Adelaide","Essendon",54
15790,2021-03-27,"R2","St Kilda",11,7,73,"Melbourne",12,19,91,"Docklands",-18,2021,"Regular",2,"Away","Melbourne","St Kilda",18
15791,2021-03-27,"R2","Gold Coast",14,14,98,"North Melbourne",5,9,39,"Carrara",59,2021,"Regular",2,"Home","Gold Coast","North Melbourne",59
15792,2021-03-28,"R2","Hawthorn",7,7,49,"Richmond",11,12,78,"M.C.G.",-29,2021,"Regular",2,"Away","Richmond","Hawthorn",29
15793,2021-03-28,"R2","Footscray",14,16,100,"West Coast",14,9,93,"Docklands",7,2021,"Regular",2,"Home","Footscray","West Coast",7
15794,2021-03-28,"R2","Fremantle",11,21,87,"GWS",7,14,56,"Perth Stadium",31,2021,"Regular",2,"Home","Fremantle","GWS",31
15795,2021-04-01,"R3","Collingwood",11,6,72,"Brisbane Lions",11,7,73,"Docklands",-1,2021,"Regular",3,"Away","Brisbane Lions","Collingwood",1
15796,2021-04-02,"R3","North Melbourne",5,9,39,"Footscray",25,17,167,"Docklands",-128,2021,"Regular",3,"Away","Footscray","North Melbourne",128
15797,2021-04-02,"R3","Adelaide",14,11,95,"Gold Coast",12,13,85,"Adelaide Oval",10,2021,"Regular",3,"Home","Adelaide","Gold Coast",10
15798,2021-04-03,"R3","Richmond",10,12,72,"Sydney",17,15,117,"M.C.G.",-45,2021,"Regular",3,"Away","Sydney","Richmond",45
15799,2021-04-03,"R3","Essendon",22,11,143,"St Kilda",9,14,68,"Docklands",75,2021,"Regular",3,"Home","Essendon","St Kilda",75
15800,2021-04-03,"R3","West Coast",16,12,108,"Port Adelaide",11,5,71,"Perth Stadium",37,2021,"Regular",3,"Home","West Coast","Port Adelaide",37
15801,2021-04-04,"R3","Carlton",16,13,109,"Fremantle",9,10,64,"Docklands",45,2021,"Regular",3,"Home","Carlton","Fremantle",45
15802,2021-04-04,"R3","GWS",11,2,68,"Melbourne",15,12,102,"Manuka Oval",-34,2021,"Regular",3,"Away","Melbourne","GWS",34
15803,2021-04-05,"R3","Geelong",10,9,69,"Hawthorn",9,10,64,"M.C.G.",5,2021,"Regular",3,"Home","Geelong","Hawthorn",5
15804,2021-04-08,"R4","Sydney",11,17,83,"Essendon",12,8,80,"S.C.G.",3,2021,"Regular",4,"Home","Sydney","Essendon",3
15805,2021-04-09,"R4","Port Adelaide",11,13,79,"Richmond",11,11,77,"Adelaide Oval",2,2021,"Regular",4,"Home","Port Adelaide","Richmond",2
15806,2021-04-10,"R4","Footscray",10,13,73,"Brisbane Lions",8,6,54,"Eureka Stadium",19,2021,"Regular",4,"Home","Footscray","Brisbane Lions",19
15807,2021-04-10,"R4","St Kilda",15,12,102,"West Coast",13,4,82,"Docklands",20,2021,"Regular",4,"Home","St Kilda","West Coast",20
15808,2021-04-10,"R4","Gold Coast",8,11,59,"Carlton",9,16,70,"Carrara",-11,2021,"Regular",4,"Away","Carlton","Gold Coast",11
15809,2021-04-10,"R4","Collingwood",9,6,60,"GWS",14,6,90,"M.C.G.",-30,2021,"Regular",4,"Away","GWS","Collingwood",30
15810,2021-04-11,"R4","North Melbourne",10,8,68,"Adelaide",16,13,109,"Docklands",-41,2021,"Regular",4,"Away","Adelaide","North Melbourne",41
15811,2021-04-11,"R4","Melbourne",12,13,85,"Geelong",9,6,60,"M.C.G.",25,2021,"Regular",4,"Home","Melbourne","Geelong",25
15812,2021-04-11,"R4","Fremantle",13,18,96,"Hawthorn",12,9,81,"Perth Stadium",15,2021,"Regular",4,"Home","Fremantle","Hawthorn",15
15813,2021-04-15,"R5","St Kilda",7,6,48,"Richmond",20,14,134,"Docklands",-86,2021,"Regular",5,"Away","Richmond","St Kilda",86
15814,2021-04-16,"R5","West Coast",16,7,103,"Collingwood",11,10,76,"Perth Stadium",27,2021,"Regular",5,"Home","West Coast","Collingwood",27
15815,2021-04-17,"R5","Footscray",17,16,118,"Gold Coast",8,8,56,"Docklands",62,2021,"Regular",5,"Home","Footscray","Gold Coast",62
15816,2021-04-17,"R5","Sydney",10,9,69,"GWS",9,17,71,"S.C.G.",-2,2021,"Regular",5,"Away","GWS","Sydney",2
15817,2021-04-17,"R5","Carlton",9,14,68,"Port Adelaide",15,6,96,"M.C.G.",-28,2021,"Regular",5,"Away","Port Adelaide","Carlton",28
15818,2021-04-17,"R5","Brisbane Lions",15,12,102,"Essendon",6,9,45,"Gabba",57,2021,"Regular",5,"Home","Brisbane Lions","Essendon",57
15819,2021-04-18,"R5","Adelaide",11,6,72,"Fremantle",12,12,84,"Adelaide Oval",-12,2021,"Regular",5,"Away","Fremantle","Adelaide",12
15820,2021-04-18,"R5","Hawthorn",8,6,54,"Melbourne",15,14,104,"M.C.G.",-50,2021,"Regular",5,"Away","Melbourne","Hawthorn",50
15821,2021-04-18,"R5","Geelong",10,17,77,"North Melbourne",7,5,47,"Kardinia Park",30,2021,"Regular",5,"Home","Geelong","North Melbourne",30
15822,2021-04-23,"R6","GWS",9,11,65,"Footscray",15,14,104,"Manuka Oval",-39,2021,"Regular",6,"Away","Footscray","GWS",39
15823,2021-04-24,"R6","Geelong",21,10,136,"West Coast",5,9,39,"Kardinia Park",97,2021,"Regular",6,"Home","Geelong","West Coast",97
15824,2021-04-24,"R6","Gold Coast",15,10,100,"Sydney",9,6,60,"Carrara",40,2021,"Regular",6,"Home","Gold Coast","Sydney",40
15825,2021-04-24,"R6","Carlton",12,13,85,"Brisbane Lions",15,13,103,"Docklands",-18,2021,"Regular",6,"Away","Brisbane Lions","Carlton",18
15826,2021-04-24,"R6","Melbourne",12,10,82,"Richmond",6,12,48,"M.C.G.",34,2021,"Regular",6,"Home","Melbourne","Richmond",34
15827,2021-04-24,"R6","Fremantle",14,15,99,"North Melbourne",6,12,48,"Perth Stadium",51,2021,"Regular",6,"Home","Fremantle","North Melbourne",51
15828,2021-04-25,"R6","Hawthorn",15,12,102,"Adelaide",16,3,99,"York Park",3,2021,"Regular",6,"Home","Hawthorn","Adelaide",3
15829,2021-04-25,"R6","Collingwood",13,7,85,"Essendon",16,13,109,"M.C.G.",-24,2021,"Regular",6,"Away","Essendon","Collingwood",24
15830,2021-04-25,"R6","Port Adelaide",14,9,93,"St Kilda",5,9,39,"Adelaide Oval",54,2021,"Regular",6,"Home","Port Adelaide","St Kilda",54
15831,2021-04-30,"R7","Richmond",11,11,77,"Footscray",7,13,55,"M.C.G.",22,2021,"Regular",7,"Home","Richmond","Footscray",22
15832,2021-05-01,"R7","Collingwood",7,13,55,"Gold Coast",12,7,79,"M.C.G.",-24,2021,"Regular",7,"Away","Gold Coast","Collingwood",24
15833,2021-05-01,"R7","Adelaide",4,15,39,"GWS",15,16,106,"Adelaide Oval",-67,2021,"Regular",7,"Away","GWS","Adelaide",67
15834,2021-05-01,"R7","St Kilda",19,14,128,"Hawthorn",9,5,59,"Docklands",69,2021,"Regular",7,"Home","St Kilda","Hawthorn",69
15835,2021-05-01,"R7","Sydney",14,6,90,"Geelong",12,16,88,"S.C.G.",2,2021,"Regular",7,"Home","Sydney","Geelong",2
15836,2021-05-01,"R7","Brisbane Lions",13,15,93,"Port Adelaide",5,14,44,"Gabba",49,2021,"Regular",7,"Home","Brisbane Lions","Port Adelaide",49
15837,2021-05-02,"R7","North Melbourne",11,7,73,"Melbourne",16,7,103,"Bellerive Oval",-30,2021,"Regular",7,"Away","Melbourne","North Melbourne",30
15838,2021-05-02,"R7","Essendon",16,11,107,"Carlton",19,9,123,"M.C.G.",-16,2021,"Regular",7,"Away","Carlton","Essendon",16
15839,2021-05-02,"R7","West Coast",20,12,132,"Fremantle",11,7,73,"Perth Stadium",59,2021,"Regular",7,"Home","West Coast","Fremantle",59
15840,2021-05-07,"R8","Richmond",9,9,63,"Geelong",19,12,126,"M.C.G.",-63,2021,"Regular",8,"Away","Geelong","Richmond",63
15841,2021-05-08,"R8","Gold Coast",7,12,54,"St Kilda",8,15,63,"Carrara",-9,2021,"Regular",8,"Away","St Kilda","Gold Coast",9
15842,2021-05-08,"R8","GWS",16,11,107,"Essendon",16,9,105,"Sydney Showground",2,2021,"Regular",8,"Home","GWS","Essendon",2
15843,2021-05-08,"R8","North Melbourne",11,10,76,"Collingwood",14,10,94,"Docklands",-18,2021,"Regular",8,"Away","Collingwood","North Melbourne",18
15844,2021-05-08,"R8","Melbourne",10,7,67,"Sydney",8,10,58,"M.C.G.",9,2021,"Regular",8,"Home","Melbourne","Sydney",9
15845,2021-05-08,"R8","Port Adelaide",12,15,87,"Adelaide",5,8,38,"Adelaide Oval",49,2021,"Regular",8,"Home","Port Adelaide","Adelaide",49
15846,2021-05-09,"R8","Hawthorn",8,12,60,"West Coast",14,14,98,"M.C.G.",-38,2021,"Regular",8,"Away","West Coast","Hawthorn",38
15847,2021-05-09,"R8","Footscray",16,11,107,"Carlton",13,13,91,"Docklands",16,2021,"Regular",8,"Home","Footscray","Carlton",16
15848,2021-05-09,"R8","Brisbane Lions",14,11,95,"Fremantle",10,11,71,"Gabba",24,2021,"Regular",8,"Home","Brisbane Lions","Fremantle",24
15849,2021-05-14,"R9","St Kilda",5,17,47,"Geelong",10,8,68,"Docklands",-21,2021,"Regular",9,"Away","Geelong","St Kilda",21
15850,2021-05-15,"R9","Sydney",10,12,72,"Collingwood",5,12,42,"S.C.G.",30,2021,"Regular",9,"Home","Sydney","Collingwood",30
15851,2021-05-15,"R9","Hawthorn",12,8,80,"North Melbourne",13,9,87,"York Park",-7,2021,"Regular",9,"Away","North Melbourne","Hawthorn",7
15852,2021-05-15,"R9","Gold Coast",7,9,51,"Brisbane Lions",19,10,124,"Carrara",-73,2021,"Regular",9,"Away","Brisbane Lions","Gold Coast",73
15853,2021-05-15,"R9","Richmond",13,9,87,"GWS",12,11,83,"Docklands",4,2021,"Regular",9,"Home","Richmond","GWS",4
15854,2021-05-15,"R9","Port Adelaide",12,5,77,"Footscray",15,6,96,"Adelaide Oval",-19,2021,"Regular",9,"Away","Footscray","Port Adelaide",19
15855,2021-05-16,"R9","Essendon",10,8,68,"Fremantle",8,13,61,"Docklands",7,2021,"Regular",9,"Home","Essendon","Fremantle",7
15856,2021-05-16,"R9","Melbourne",13,16,94,"Carlton",10,8,68,"M.C.G.",26,2021,"Regular",9,"Home","Melbourne","Carlton",26
15857,2021-05-16,"R9","West Coast",16,10,106,"Adelaide",11,10,76,"Perth Stadium",30,2021,"Regular",9,"Home","West Coast","Adelaide",30
15858,2021-05-21,"R10","Brisbane Lions",15,12,102,"Richmond",11,8,74,"Gabba",28,2021,"Regular",10,"Home","Brisbane Lions","Richmond",28
15859,2021-05-22,"R10","Carlton",13,8,86,"Hawthorn",9,9,63,"M.C.G.",23,2021,"Regular",10,"Home","Carlton","Hawthorn",23
15860,2021-05-22,"R10","Geelong",14,7,91,"Gold Coast",8,9,57,"Kardinia Park",34,2021,"Regular",10,"Home","Geelong","Gold Coast",34
15861,2021-05-22,"R10","Adelaide",15,6,96,"Melbourne",14,11,95,"Adelaide Oval",1,2021,"Regular",10,"Home","Adelaide","Melbourne",1
15862,2021-05-22,"R10","Footscray",21,18,144,"St Kilda",5,3,33,"Docklands",111,2021,"Regular",10,"Home","Footscray","St Kilda",111
15863,2021-05-22,"R10","Fremantle",12,14,86,"Sydney",13,6,84,"Perth Stadium",2,2021,"Regular",10,"Home","Fremantle","Sydney",2
15864,2021-05-23,"R10","GWS",13,15,93,"West Coast",11,11,77,"Sydney Showground",16,2021,"Regular",10,"Home","GWS","West Coast",16
15865,2021-05-23,"R10","Collingwood",8,10,58,"Port Adelaide",8,11,59,"M.C.G.",-1,2021,"Regular",10,"Away","Port Adelaide","Collingwood",1
15866,2021-05-23,"R10","Essendon",22,9,141,"North Melbourne",10,9,69,"Docklands",72,2021,"Regular",10,"Home","Essendon","North Melbourne",72
15867,2021-05-28,"R11","Footscray",8,11,59,"Melbourne",13,9,87,"Docklands",-28,2021,"Regular",11,"Away","Melbourne","Footscray",28
15868,2021-05-29,"R11","Collingwood",6,15,51,"Geelong",8,13,61,"M.C.G.",-10,2021,"Regular",11,"Away","Geelong","Collingwood",10
15869,2021-05-29,"R11","Brisbane Lions",19,15,129,"GWS",10,5,65,"Gabba",64,2021,"Regular",11,"Home","Brisbane Lions","GWS",64
15870,2021-05-29,"R11","St Kilda",12,16,88,"North Melbourne",10,8,68,"Docklands",20,2021,"Regular",11,"Home","St Kilda","North Melbourne",20
15871,2021-05-29,"R11","West Coast",11,5,71,"Essendon",12,15,87,"Perth Stadium",-16,2021,"Regular",11,"Away","Essendon","West Coast",16
15872,2021-05-29,"R11","Gold Coast",17,11,113,"Hawthorn",11,10,76,"S.C.G.",37,2021,"Regular",11,"Home","Gold Coast","Hawthorn",37
15873,2021-05-30,"R11","Richmond",17,9,111,"Adelaide",12,11,83,"Sydney Showground",28,2021,"Regular",11,"Home","Richmond","Adelaide",28
15874,2021-05-30,"R11","Sydney",15,10,100,"Carlton",11,12,78,"S.C.G.",22,2021,"Regular",11,"Home","Sydney","Carlton",22
15875,2021-05-30,"R11","Port Adelaide",18,7,115,"Fremantle",9,15,69,"Adelaide Oval",46,2021,"Regular",11,"Home","Port Adelaide","Fremantle",46
15876,2021-06-04,"R12","Melbourne",14,13,97,"Brisbane Lions",11,9,75,"Sydney Showground",22,2021,"Regular",12,"Home","Melbourne","Brisbane Lions",22
15877,2021-06-05,"R12","Sydney",13,14,92,"St Kilda",12,11,83,"S.C.G.",9,2021,"Regular",12,"Home","Sydney","St Kilda",9
15878,2021-06-05,"R12","Adelaide",10,13,73,"Collingwood",12,6,78,"Adelaide Oval",-5,2021,"Regular",12,"Away","Collingwood","Adelaide",5
15879,2021-06-05,"R12","Essendon",12,12,84,"Richmond",19,9,123,"Perth Stadium",-39,2021,"Regular",12,"Away","Richmond","Essendon",39
15880,2021-06-06,"R12","Carlton",10,13,73,"West Coast",14,11,95,"S.C.G.",-22,2021,"Regular",12,"Away","West Coast","Carlton",22
15881,2021-06-06,"R12","Fremantle",9,11,65,"Footscray",13,15,93,"Perth Stadium",-28,2021,"Regular",12,"Away","Footscray","Fremantle",28
15882,2021-06-10,"R13","Port Adelaide",14,7,91,"Geelong",17,10,112,"Adelaide Oval",-21,2021,"Regular",13,"Away","Geelong","Port Adelaide",21
15883,2021-06-11,"R13","Sydney",7,9,51,"Hawthorn",14,5,89,"S.C.G.",-38,2021,"Regular",13,"Away","Hawthorn","Sydney",38
15884,2021-06-12,"R13","Fremantle",11,10,76,"Gold Coast",6,13,49,"Perth Stadium",27,2021,"Regular",13,"Home","Fremantle","Gold Coast",27
15885,2021-06-12,"R13","St Kilda",8,12,60,"Adelaide",9,12,66,"Cazaly's Stadium",-6,2021,"Regular",13,"Away","Adelaide","St Kilda",6
15886,2021-06-13,"R13","North Melbourne",14,10,94,"GWS",14,10,94,"Bellerive Oval",0,2021,"Regular",13,"Home","North Melbourne","GWS",0
15887,2021-06-13,"R13","West Coast",13,7,85,"Richmond",12,9,81,"Perth Stadium",4,2021,"Regular",13,"Home","West Coast","Richmond",4
15888,2021-06-14,"R13","Melbourne",9,9,63,"Collingwood",11,14,80,"S.C.G.",-17,2021,"Regular",13,"Away","Collingwood","Melbourne",17
15889,2021-06-18,"R14","Geelong",12,11,83,"Footscray",11,12,78,"Kardinia Park",5,2021,"Regular",14,"Home","Geelong","Footscray",5
15890,2021-06-19,"R14","Gold Coast",4,7,31,"Port Adelaide",12,9,81,"Carrara",-50,2021,"Regular",14,"Away","Port Adelaide","Gold Coast",50
15891,2021-06-19,"R14","North Melbourne",6,9,45,"Brisbane Lions",9,14,68,"Bellerive Oval",-23,2021,"Regular",14,"Away","Brisbane Lions","North Melbourne",23
15892,2021-06-19,"R14","GWS",16,6,102,"Carlton",9,12,66,"Sydney Showground",36,2021,"Regular",14,"Home","GWS","Carlton",36
15893,2021-06-20,"R14","Hawthorn",10,13,73,"Essendon",13,8,86,"York Park",-13,2021,"Regular",14,"Away","Essendon","Hawthorn",13
15894,2021-06-24,"R15","Brisbane Lions",13,16,94,"Geelong",7,8,50,"Gabba",44,2021,"Regular",15,"Home","Brisbane Lions","Geelong",44
15895,2021-06-25,"R15","Richmond",2,10,22,"St Kilda",9,8,62,"M.C.G.",-40,2021,"Regular",15,"Away","St Kilda","Richmond",40
15896,2021-06-26,"R15","Collingwood",12,7,79,"Fremantle",14,7,91,"Docklands",-12,2021,"Regular",15,"Away","Fremantle","Collingwood",12
15897,2021-06-26,"R15","North Melbourne",9,18,72,"Gold Coast",9,9,63,"Bellerive Oval",9,2021,"Regular",15,"Home","North Melbourne","Gold Coast",9
15898,2021-06-26,"R15","Port Adelaide",12,9,81,"Sydney",10,11,71,"Adelaide Oval",10,2021,"Regular",15,"Home","Port Adelaide","Sydney",10
15899,2021-06-26,"R15","Essendon",8,9,57,"Melbourne",9,14,68,"M.C.G.",-11,2021,"Regular",15,"Away","Melbourne","Essendon",11
15900,2021-06-27,"R15","GWS",11,6,72,"Hawthorn",13,12,90,"M.C.G.",-18,2021,"Regular",15,"Away","Hawthorn","GWS",18
15901,2021-06-27,"R15","West Coast",6,7,43,"Footscray",13,20,98,"Perth Stadium",-55,2021,"Regular",15,"Away","Footscray","West Coast",55
15902,2021-06-27,"R15","Carlton",12,11,83,"Adelaide",10,13,73,"Docklands",10,2021,"Regular",15,"Home","Carlton","Adelaide",10
15903,2021-07-01,"R16","Gold Coast",10,17,77,"Richmond",10,7,67,"Docklands",10,2021,"Regular",16,"Home","Gold Coast","Richmond",10
15904,2021-07-02,"R16","Geelong",15,8,98,"Essendon",8,9,57,"Kardinia Park",41,2021,"Regular",16,"Home","Geelong","Essendon",41
15905,2021-07-03,"R16","Melbourne",7,13,55,"GWS",9,10,64,"M.C.G.",-9,2021,"Regular",16,"Away","GWS","Melbourne",9
15906,2021-07-03,"R16","Adelaide",8,11,59,"Brisbane Lions",17,9,111,"Adelaide Oval",-52,2021,"Regular",16,"Away","Brisbane Lions","Adelaide",52
15907,2021-07-03,"R16","Fremantle",8,16,64,"Carlton",12,8,80,"M.C.G.",-16,2021,"Regular",16,"Away","Carlton","Fremantle",16
15908,2021-07-03,"R16","Hawthorn",7,11,53,"Port Adelaide",13,9,87,"Docklands",-34,2021,"Regular",16,"Away","Port Adelaide","Hawthorn",34
15909,2021-07-04,"R16","Sydney",18,10,118,"West Coast",3,8,26,"Kardinia Park",92,2021,"Regular",16,"Home","Sydney","West Coast",92
15910,2021-07-04,"R16","Collingwood",8,13,61,"St Kilda",10,10,70,"M.C.G.",-9,2021,"Regular",16,"Away","St Kilda","Collingwood",9
15911,2021-07-04,"R16","Footscray",16,12,108,"North Melbourne",11,13,79,"Docklands",29,2021,"Regular",16,"Home","Footscray","North Melbourne",29
15912,2021-07-08,"R17","Port Adelaide",8,7,55,"Melbourne",12,14,86,"Adelaide Oval",-31,2021,"Regular",17,"Away","Melbourne","Port Adelaide",31
15913,2021-07-09,"R17","Essendon",11,18,84,"Adelaide",2,9,21,"Docklands",63,2021,"Regular",17,"Home","Essendon","Adelaide",63
15914,2021-07-10,"R17","Hawthorn",6,10,46,"Fremantle",16,12,108,"York Park",-62,2021,"Regular",17,"Away","Fremantle","Hawthorn",62
15915,2021-07-10,"R17","Carlton",5,14,44,"Geelong",10,10,70,"M.C.G.",-26,2021,"Regular",17,"Away","Geelong","Carlton",26
15916,2021-07-10,"R17","Brisbane Lions",8,15,63,"St Kilda",14,11,95,"Carrara",-32,2021,"Regular",17,"Away","St Kilda","Brisbane Lions",32
15917,2021-07-11,"R17","GWS",9,10,64,"Gold Coast",10,5,65,"Eureka Stadium",-1,2021,"Regular",17,"Away","Gold Coast","GWS",1
15918,2021-07-11,"R17","Footscray",8,12,60,"Sydney",11,13,79,"Docklands",-19,2021,"Regular",17,"Away","Sydney","Footscray",19
15919,2021-07-11,"R17","Richmond",11,5,71,"Collingwood",13,9,87,"M.C.G.",-16,2021,"Regular",17,"Away","Collingwood","Richmond",16
15920,2021-07-12,"R17","West Coast",8,12,60,"North Melbourne",10,10,70,"Perth Stadium",-10,2021,"Regular",17,"Away","North Melbourne","West Coast",10
15921,2021-07-15,"R18","Fremantle",3,13,31,"Geelong",14,16,100,"Perth Stadium",-69,2021,"Regular",18,"Away","Geelong","Fremantle",69
15922,2021-07-16,"R18","Richmond",16,10,106,"Brisbane Lions",13,8,86,"Carrara",20,2021,"Regular",18,"Home","Richmond","Brisbane Lions",20
15923,2021-07-17,"R18","St Kilda",8,13,61,"Port Adelaide",10,14,74,"Docklands",-13,2021,"Regular",18,"Away","Port Adelaide","St Kilda",13
15924,2021-07-17,"R18","Gold Coast",11,13,79,"Footscray",14,6,90,"Carrara",-11,2021,"Regular",18,"Away","Footscray","Gold Coast",11
15925,2021-07-17,"R18","Melbourne",11,13,79,"Hawthorn",12,7,79,"M.C.G.",0,2021,"Regular",18,"Home","Melbourne","Hawthorn",0
15926,2021-07-18,"R18","North Melbourne",11,8,74,"Essendon",13,14,92,"Carrara",-18,2021,"Regular",18,"Away","Essendon","North Melbourne",18
15927,2021-07-18,"R18","Collingwood",9,8,62,"Carlton",13,13,91,"M.C.G.",-29,2021,"Regular",18,"Away","Carlton","Collingwood",29
15928,2021-07-18,"R18","Adelaide",8,8,56,"West Coast",14,14,98,"Adelaide Oval",-42,2021,"Regular",18,"Away","West Coast","Adelaide",42
15929,2021-07-18,"R18","GWS",11,6,72,"Sydney",15,8,98,"Carrara",-26,2021,"Regular",18,"Away","Sydney","GWS",26
15930,2021-07-23,"R19","Port Adelaide",14,13,97,"Collingwood",10,9,69,"Docklands",28,2021,"Regular",19,"Home","Port Adelaide","Collingwood",28
15931,2021-07-24,"R19","Carlton",11,11,77,"North Melbourne",18,8,116,"Docklands",-39,2021,"Regular",19,"Away","North Melbourne","Carlton",39
15932,2021-07-24,"R19","Brisbane Lions",17,18,120,"Gold Coast",10,11,71,"Gabba",49,2021,"Regular",19,"Home","Brisbane Lions","Gold Coast",49
15933,2021-07-24,"R19","West Coast",14,10,94,"St Kilda",13,8,86,"Perth Stadium",8,2021,"Regular",19,"Home","West Coast","St Kilda",8
15934,2021-07-24,"R19","Melbourne",9,11,65,"Footscray",13,7,85,"M.C.G.",-20,2021,"Regular",19,"Away","Footscray","Melbourne",20
15935,2021-07-24,"R19","Adelaide",16,6,102,"Hawthorn",13,5,83,"Docklands",19,2021,"Regular",19,"Home","Adelaide","Hawthorn",19
15936,2021-07-25,"R19","Sydney",14,14,98,"Fremantle",8,10,58,"Carrara",40,2021,"Regular",19,"Home","Sydney","Fremantle",40
15937,2021-07-25,"R19","Geelong",15,5,95,"Richmond",8,9,57,"M.C.G.",38,2021,"Regular",19,"Home","Geelong","Richmond",38
15938,2021-07-25,"R19","Essendon",7,11,53,"GWS",9,12,66,"Carrara",-13,2021,"Regular",19,"Away","GWS","Essendon",13
15939,2021-07-30,"R20","St Kilda",12,9,81,"Carlton",18,4,112,"Docklands",-31,2021,"Regular",20,"Away","Carlton","St Kilda",31
15940,2021-07-31,"R20","Footscray",15,15,105,"Adelaide",8,8,56,"Eureka Stadium",49,2021,"Regular",20,"Home","Footscray","Adelaide",49
15941,2021-07-31,"R20","North Melbourne",6,6,42,"Geelong",8,14,62,"Bellerive Oval",-20,2021,"Regular",20,"Away","Geelong","North Melbourne",20
15942,2021-07-31,"R20","Collingwood",14,6,90,"West Coast",6,9,45,"M.C.G.",45,2021,"Regular",20,"Home","Collingwood","West Coast",45
15943,2021-08-01,"R20","Gold Coast",4,6,30,"Melbourne",18,20,128,"Docklands",-98,2021,"Regular",20,"Away","Melbourne","Gold Coast",98
15944,2021-08-01,"R20","Hawthorn",14,8,92,"Brisbane Lions",12,8,80,"York Park",12,2021,"Regular",20,"Home","Hawthorn","Brisbane Lions",12
15945,2021-08-01,"R20","Essendon",16,6,102,"Sydney",17,7,109,"M.C.G.",-7,2021,"Regular",20,"Away","Sydney","Essendon",7
15946,2021-08-01,"R20","Fremantle",7,13,55,"Richmond",6,15,51,"Perth Stadium",4,2021,"Regular",20,"Home","Fremantle","Richmond",4
15947,2021-08-01,"R20","GWS",11,7,73,"Port Adelaide",15,10,100,"Docklands",-27,2021,"Regular",20,"Away","Port Adelaide","GWS",27
15948,2021-08-06,"R21","Geelong",8,17,65,"GWS",13,6,84,"Kardinia Park",-19,2021,"Regular",21,"Away","GWS","Geelong",19
15949,2021-08-07,"R21","Carlton",8,9,57,"Gold Coast",11,10,76,"Docklands",-19,2021,"Regular",21,"Away","Gold Coast","Carlton",19
15950,2021-08-07,"R21","Richmond",13,11,89,"North Melbourne",8,8,56,"M.C.G.",33,2021,"Regular",21,"Home","Richmond","North Melbourne",33
15951,2021-08-07,"R21","Adelaide",7,9,51,"Port Adelaide",7,13,55,"Adelaide Oval",-4,2021,"Regular",21,"Away","Port Adelaide","Adelaide",4
15952,2021-08-07,"R21","St Kilda",14,9,93,"Sydney",10,4,64,"Docklands",29,2021,"Regular",21,"Home","St Kilda","Sydney",29
15953,2021-08-08,"R21","Hawthorn",15,7,97,"Collingwood",12,6,78,"M.C.G.",19,2021,"Regular",21,"Home","Hawthorn","Collingwood",19
15954,2021-08-08,"R21","Footscray",12,12,84,"Essendon",15,7,97,"Docklands",-13,2021,"Regular",21,"Away","Essendon","Footscray",13
15955,2021-08-08,"R21","Fremantle",8,6,54,"Brisbane Lions",18,10,118,"Perth Stadium",-64,2021,"Regular",21,"Away","Brisbane Lions","Fremantle",64
15956,2021-08-09,"R21","West Coast",9,9,63,"Melbourne",10,12,72,"Perth Stadium",-9,2021,"Regular",21,"Away","Melbourne","West Coast",9
15957,2021-08-13,"R22","GWS",16,10,106,"Richmond",10,7,67,"Docklands",39,2021,"Regular",22,"Home","GWS","Richmond",39
15958,2021-08-14,"R22","Hawthorn",9,10,64,"Footscray",5,7,37,"York Park",27,2021,"Regular",22,"Home","Hawthorn","Footscray",27
15959,2021-08-14,"R22","Port Adelaide",21,14,140,"Carlton",5,15,45,"Adelaide Oval",95,2021,"Regular",22,"Home","Port Adelaide","Carlton",95
15960,2021-08-14,"R22","Geelong",13,7,85,"St Kilda",11,5,71,"Kardinia Park",14,2021,"Regular",22,"Home","Geelong","St Kilda",14
15961,2021-08-14,"R22","Brisbane Lions",22,10,142,"Collingwood",8,9,57,"Gabba",85,2021,"Regular",22,"Home","Brisbane Lions","Collingwood",85
15962,2021-08-14,"R22","North Melbourne",12,5,77,"Sydney",13,13,91,"Docklands",-14,2021,"Regular",22,"Away","Sydney","North Melbourne",14
15963,2021-08-15,"R22","Melbourne",16,8,104,"Adelaide",9,9,63,"M.C.G.",41,2021,"Regular",22,"Home","Melbourne","Adelaide",41
15964,2021-08-15,"R22","Gold Coast",4,6,30,"Essendon",14,14,98,"Kardinia Park",-68,2021,"Regular",22,"Away","Essendon","Gold Coast",68
15965,2021-08-15,"R22","Fremantle",12,7,79,"West Coast",9,10,64,"Perth Stadium",15,2021,"Regular",22,"Home","Fremantle","West Coast",15
15966,2021-08-20,"R23","Footscray",10,4,64,"Port Adelaide",9,12,66,"Docklands",-2,2021,"Regular",23,"Away","Port Adelaide","Footscray",2
15967,2021-08-21,"R23","Richmond",12,11,83,"Hawthorn",12,11,83,"M.C.G.",0,2021,"Regular",23,"Home","Richmond","Hawthorn",0
15968,2021-08-21,"R23","Sydney",21,10,136,"Gold Coast",6,13,49,"Docklands",87,2021,"Regular",23,"Home","Sydney","Gold Coast",87
15969,2021-08-21,"R23","Brisbane Lions",19,11,125,"West Coast",13,9,87,"Gabba",38,2021,"Regular",23,"Home","Brisbane Lions","West Coast",38
15970,2021-08-21,"R23","Geelong",12,5,77,"Melbourne",12,9,81,"Kardinia Park",-4,2021,"Regular",23,"Away","Melbourne","Geelong",4
15971,2021-08-21,"R23","Carlton",11,9,75,"GWS",12,17,89,"Docklands",-14,2021,"Regular",23,"Away","GWS","Carlton",14
15972,2021-08-22,"R23","St Kilda",17,5,107,"Fremantle",6,13,49,"Bellerive Oval",58,2021,"Regular",23,"Home","St Kilda","Fremantle",58
15973,2021-08-22,"R23","Essendon",16,6,102,"Collingwood",9,10,64,"M.C.G.",38,2021,"Regular",23,"Home","Essendon","Collingwood",38
15974,2021-08-22,"R23","Adelaide",13,20,98,"North Melbourne",8,6,54,"Adelaide Oval",44,2021,"Regular",23,"Home","Adelaide","North Melbourne",44
15975,2021-08-27,"QF","Port Adelaide",12,14,86,"Geelong",5,13,43,"Adelaide Oval",43,2021,"Finals",24,"Home","Port Adelaide","Geelong",43
15976,2021-08-28,"EF","Sydney",10,13,73,"GWS",11,8,74,"York Park",-1,2021,"Finals",24,"Away","GWS","Sydney",1
15977,2021-08-28,"QF","Melbourne",13,15,93,"Brisbane Lions",9,6,60,"Adelaide Oval",33,2021,"Finals",24,"Home","Melbourne","Brisbane Lions",33
15978,2021-08-29,"EF","Footscray",13,7,85,"Essendon",4,12,36,"York Park",49,2021,"Finals",24,"Home","Footscray","Essendon",49
15979,2021-09-03,"SF","Geelong",15,13,103,"GWS",10,8,68,"Perth Stadium",35,2021,"Finals",25,"Home","Geelong","GWS",35
15980,2021-09-04,"SF","Brisbane Lions",11,12,78,"Footscray",11,13,79,"Gabba",-1,2021,"Finals",25,"Away","Footscray","Brisbane Lions",1
15981,2021-09-10,"PF","Melbourne",19,11,125,"Geelong",6,6,42,"Perth Stadium",83,2021,"Finals",26,"Home","Melbourne","Geelong",83
15982,2021-09-11,"PF","Port Adelaide",6,9,45,"Footscray",17,14,116,"Adelaide Oval",-71,2021,"Finals",26,"Away","Footscray","Port Adelaide",71
15983,2021-09-25,"GF","Melbourne",21,14,140,"Footscray",10,6,66,"Perth Stadium",74,2021,"Finals",27,"Home","Melbourne","Footscray",74
15984,2022-03-16,"R1","Melbourne",14,13,97,"Footscray",11,5,71,"M.C.G.",26,2022,"Regular",1,"Home","Melbourne","Footscray",26
15985,2022-03-17,"R1","Carlton",14,17,101,"Richmond",11,10,76,"M.C.G.",25,2022,"Regular",1,"Home","Carlton","Richmond",25
15986,2022-03-18,"R1","St Kilda",12,13,85,"Collingwood",15,12,102,"Docklands",-17,2022,"Regular",1,"Away","Collingwood","St Kilda",17
15987,2022-03-19,"R1","Geelong",20,18,138,"Essendon",11,6,72,"M.C.G.",66,2022,"Regular",1,"Home","Geelong","Essendon",66
15988,2022-03-19,"R1","GWS",13,14,92,"Sydney",17,10,112,"Stadium Australia",-20,2022,"Regular",1,"Away","Sydney","GWS",20
15989,2022-03-19,"R1","Brisbane Lions",11,14,80,"Port Adelaide",10,9,69,"Gabba",11,2022,"Regular",1,"Home","Brisbane Lions","Port Adelaide",11
15990,2022-03-20,"R1","Hawthorn",11,12,78,"North Melbourne",8,10,58,"M.C.G.",20,2022,"Regular",1,"Home","Hawthorn","North Melbourne",20
15991,2022-03-20,"R1","Adelaide",12,10,82,"Fremantle",11,17,83,"Adelaide Oval",-1,2022,"Regular",1,"Away","Fremantle","Adelaide",1
15992,2022-03-20,"R1","West Coast",12,8,80,"Gold Coast",16,11,107,"Perth Stadium",-27,2022,"Regular",1,"Away","Gold Coast","West Coast",27
15993,2022-03-24,"R2","Footscray",13,12,90,"Carlton",16,6,102,"Docklands",-12,2022,"Regular",2,"Away","Carlton","Footscray",12
15994,2022-03-25,"R2","Sydney",17,5,107,"Geelong",10,17,77,"S.C.G.",30,2022,"Regular",2,"Home","Sydney","Geelong",30
15995,2022-03-26,"R2","Collingwood",15,10,100,"Adelaide",8,10,58,"M.C.G.",42,2022,"Regular",2,"Home","Collingwood","Adelaide",42
15996,2022-03-26,"R2","Essendon",10,15,75,"Brisbane Lions",15,7,97,"Docklands",-22,2022,"Regular",2,"Away","Brisbane Lions","Essendon",22
15997,2022-03-26,"R2","Port Adelaide",7,14,56,"Hawthorn",19,6,120,"Adelaide Oval",-64,2022,"Regular",2,"Away","Hawthorn","Port Adelaide",64
15998,2022-03-26,"R2","Gold Coast",10,9,69,"Melbourne",12,10,82,"Carrara",-13,2022,"Regular",2,"Away","Melbourne","Gold Coast",13
15999,2022-03-27,"R2","North Melbourne",10,14,74,"West Coast",8,11,59,"Docklands",15,2022,"Regular",2,"Home","North Melbourne","West Coast",15
16000,2022-03-27,"R2","Richmond",16,13,109,"GWS",10,13,73,"M.C.G.",36,2022,"Regular",2,"Home","Richmond","GWS",36
16001,2022-03-27,"R2","Fremantle",8,7,55,"St Kilda",9,11,65,"Perth Stadium",-10,2022,"Regular",2,"Away","St Kilda","Fremantle",10
16002,2022-03-31,"R3","Footscray",9,17,71,"Sydney",9,6,60,"Docklands",11,2022,"Regular",3,"Home","Footscray","Sydney",11
16003,2022-04-01,"R3","Adelaide",15,6,96,"Port Adelaide",13,14,92,"Adelaide Oval",4,2022,"Regular",3,"Home","Adelaide","Port Adelaide",4
16004,2022-04-01,"R3","Melbourne",14,15,99,"Essendon",10,10,70,"M.C.G.",29,2022,"Regular",3,"Home","Melbourne","Essendon",29
16005,2022-04-02,"R3","GWS",12,11,83,"Gold Coast",8,9,57,"Sydney Showground",26,2022,"Regular",3,"Home","GWS","Gold Coast",26
16006,2022-04-02,"R3","Collingwood",13,13,91,"Geelong",16,8,104,"M.C.G.",-13,2022,"Regular",3,"Away","Geelong","Collingwood",13
16007,2022-04-02,"R3","Brisbane Lions",23,18,156,"North Melbourne",7,6,48,"Gabba",108,2022,"Regular",3,"Home","Brisbane Lions","North Melbourne",108
16008,2022-04-03,"R3","Carlton",11,8,74,"Hawthorn",11,7,73,"M.C.G.",1,2022,"Regular",3,"Home","Carlton","Hawthorn",1
16009,2022-04-03,"R3","St Kilda",18,9,117,"Richmond",13,6,84,"Docklands",33,2022,"Regular",3,"Home","St Kilda","Richmond",33
16010,2022-04-03,"R3","West Coast",7,5,47,"Fremantle",15,12,102,"Perth Stadium",-55,2022,"Regular",3,"Away","Fremantle","West Coast",55
16011,2022-04-07,"R4","Port Adelaide",4,12,36,"Melbourne",10,8,68,"Adelaide Oval",-32,2022,"Regular",4,"Away","Melbourne","Port Adelaide",32
16012,2022-04-08,"R4","Geelong",11,14,80,"Brisbane Lions",11,4,70,"Kardinia Park",10,2022,"Regular",4,"Home","Geelong","Brisbane Lions",10
16013,2022-04-09,"R4","Sydney",13,8,86,"North Melbourne",12,3,75,"S.C.G.",11,2022,"Regular",4,"Home","Sydney","North Melbourne",11
16014,2022-04-09,"R4","Collingwood",10,14,74,"West Coast",14,3,87,"Docklands",-13,2022,"Regular",4,"Away","West Coast","Collingwood",13
16015,2022-04-09,"R4","Richmond",15,9,99,"Footscray",7,19,61,"M.C.G.",38,2022,"Regular",4,"Home","Richmond","Footscray",38
16016,2022-04-09,"R4","Fremantle",13,10,88,"GWS",8,6,54,"Perth Stadium",34,2022,"Regular",4,"Home","Fremantle","GWS",34
16017,2022-04-10,"R4","Essendon",15,13,103,"Adelaide",15,9,99,"Docklands",4,2022,"Regular",4,"Home","Essendon","Adelaide",4
16018,2022-04-10,"R4","Hawthorn",10,13,73,"St Kilda",22,10,142,"M.C.G.",-69,2022,"Regular",4,"Away","St Kilda","Hawthorn",69
16019,2022-04-10,"R4","Gold Coast",13,14,92,"Carlton",8,14,62,"Carrara",30,2022,"Regular",4,"Home","Gold Coast","Carlton",30
16020,2022-04-14,"R5","Brisbane Lions",15,8,98,"Collingwood",14,7,91,"Gabba",7,2022,"Regular",5,"Home","Brisbane Lions","Collingwood",7
16021,2022-04-15,"R5","North Melbourne",11,5,71,"Footscray",21,13,139,"Docklands",-68,2022,"Regular",5,"Away","Footscray","North Melbourne",68
16022,2022-04-15,"R5","West Coast",9,4,58,"Sydney",18,13,121,"Perth Stadium",-63,2022,"Regular",5,"Away","Sydney","West Coast",63
16023,2022-04-16,"R5","St Kilda",13,9,87,"Gold Coast",9,7,61,"Docklands",26,2022,"Regular",5,"Home","St Kilda","Gold Coast",26
16024,2022-04-16,"R5","Adelaide",15,11,101,"Richmond",12,10,82,"Adelaide Oval",19,2022,"Regular",5,"Home","Adelaide","Richmond",19
16025,2022-04-16,"R5","Melbourne",19,6,120,"GWS",7,11,53,"M.C.G.",67,2022,"Regular",5,"Home","Melbourne","GWS",67
16026,2022-04-17,"R5","Carlton",14,10,94,"Port Adelaide",13,13,91,"M.C.G.",3,2022,"Regular",5,"Home","Carlton","Port Adelaide",3
16027,2022-04-17,"R5","Essendon",8,11,59,"Fremantle",16,11,107,"Docklands",-48,2022,"Regular",5,"Away","Fremantle","Essendon",48
16028,2022-04-18,"R5","Hawthorn",14,8,92,"Geelong",11,14,80,"M.C.G.",12,2022,"Regular",5,"Home","Hawthorn","Geelong",12
16029,2022-04-22,"R6","GWS",8,12,60,"St Kilda",10,17,77,"Manuka Oval",-17,2022,"Regular",6,"Away","St Kilda","GWS",17
16030,2022-04-23,"R6","Footscray",9,8,62,"Adelaide",8,15,63,"Eureka Stadium",-1,2022,"Regular",6,"Away","Adelaide","Footscray",1
16031,2022-04-23,"R6","Port Adelaide",18,9,117,"West Coast",4,9,33,"Adelaide Oval",84,2022,"Regular",6,"Home","Port Adelaide","West Coast",84
16032,2022-04-23,"R6","Fremantle",14,13,97,"Carlton",9,8,62,"Perth Stadium",35,2022,"Regular",6,"Home","Fremantle","Carlton",35
16033,2022-04-24,"R6","North Melbourne",9,7,61,"Geelong",17,19,121,"Bellerive Oval",-60,2022,"Regular",6,"Away","Geelong","North Melbourne",60
16034,2022-04-24,"R6","Gold Coast",11,14,80,"Brisbane Lions",21,6,132,"Carrara",-52,2022,"Regular",6,"Away","Brisbane Lions","Gold Coast",52
16035,2022-04-24,"R6","Richmond",8,6,54,"Melbourne",9,22,76,"M.C.G.",-22,2022,"Regular",6,"Away","Melbourne","Richmond",22
16036,2022-04-25,"R6","Hawthorn",10,8,68,"Sydney",16,13,109,"York Park",-41,2022,"Regular",6,"Away","Sydney","Hawthorn",41
16037,2022-04-25,"R6","Essendon",12,10,82,"Collingwood",15,3,93,"M.C.G.",-11,2022,"Regular",6,"Away","Collingwood","Essendon",11
16038,2022-04-29,"R7","West Coast",8,8,56,"Richmond",25,15,165,"Perth Stadium",-109,2022,"Regular",7,"Away","Richmond","West Coast",109
16039,2022-04-30,"R7","Geelong",10,6,66,"Fremantle",10,9,69,"Kardinia Park",-3,2022,"Regular",7,"Away","Fremantle","Geelong",3
16040,2022-04-30,"R7","Adelaide",8,6,54,"GWS",17,11,113,"Adelaide Oval",-59,2022,"Regular",7,"Away","GWS","Adelaide",59
16041,2022-04-30,"R7","Melbourne",13,13,91,"Hawthorn",11,15,81,"M.C.G.",10,2022,"Regular",7,"Home","Melbourne","Hawthorn",10
16042,2022-04-30,"R7","Carlton",17,12,114,"North Melbourne",10,4,64,"Docklands",50,2022,"Regular",7,"Home","Carlton","North Melbourne",50
16043,2022-04-30,"R7","St Kilda",4,18,42,"Port Adelaide",5,13,43,"Cazaly's Stadium",-1,2022,"Regular",7,"Away","Port Adelaide","St Kilda",1
16044,2022-05-01,"R7","Collingwood",17,13,115,"Gold Coast",14,6,90,"M.C.G.",25,2022,"Regular",7,"Home","Collingwood","Gold Coast",25
16045,2022-05-01,"R7","Footscray",16,7,103,"Essendon",10,11,71,"Docklands",32,2022,"Regular",7,"Home","Footscray","Essendon",32
16046,2022-05-01,"R7","Sydney",13,11,89,"Brisbane Lions",17,11,113,"S.C.G.",-24,2022,"Regular",7,"Away","Brisbane Lions","Sydney",24
16047,2022-05-06,"R8","Port Adelaide",12,14,86,"Footscray",10,9,69,"Adelaide Oval",17,2022,"Regular",8,"Home","Port Adelaide","Footscray",17
16048,2022-05-06,"R8","Fremantle",15,12,102,"North Melbourne",3,6,24,"Perth Stadium",78,2022,"Regular",8,"Home","Fremantle","North Melbourne",78
16049,2022-05-07,"R8","Richmond",17,11,113,"Collingwood",12,14,86,"M.C.G.",27,2022,"Regular",8,"Home","Richmond","Collingwood",27
16050,2022-05-07,"R8","Sydney",8,13,61,"Gold Coast",10,15,75,"S.C.G.",-14,2022,"Regular",8,"Away","Gold Coast","Sydney",14
16051,2022-05-07,"R8","GWS",4,11,35,"Geelong",12,16,88,"Manuka Oval",-53,2022,"Regular",8,"Away","Geelong","GWS",53
16052,2022-05-07,"R8","Essendon",16,12,108,"Hawthorn",11,15,81,"Docklands",27,2022,"Regular",8,"Home","Essendon","Hawthorn",27
16053,2022-05-07,"R8","Brisbane Lions",16,9,105,"West Coast",4,6,30,"Gabba",75,2022,"Regular",8,"Home","Brisbane Lions","West Coast",75
16054,2022-05-08,"R8","Melbourne",14,9,93,"St Kilda",8,7,55,"M.C.G.",38,2022,"Regular",8,"Home","Melbourne","St Kilda",38
16055,2022-05-08,"R8","Carlton",17,14,116,"Adelaide",10,8,68,"Docklands",48,2022,"Regular",8,"Home","Carlton","Adelaide",48
16056,2022-05-13,"R9","Collingwood",7,9,51,"Footscray",14,15,99,"Docklands",-48,2022,"Regular",9,"Away","Footscray","Collingwood",48
16057,2022-05-14,"R9","Hawthorn",14,10,94,"Richmond",17,15,117,"M.C.G.",-23,2022,"Regular",9,"Away","Richmond","Hawthorn",23
16058,2022-05-14,"R9","North Melbourne",6,10,46,"Port Adelaide",17,13,115,"Bellerive Oval",-69,2022,"Regular",9,"Away","Port Adelaide","North Melbourne",69
16059,2022-05-14,"R9","St Kilda",13,12,90,"Geelong",11,14,80,"Docklands",10,2022,"Regular",9,"Home","St Kilda","Geelong",10
16060,2022-05-14,"R9","Sydney",14,21,105,"Essendon",6,11,47,"S.C.G.",58,2022,"Regular",9,"Home","Sydney","Essendon",58
16061,2022-05-14,"R9","Adelaide",9,12,66,"Brisbane Lions",16,6,102,"Adelaide Oval",-36,2022,"Regular",9,"Away","Brisbane Lions","Adelaide",36
16062,2022-05-15,"R9","Gold Coast",10,9,69,"Fremantle",4,9,33,"Carrara",36,2022,"Regular",9,"Home","Gold Coast","Fremantle",36
16063,2022-05-15,"R9","GWS",11,9,75,"Carlton",15,15,105,"Sydney Showground",-30,2022,"Regular",9,"Away","Carlton","GWS",30
16064,2022-05-15,"R9","West Coast",5,8,38,"Melbourne",16,16,112,"Perth Stadium",-74,2022,"Regular",9,"Away","Melbourne","West Coast",74
16065,2022-05-20,"R10","Carlton",15,12,102,"Sydney",13,9,87,"Docklands",15,2022,"Regular",10,"Home","Carlton","Sydney",15
16066,2022-05-21,"R10","Footscray",15,16,106,"Gold Coast",13,9,87,"Eureka Stadium",19,2022,"Regular",10,"Home","Footscray","Gold Coast",19
16067,2022-05-21,"R10","Geelong",11,16,82,"Port Adelaide",7,5,47,"Kardinia Park",35,2022,"Regular",10,"Home","Geelong","Port Adelaide",35
16068,2022-05-21,"R10","North Melbourne",8,5,53,"Melbourne",14,16,100,"Docklands",-47,2022,"Regular",10,"Away","Melbourne","North Melbourne",47
16069,2022-05-21,"R10","Adelaide",9,15,69,"St Kilda",14,6,90,"Adelaide Oval",-21,2022,"Regular",10,"Away","St Kilda","Adelaide",21
16070,2022-05-21,"R10","Richmond",11,14,80,"Essendon",7,6,48,"M.C.G.",32,2022,"Regular",10,"Home","Richmond","Essendon",32
16071,2022-05-22,"R10","GWS",21,12,138,"West Coast",13,8,86,"Sydney Showground",52,2022,"Regular",10,"Home","GWS","West Coast",52
16072,2022-05-22,"R10","Hawthorn",18,9,117,"Brisbane Lions",17,10,112,"York Park",5,2022,"Regular",10,"Home","Hawthorn","Brisbane Lions",5
16073,2022-05-22,"R10","Fremantle",6,8,44,"Collingwood",12,8,80,"Perth Stadium",-36,2022,"Regular",10,"Away","Collingwood","Fremantle",36
16074,2022-05-27,"R11","Sydney",16,10,106,"Richmond",15,10,100,"S.C.G.",6,2022,"Regular",11,"Home","Sydney","Richmond",6
16075,2022-05-28,"R11","Geelong",15,7,97,"Adelaide",7,13,55,"Kardinia Park",42,2022,"Regular",11,"Home","Geelong","Adelaide",42
16076,2022-05-28,"R11","Brisbane Lions",16,14,110,"GWS",15,6,96,"Gabba",14,2022,"Regular",11,"Home","Brisbane Lions","GWS",14
16077,2022-05-28,"R11","Melbourne",7,14,56,"Fremantle",14,10,94,"M.C.G.",-38,2022,"Regular",11,"Away","Fremantle","Melbourne",38
16078,2022-05-28,"R11","West Coast",9,6,60,"Footscray",25,11,161,"Perth Stadium",-101,2022,"Regular",11,"Away","Footscray","West Coast",101
16079,2022-05-28,"R11","Gold Coast",18,13,121,"Hawthorn",7,12,54,"Marrara Oval",67,2022,"Regular",11,"Home","Gold Coast","Hawthorn",67
16080,2022-05-29,"R11","St Kilda",16,7,103,"North Melbourne",7,8,50,"Docklands",53,2022,"Regular",11,"Home","St Kilda","North Melbourne",53
16081,2022-05-29,"R11","Collingwood",11,13,79,"Carlton",11,9,75,"M.C.G.",4,2022,"Regular",11,"Home","Collingwood","Carlton",4
16082,2022-05-29,"R11","Port Adelaide",9,12,66,"Essendon",6,14,50,"Adelaide Oval",16,2022,"Regular",11,"Home","Port Adelaide","Essendon",16
16083,2022-06-03,"R12","Footscray",10,10,70,"Geelong",12,11,83,"Docklands",-13,2022,"Regular",12,"Away","Geelong","Footscray",13
16084,2022-06-04,"R12","Adelaide",13,10,88,"West Coast",8,9,57,"Adelaide Oval",31,2022,"Regular",12,"Home","Adelaide","West Coast",31
16085,2022-06-04,"R12","Gold Coast",15,19,109,"North Melbourne",7,5,47,"Marrara Oval",62,2022,"Regular",12,"Home","Gold Coast","North Melbourne",62
16086,2022-06-04,"R12","Melbourne",9,7,61,"Sydney",10,13,73,"M.C.G.",-12,2022,"Regular",12,"Away","Sydney","Melbourne",12
16087,2022-06-05,"R12","Hawthorn",10,8,68,"Collingwood",10,12,72,"M.C.G.",-4,2022,"Regular",12,"Away","Collingwood","Hawthorn",4
16088,2022-06-05,"R12","Fremantle",15,9,99,"Brisbane Lions",13,7,85,"Perth Stadium",14,2022,"Regular",12,"Home","Fremantle","Brisbane Lions",14
16089,2022-06-09,"R13","Richmond",11,11,77,"Port Adelaide",10,5,65,"M.C.G.",12,2022,"Regular",13,"Home","Richmond","Port Adelaide",12
16090,2022-06-10,"R13","Essendon",7,12,54,"Carlton",12,8,80,"M.C.G.",-26,2022,"Regular",13,"Away","Carlton","Essendon",26
16091,2022-06-11,"R13","Fremantle",14,11,95,"Hawthorn",12,10,82,"Perth Stadium",13,2022,"Regular",13,"Home","Fremantle","Hawthorn",13
16092,2022-06-11,"R13","Brisbane Lions",10,18,78,"St Kilda",8,9,57,"Gabba",21,2022,"Regular",13,"Home","Brisbane Lions","St Kilda",21
16093,2022-06-12,"R13","North Melbourne",7,11,53,"GWS",15,12,102,"Docklands",-49,2022,"Regular",13,"Away","GWS","North Melbourne",49
16094,2022-06-13,"R13","Collingwood",12,10,82,"Melbourne",8,8,56,"M.C.G.",26,2022,"Regular",13,"Home","Collingwood","Melbourne",26
16095,2022-06-16,"R14","Richmond",11,15,81,"Carlton",9,12,66,"M.C.G.",15,2022,"Regular",14,"Home","Richmond","Carlton",15
16096,2022-06-17,"R14","St Kilda",11,6,72,"Essendon",15,17,107,"Docklands",-35,2022,"Regular",14,"Away","Essendon","St Kilda",35
16097,2022-06-18,"R14","Port Adelaide",12,10,82,"Sydney",8,11,59,"Adelaide Oval",23,2022,"Regular",14,"Home","Port Adelaide","Sydney",23
16098,2022-06-18,"R14","West Coast",9,9,63,"Geelong",12,9,81,"Perth Stadium",-18,2022,"Regular",14,"Away","Geelong","West Coast",18
16099,2022-06-18,"R14","GWS",16,9,105,"Footscray",19,11,125,"Sydney Showground",-20,2022,"Regular",14,"Away","Footscray","GWS",20
16100,2022-06-19,"R14","Gold Coast",18,8,116,"Adelaide",10,13,73,"Carrara",43,2022,"Regular",14,"Home","Gold Coast","Adelaide",43
16101,2022-06-23,"R15","Melbourne",16,21,117,"Brisbane Lions",7,11,53,"M.C.G.",64,2022,"Regular",15,"Home","Melbourne","Brisbane Lions",64
16102,2022-06-24,"R15","Footscray",19,11,125,"Hawthorn",12,11,83,"Docklands",42,2022,"Regular",15,"Home","Footscray","Hawthorn",42
16103,2022-06-24,"R15","West Coast",16,11,107,"Essendon",14,13,97,"Perth Stadium",10,2022,"Regular",15,"Home","West Coast","Essendon",10
16104,2022-06-25,"R15","Carlton",12,9,81,"Fremantle",7,8,50,"Docklands",31,2022,"Regular",15,"Home","Carlton","Fremantle",31
16105,2022-06-25,"R15","Geelong",13,11,89,"Richmond",13,8,86,"M.C.G.",3,2022,"Regular",15,"Home","Geelong","Richmond",3
16106,2022-06-25,"R15","Sydney",12,11,83,"St Kilda",4,8,32,"S.C.G.",51,2022,"Regular",15,"Home","Sydney","St Kilda",51
16107,2022-06-26,"R15","North Melbourne",8,10,58,"Adelaide",17,13,115,"Bellerive Oval",-57,2022,"Regular",15,"Away","Adelaide","North Melbourne",57
16108,2022-06-26,"R15","Collingwood",11,22,88,"GWS",12,5,77,"M.C.G.",11,2022,"Regular",15,"Home","Collingwood","GWS",11
16109,2022-06-26,"R15","Port Adelaide",13,15,93,"Gold Coast",13,13,91,"Adelaide Oval",2,2022,"Regular",15,"Home","Port Adelaide","Gold Coast",2
16110,2022-06-30,"R16","Brisbane Lions",16,12,108,"Footscray",9,13,67,"Gabba",41,2022,"Regular",16,"Home","Brisbane Lions","Footscray",41
16111,2022-07-01,"R16","Carlton",10,18,78,"St Kilda",14,9,93,"Docklands",-15,2022,"Regular",16,"Away","St Kilda","Carlton",15
16112,2022-07-02,"R16","Essendon",15,5,95,"Sydney",12,14,86,"M.C.G.",9,2022,"Regular",16,"Home","Essendon","Sydney",9
16113,2022-07-02,"R16","Adelaide",10,5,65,"Melbourne",14,10,94,"Adelaide Oval",-29,2022,"Regular",16,"Away","Melbourne","Adelaide",29
16114,2022-07-02,"R16","Gold Coast",8,14,62,"Collingwood",9,13,67,"Carrara",-5,2022,"Regular",16,"Away","Collingwood","Gold Coast",5
16115,2022-07-02,"R16","Geelong",21,18,144,"North Melbourne",5,2,32,"Kardinia Park",112,2022,"Regular",16,"Home","Geelong","North Melbourne",112
16116,2022-07-03,"R16","Richmond",20,8,128,"West Coast",13,15,93,"M.C.G.",35,2022,"Regular",16,"Home","Richmond","West Coast",35
16117,2022-07-03,"R16","GWS",11,6,72,"Hawthorn",7,8,50,"Sydney Showground",22,2022,"Regular",16,"Home","GWS","Hawthorn",22
16118,2022-07-03,"R16","Fremantle",15,9,99,"Port Adelaide",14,7,91,"Perth Stadium",8,2022,"Regular",16,"Home","Fremantle","Port Adelaide",8
16119,2022-07-07,"R17","Geelong",12,19,91,"Melbourne",9,9,63,"Kardinia Park",28,2022,"Regular",17,"Home","Geelong","Melbourne",28
16120,2022-07-08,"R17","Sydney",17,18,120,"Footscray",9,13,67,"S.C.G.",53,2022,"Regular",17,"Home","Sydney","Footscray",53
16121,2022-07-09,"R17","Collingwood",13,10,88,"North Melbourne",12,9,81,"M.C.G.",7,2022,"Regular",17,"Home","Collingwood","North Melbourne",7
16122,2022-07-09,"R17","Gold Coast",14,10,94,"Richmond",13,14,92,"Carrara",2,2022,"Regular",17,"Home","Gold Coast","Richmond",2
16123,2022-07-09,"R17","St Kilda",10,10,70,"Fremantle",17,9,111,"Docklands",-41,2022,"Regular",17,"Away","Fremantle","St Kilda",41
16124,2022-07-09,"R17","Port Adelaide",12,12,84,"GWS",3,11,29,"Adelaide Oval",55,2022,"Regular",17,"Home","Port Adelaide","GWS",55
16125,2022-07-10,"R17","Brisbane Lions",13,12,90,"Essendon",15,10,100,"Gabba",-10,2022,"Regular",17,"Away","Essendon","Brisbane Lions",10
16126,2022-07-10,"R17","Hawthorn",13,8,86,"Adelaide",8,6,54,"Docklands",32,2022,"Regular",17,"Home","Hawthorn","Adelaide",32
16127,2022-07-10,"R17","West Coast",8,5,53,"Carlton",17,14,116,"Perth Stadium",-63,2022,"Regular",17,"Away","Carlton","West Coast",63
16128,2022-07-15,"R18","Footscray",13,6,84,"St Kilda",7,14,56,"Docklands",28,2022,"Regular",18,"Home","Footscray","St Kilda",28
16129,2022-07-16,"R18","Adelaide",13,8,86,"Collingwood",14,7,91,"Adelaide Oval",-5,2022,"Regular",18,"Away","Collingwood","Adelaide",5
16130,2022-07-16,"R18","GWS",9,5,59,"Brisbane Lions",15,9,99,"Manuka Oval",-40,2022,"Regular",18,"Away","Brisbane Lions","GWS",40
16131,2022-07-16,"R18","North Melbourne",14,8,92,"Richmond",11,22,88,"Docklands",4,2022,"Regular",18,"Home","North Melbourne","Richmond",4
16132,2022-07-16,"R18","Carlton",8,7,55,"Geelong",12,13,85,"M.C.G.",-30,2022,"Regular",18,"Away","Geelong","Carlton",30
16133,2022-07-16,"R18","Fremantle",9,11,65,"Sydney",11,16,82,"Perth Stadium",-17,2022,"Regular",18,"Away","Sydney","Fremantle",17
16134,2022-07-17,"R18","Hawthorn",15,12,102,"West Coast",12,5,77,"M.C.G.",25,2022,"Regular",18,"Home","Hawthorn","West Coast",25
16135,2022-07-17,"R18","Melbourne",12,11,83,"Port Adelaide",10,9,69,"Traeger Park",14,2022,"Regular",18,"Home","Melbourne","Port Adelaide",14
16136,2022-07-17,"R18","Essendon",14,19,103,"Gold Coast",8,7,55,"Docklands",48,2022,"Regular",18,"Home","Essendon","Gold Coast",48
16137,2022-07-22,"R19","Richmond",7,10,52,"Fremantle",7,10,52,"Docklands",0,2022,"Regular",19,"Home","Richmond","Fremantle",0
16138,2022-07-23,"R19","Sydney",17,16,118,"Adelaide",12,13,85,"S.C.G.",33,2022,"Regular",19,"Home","Sydney","Adelaide",33
16139,2022-07-23,"R19","North Melbourne",11,9,75,"Hawthorn",19,7,121,"Bellerive Oval",-46,2022,"Regular",19,"Away","Hawthorn","North Melbourne",46
16140,2022-07-23,"R19","Port Adelaide",14,10,94,"Geelong",16,10,106,"Adelaide Oval",-12,2022,"Regular",19,"Away","Geelong","Port Adelaide",12
16141,2022-07-23,"R19","Brisbane Lions",16,14,110,"Gold Coast",14,9,93,"Gabba",17,2022,"Regular",19,"Home","Brisbane Lions","Gold Coast",17
16142,2022-07-23,"R19","Footscray",17,8,110,"Melbourne",15,10,100,"Docklands",10,2022,"Regular",19,"Home","Footscray","Melbourne",10
16143,2022-07-24,"R19","Carlton",13,12,90,"GWS",8,6,54,"Docklands",36,2022,"Regular",19,"Home","Carlton","GWS",36
16144,2022-07-24,"R19","Collingwood",12,8,80,"Essendon",11,10,76,"M.C.G.",4,2022,"Regular",19,"Home","Collingwood","Essendon",4
16145,2022-07-24,"R19","West Coast",10,2,62,"St Kilda",14,6,90,"Perth Stadium",-28,2022,"Regular",19,"Away","St Kilda","West Coast",28
16146,2022-07-29,"R20","Fremantle",5,9,39,"Melbourne",12,13,85,"Perth Stadium",-46,2022,"Regular",20,"Away","Melbourne","Fremantle",46
16147,2022-07-30,"R20","Collingwood",13,10,88,"Port Adelaide",12,10,82,"M.C.G.",6,2022,"Regular",20,"Home","Collingwood","Port Adelaide",6
16148,2022-07-30,"R20","Sydney",17,10,112,"GWS",5,9,39,"S.C.G.",73,2022,"Regular",20,"Home","Sydney","GWS",73
16149,2022-07-30,"R20","St Kilda",10,15,75,"Hawthorn",9,9,63,"Docklands",12,2022,"Regular",20,"Home","St Kilda","Hawthorn",12
16150,2022-07-30,"R20","Geelong",14,10,94,"Footscray",9,12,66,"Kardinia Park",28,2022,"Regular",20,"Home","Geelong","Footscray",28
16151,2022-07-30,"R20","Adelaide",12,12,84,"Carlton",8,7,55,"Adelaide Oval",29,2022,"Regular",20,"Home","Adelaide","Carlton",29
16152,2022-07-31,"R20","Gold Coast",16,11,107,"West Coast",16,8,104,"Carrara",3,2022,"Regular",20,"Home","Gold Coast","West Coast",3
16153,2022-07-31,"R20","Richmond",15,14,104,"Brisbane Lions",14,13,97,"M.C.G.",7,2022,"Regular",20,"Home","Richmond","Brisbane Lions",7
16154,2022-07-31,"R20","Essendon",17,12,114,"North Melbourne",9,12,66,"Docklands",48,2022,"Regular",20,"Home","Essendon","North Melbourne",48
16155,2022-08-05,"R21","Melbourne",13,11,89,"Collingwood",15,6,96,"M.C.G.",-7,2022,"Regular",21,"Away","Collingwood","Melbourne",7
16156,2022-08-06,"R21","Hawthorn",10,10,70,"Gold Coast",8,15,63,"York Park",7,2022,"Regular",21,"Home","Hawthorn","Gold Coast",7
16157,2022-08-06,"R21","GWS",14,12,96,"Essendon",10,9,69,"Sydney Showground",27,2022,"Regular",21,"Home","GWS","Essendon",27
16158,2022-08-06,"R21","Footscray",11,12,78,"Fremantle",14,11,95,"Docklands",-17,2022,"Regular",21,"Away","Fremantle","Footscray",17
16159,2022-08-06,"R21","Geelong",17,8,110,"St Kilda",10,5,65,"Kardinia Park",45,2022,"Regular",21,"Home","Geelong","St Kilda",45
16160,2022-08-06,"R21","Port Adelaide",10,11,71,"Richmond",16,13,109,"Adelaide Oval",-38,2022,"Regular",21,"Away","Richmond","Port Adelaide",38
16161,2022-08-07,"R21","North Melbourne",13,10,88,"Sydney",18,18,126,"Docklands",-38,2022,"Regular",21,"Away","Sydney","North Melbourne",38
16162,2022-08-07,"R21","Brisbane Lions",17,12,114,"Carlton",12,9,81,"Gabba",33,2022,"Regular",21,"Home","Brisbane Lions","Carlton",33
16163,2022-08-07,"R21","West Coast",13,8,86,"Adelaide",16,6,102,"Perth Stadium",-16,2022,"Regular",21,"Away","Adelaide","West Coast",16
16164,2022-08-12,"R22","St Kilda",9,12,66,"Brisbane Lions",12,9,81,"Docklands",-15,2022,"Regular",22,"Away","Brisbane Lions","St Kilda",15
16165,2022-08-13,"R22","Footscray",9,8,62,"GWS",8,9,57,"Docklands",5,2022,"Regular",22,"Home","Footscray","GWS",5
16166,2022-08-13,"R22","Adelaide",15,13,103,"North Melbourne",10,14,74,"Adelaide Oval",29,2022,"Regular",22,"Home","Adelaide","North Melbourne",29
16167,2022-08-13,"R22","Gold Coast",9,5,59,"Geelong",18,11,119,"Carrara",-60,2022,"Regular",22,"Away","Geelong","Gold Coast",60
16168,2022-08-13,"R22","Melbourne",11,13,79,"Carlton",10,14,74,"M.C.G.",5,2022,"Regular",22,"Home","Melbourne","Carlton",5
16169,2022-08-13,"R22","Fremantle",9,17,71,"West Coast",7,5,47,"Perth Stadium",24,2022,"Regular",22,"Home","Fremantle","West Coast",24
16170,2022-08-14,"R22","Richmond",20,8,128,"Hawthorn",9,13,67,"M.C.G.",61,2022,"Regular",22,"Home","Richmond","Hawthorn",61
16171,2022-08-14,"R22","Sydney",11,11,77,"Collingwood",7,8,50,"S.C.G.",27,2022,"Regular",22,"Home","Sydney","Collingwood",27
16172,2022-08-14,"R22","Essendon",9,8,62,"Port Adelaide",23,8,146,"Docklands",-84,2022,"Regular",22,"Away","Port Adelaide","Essendon",84
16173,2022-08-19,"R23","Brisbane Lions",8,9,57,"Melbourne",18,7,115,"Gabba",-58,2022,"Regular",23,"Away","Melbourne","Brisbane Lions",58
16174,2022-08-20,"R23","GWS",10,9,69,"Fremantle",13,11,89,"Manuka Oval",-20,2022,"Regular",23,"Away","Fremantle","GWS",20
16175,2022-08-20,"R23","North Melbourne",6,11,47,"Gold Coast",16,18,114,"Docklands",-67,2022,"Regular",23,"Away","Gold Coast","North Melbourne",67
16176,2022-08-20,"R23","Geelong",19,17,131,"West Coast",7,4,46,"Kardinia Park",85,2022,"Regular",23,"Home","Geelong","West Coast",85
16177,2022-08-20,"R23","Essendon",11,9,75,"Richmond",21,15,141,"M.C.G.",-66,2022,"Regular",23,"Away","Richmond","Essendon",66
16178,2022-08-20,"R23","Port Adelaide",16,15,111,"Adelaide",7,13,55,"Adelaide Oval",56,2022,"Regular",23,"Home","Port Adelaide","Adelaide",56
16179,2022-08-21,"R23","Hawthorn",10,4,64,"Footscray",12,15,87,"York Park",-23,2022,"Regular",23,"Away","Footscray","Hawthorn",23
16180,2022-08-21,"R23","Carlton",10,14,74,"Collingwood",11,9,75,"M.C.G.",-1,2022,"Regular",23,"Away","Collingwood","Carlton",1
16181,2022-08-21,"R23","St Kilda",11,8,74,"Sydney",13,10,88,"Docklands",-14,2022,"Regular",23,"Away","Sydney","St Kilda",14
16182,2022-09-01,"EF","Brisbane Lions",16,10,106,"Richmond",16,8,104,"Gabba",2,2022,"Finals",24,"Home","Brisbane Lions","Richmond",2
16183,2022-09-02,"QF","Melbourne",10,9,69,"Sydney",14,7,91,"M.C.G.",-22,2022,"Finals",24,"Away","Sydney","Melbourne",22
16184,2022-09-03,"QF","Geelong",11,12,78,"Collingwood",10,12,72,"M.C.G.",6,2022,"Finals",24,"Home","Geelong","Collingwood",6
16185,2022-09-03,"EF","Fremantle",11,7,73,"Footscray",8,12,60,"Perth Stadium",13,2022,"Finals",24,"Home","Fremantle","Footscray",13
16186,2022-09-09,"SF","Melbourne",11,13,79,"Brisbane Lions",14,8,92,"M.C.G.",-13,2022,"Finals",25,"Away","Brisbane Lions","Melbourne",13
16187,2022-09-10,"SF","Collingwood",11,13,79,"Fremantle",9,5,59,"M.C.G.",20,2022,"Finals",25,"Home","Collingwood","Fremantle",20
16188,2022-09-16,"PF","Geelong",18,12,120,"Brisbane Lions",7,7,49,"M.C.G.",71,2022,"Finals",26,"Home","Geelong","Brisbane Lions",71
16189,2022-09-17,"PF","Sydney",14,11,95,"Collingwood",14,10,94,"S.C.G.",1,2022,"Finals",26,"Home","Sydney","Collingwood",1
16190,2022-09-24,"GF","Geelong",20,13,133,"Sydney",8,4,52,"M.C.G.",81,2022,"Finals",27,"Home","Geelong","Sydney",81
16191,2023-03-16,"R1","Richmond",8,10,58,"Carlton",8,10,58,"M.C.G.",0,2023,"Regular",1,"Home","Richmond","Carlton",0
16192,2023-03-17,"R1","Geelong",16,7,103,"Collingwood",19,11,125,"M.C.G.",-22,2023,"Regular",1,"Away","Collingwood","Geelong",22
16193,2023-03-18,"R1","North Melbourne",12,15,87,"West Coast",12,10,82,"Docklands",5,2023,"Regular",1,"Home","North Melbourne","West Coast",5
16194,2023-03-18,"R1","Port Adelaide",18,18,126,"Brisbane Lions",11,6,72,"Adelaide Oval",54,2023,"Regular",1,"Home","Port Adelaide","Brisbane Lions",54
16195,2023-03-18,"R1","Melbourne",17,13,115,"Footscray",9,11,65,"M.C.G.",50,2023,"Regular",1,"Home","Melbourne","Footscray",50
16196,2023-03-18,"R1","Gold Coast",9,7,61,"Sydney",16,14,110,"Carrara",-49,2023,"Regular",1,"Away","Sydney","Gold Coast",49
16197,2023-03-19,"R1","GWS",15,16,106,"Adelaide",12,18,90,"Sydney Showground",16,2023,"Regular",1,"Home","GWS","Adelaide",16
16198,2023-03-19,"R1","Hawthorn",9,11,65,"Essendon",19,10,124,"M.C.G.",-59,2023,"Regular",1,"Away","Essendon","Hawthorn",59
16199,2023-03-19,"R1","St Kilda",10,7,67,"Fremantle",7,10,52,"Docklands",15,2023,"Regular",1,"Home","St Kilda","Fremantle",15
16200,2023-03-23,"R2","Carlton",13,12,90,"Geelong",12,10,82,"M.C.G.",8,2023,"Regular",2,"Home","Carlton","Geelong",8
16201,2023-03-24,"R2","Brisbane Lions",14,9,93,"Melbourne",13,4,82,"Gabba",11,2023,"Regular",2,"Home","Brisbane Lions","Melbourne",11
16202,2023-03-25,"R2","Collingwood",21,9,135,"Port Adelaide",9,10,64,"M.C.G.",71,2023,"Regular",2,"Home","Collingwood","Port Adelaide",71
16203,2023-03-25,"R2","Adelaide",10,16,76,"Richmond",17,6,108,"Adelaide Oval",-32,2023,"Regular",2,"Away","Richmond","Adelaide",32
16204,2023-03-25,"R2","Footscray",5,11,41,"St Kilda",14,8,92,"Docklands",-51,2023,"Regular",2,"Away","St Kilda","Footscray",51
16205,2023-03-25,"R2","Fremantle",10,12,72,"North Melbourne",11,7,73,"Perth Stadium",-1,2023,"Regular",2,"Away","North Melbourne","Fremantle",1
16206,2023-03-26,"R2","Sydney",17,16,118,"Hawthorn",4,13,37,"S.C.G.",81,2023,"Regular",2,"Home","Sydney","Hawthorn",81
16207,2023-03-26,"R2","Essendon",16,12,108,"Gold Coast",11,14,80,"Docklands",28,2023,"Regular",2,"Home","Essendon","Gold Coast",28
16208,2023-03-26,"R2","West Coast",14,16,100,"GWS",11,15,81,"Perth Stadium",19,2023,"Regular",2,"Home","West Coast","GWS",19
16209,2023-03-30,"R3","Footscray",10,7,67,"Brisbane Lions",7,11,53,"Docklands",14,2023,"Regular",3,"Home","Footscray","Brisbane Lions",14
16210,2023-03-31,"R3","Collingwood",8,15,63,"Richmond",7,7,49,"M.C.G.",14,2023,"Regular",3,"Home","Collingwood","Richmond",14
16211,2023-04-01,"R3","Hawthorn",11,14,80,"North Melbourne",9,7,61,"York Park",19,2023,"Regular",3,"Home","Hawthorn","North Melbourne",19
16212,2023-04-01,"R3","GWS",9,10,64,"Carlton",9,20,74,"Sydney Showground",-10,2023,"Regular",3,"Away","Carlton","GWS",10
16213,2023-04-01,"R3","St Kilda",14,8,92,"Essendon",11,8,74,"M.C.G.",18,2023,"Regular",3,"Home","St Kilda","Essendon",18
16214,2023-04-01,"R3","Port Adelaide",13,8,86,"Adelaide",18,9,117,"Adelaide Oval",-31,2023,"Regular",3,"Away","Adelaide","Port Adelaide",31
16215,2023-04-02,"R3","Gold Coast",10,13,73,"Geelong",7,12,54,"Carrara",19,2023,"Regular",3,"Home","Gold Coast","Geelong",19
16216,2023-04-02,"R3","Melbourne",21,8,134,"Sydney",12,12,84,"M.C.G.",50,2023,"Regular",3,"Home","Melbourne","Sydney",50
16217,2023-04-02,"R3","Fremantle",16,12,108,"West Coast",9,13,67,"Perth Stadium",41,2023,"Regular",3,"Home","Fremantle","West Coast",41
16218,2023-04-06,"R4","Brisbane Lions",18,8,116,"Collingwood",11,17,83,"Gabba",33,2023,"Regular",4,"Home","Brisbane Lions","Collingwood",33
16219,2023-04-07,"R4","North Melbourne",11,18,84,"Carlton",16,11,107,"Docklands",-23,2023,"Regular",4,"Away","Carlton","North Melbourne",23
16220,2023-04-08,"R4","Adelaide",17,9,111,"Fremantle",10,12,72,"Adelaide Oval",39,2023,"Regular",4,"Home","Adelaide","Fremantle",39
16221,2023-04-08,"R4","Richmond",12,12,84,"Footscray",12,17,89,"M.C.G.",-5,2023,"Regular",4,"Away","Footscray","Richmond",5
16222,2023-04-08,"R4","Sydney",9,10,64,"Port Adelaide",9,12,66,"S.C.G.",-2,2023,"Regular",4,"Away","Port Adelaide","Sydney",2
16223,2023-04-08,"R4","St Kilda",17,11,113,"Gold Coast",8,12,60,"Docklands",53,2023,"Regular",4,"Home","St Kilda","Gold Coast",53
16224,2023-04-09,"R4","Essendon",11,22,88,"GWS",11,9,75,"Docklands",13,2023,"Regular",4,"Home","Essendon","GWS",13
16225,2023-04-09,"R4","West Coast",9,9,63,"Melbourne",19,12,126,"Perth Stadium",-63,2023,"Regular",4,"Away","Melbourne","West Coast",63
16226,2023-04-10,"R4","Geelong",19,13,127,"Hawthorn",6,9,45,"M.C.G.",82,2023,"Regular",4,"Home","Geelong","Hawthorn",82
16227,2023-04-13,"R5","Adelaide",18,10,118,"Carlton",9,8,62,"Adelaide Oval",56,2023,"Regular",5,"Home","Adelaide","Carlton",56
16228,2023-04-14,"R5","Fremantle",15,10,100,"Gold Coast",13,12,90,"Norwood Oval",10,2023,"Regular",5,"Home","Fremantle","Gold Coast",10
16229,2023-04-14,"R5","Richmond",11,12,78,"Sydney",18,14,122,"Adelaide Oval",-44,2023,"Regular",5,"Away","Sydney","Richmond",44
16230,2023-04-15,"R5","Brisbane Lions",22,20,152,"North Melbourne",12,5,77,"Summit Sports Park",75,2023,"Regular",5,"Home","Brisbane Lions","North Melbourne",75
16231,2023-04-15,"R5","Essendon",15,14,104,"Melbourne",11,11,77,"Adelaide Oval",27,2023,"Regular",5,"Home","Essendon","Melbourne",27
16232,2023-04-15,"R5","Port Adelaide",10,10,70,"Footscray",8,8,56,"Adelaide Oval",14,2023,"Regular",5,"Home","Port Adelaide","Footscray",14
16233,2023-04-16,"R5","Geelong",21,10,136,"West Coast",13,11,89,"Adelaide Oval",47,2023,"Regular",5,"Home","Geelong","West Coast",47
16234,2023-04-16,"R5","GWS",10,17,77,"Hawthorn",11,9,75,"Norwood Oval",2,2023,"Regular",5,"Home","GWS","Hawthorn",2
16235,2023-04-16,"R5","Collingwood",10,10,70,"St Kilda",9,10,64,"Adelaide Oval",6,2023,"Regular",5,"Home","Collingwood","St Kilda",6
16236,2023-04-21,"R6","Fremantle",10,9,69,"Footscray",17,16,118,"Perth Stadium",-49,2023,"Regular",6,"Away","Footscray","Fremantle",49
16237,2023-04-22,"R6","Port Adelaide",16,13,109,"West Coast",10,9,69,"Adelaide Oval",40,2023,"Regular",6,"Home","Port Adelaide","West Coast",40
16238,2023-04-22,"R6","GWS",13,9,87,"Brisbane Lions",16,12,108,"Manuka Oval",-21,2023,"Regular",6,"Away","Brisbane Lions","GWS",21
16239,2023-04-22,"R6","Geelong",20,10,130,"Sydney",5,7,37,"Kardinia Park",93,2023,"Regular",6,"Home","Geelong","Sydney",93
16240,2023-04-23,"R6","Hawthorn",11,10,76,"Adelaide",11,13,79,"York Park",-3,2023,"Regular",6,"Away","Adelaide","Hawthorn",3
16241,2023-04-23,"R6","Carlton",8,12,60,"St Kilda",12,10,82,"Docklands",-22,2023,"Regular",6,"Away","St Kilda","Carlton",22
16242,2023-04-23,"R6","Gold Coast",14,13,97,"North Melbourne",7,12,54,"Carrara",43,2023,"Regular",6,"Home","Gold Coast","North Melbourne",43
16243,2023-04-24,"R6","Melbourne",15,6,96,"Richmond",11,12,78,"M.C.G.",18,2023,"Regular",6,"Home","Melbourne","Richmond",18
16244,2023-04-25,"R6","Collingwood",13,12,90,"Essendon",11,11,77,"M.C.G.",13,2023,"Regular",6,"Home","Collingwood","Essendon",13
16245,2023-04-28,"R7","St Kilda",11,10,76,"Port Adelaide",12,11,83,"Docklands",-7,2023,"Regular",7,"Away","Port Adelaide","St Kilda",7
16246,2023-04-29,"R7","Brisbane Lions",17,13,115,"Fremantle",10,7,67,"Gabba",48,2023,"Regular",7,"Home","Brisbane Lions","Fremantle",48
16247,2023-04-29,"R7","Sydney",16,10,106,"GWS",17,5,107,"S.C.G.",-1,2023,"Regular",7,"Away","GWS","Sydney",1
16248,2023-04-29,"R7","Footscray",14,10,94,"Hawthorn",9,11,65,"Docklands",29,2023,"Regular",7,"Home","Footscray","Hawthorn",29
16249,2023-04-29,"R7","Melbourne",22,7,139,"North Melbourne",7,7,49,"M.C.G.",90,2023,"Regular",7,"Home","Melbourne","North Melbourne",90
16250,2023-04-29,"R7","West Coast",6,8,44,"Carlton",23,14,152,"Perth Stadium",-108,2023,"Regular",7,"Away","Carlton","West Coast",108
16251,2023-04-30,"R7","Essendon",16,8,104,"Geelong",20,12,132,"M.C.G.",-28,2023,"Regular",7,"Away","Geelong","Essendon",28
16252,2023-04-30,"R7","Richmond",6,12,48,"Gold Coast",11,6,72,"Docklands",-24,2023,"Regular",7,"Away","Gold Coast","Richmond",24
16253,2023-04-30,"R7","Adelaide",7,16,58,"Collingwood",8,11,59,"Adelaide Oval",-1,2023,"Regular",7,"Away","Collingwood","Adelaide",1
16254,2023-05-05,"R8","Carlton",11,8,74,"Brisbane Lions",15,10,100,"Docklands",-26,2023,"Regular",8,"Away","Brisbane Lions","Carlton",26
16255,2023-05-06,"R8","Richmond",15,14,104,"West Coast",8,10,58,"M.C.G.",46,2023,"Regular",8,"Home","Richmond","West Coast",46
16256,2023-05-06,"R8","Geelong",14,14,98,"Adelaide",11,6,72,"Kardinia Park",26,2023,"Regular",8,"Home","Geelong","Adelaide",26
16257,2023-05-06,"R8","Gold Coast",13,7,85,"Melbourne",13,12,90,"Carrara",-5,2023,"Regular",8,"Away","Melbourne","Gold Coast",5
16258,2023-05-06,"R8","GWS",10,11,71,"Footscray",13,8,86,"Manuka Oval",-15,2023,"Regular",8,"Away","Footscray","GWS",15
16259,2023-05-06,"R8","Fremantle",18,9,117,"Hawthorn",7,6,48,"Perth Stadium",69,2023,"Regular",8,"Home","Fremantle","Hawthorn",69
16260,2023-05-07,"R8","Port Adelaide",12,20,92,"Essendon",13,9,87,"Adelaide Oval",5,2023,"Regular",8,"Home","Port Adelaide","Essendon",5
16261,2023-05-07,"R8","Collingwood",11,11,77,"Sydney",6,12,48,"M.C.G.",29,2023,"Regular",8,"Home","Collingwood","Sydney",29
16262,2023-05-07,"R8","North Melbourne",4,10,34,"St Kilda",8,16,64,"Docklands",-30,2023,"Regular",8,"Away","St Kilda","North Melbourne",30
16263,2023-05-12,"R9","Richmond",16,6,102,"Geelong",11,12,78,"M.C.G.",24,2023,"Regular",9,"Home","Richmond","Geelong",24
16264,2023-05-12,"R9","West Coast",6,7,43,"Gold Coast",16,17,113,"Perth Stadium",-70,2023,"Regular",9,"Away","Gold Coast","West Coast",70
16265,2023-05-13,"R9","Sydney",13,8,86,"Fremantle",16,7,103,"S.C.G.",-17,2023,"Regular",9,"Away","Fremantle","Sydney",17
16266,2023-05-13,"R9","North Melbourne",10,5,65,"Port Adelaide",20,15,135,"Bellerive Oval",-70,2023,"Regular",9,"Away","Port Adelaide","North Melbourne",70
16267,2023-05-13,"R9","Hawthorn",7,7,49,"Melbourne",15,13,103,"M.C.G.",-54,2023,"Regular",9,"Away","Melbourne","Hawthorn",54
16268,2023-05-13,"R9","Brisbane Lions",12,15,87,"Essendon",6,9,45,"Gabba",42,2023,"Regular",9,"Home","Brisbane Lions","Essendon",42
16269,2023-05-13,"R9","Carlton",8,11,59,"Footscray",11,13,79,"Docklands",-20,2023,"Regular",9,"Away","Footscray","Carlton",20
16270,2023-05-14,"R9","Adelaide",19,7,121,"St Kilda",10,9,69,"Adelaide Oval",52,2023,"Regular",9,"Home","Adelaide","St Kilda",52
16271,2023-05-14,"R9","Collingwood",18,12,120,"GWS",7,13,55,"M.C.G.",65,2023,"Regular",9,"Home","Collingwood","GWS",65
16272,2023-05-19,"R10","Port Adelaide",11,14,80,"Melbourne",11,10,76,"Adelaide Oval",4,2023,"Regular",10,"Home","Port Adelaide","Melbourne",4
16273,2023-05-20,"R10","North Melbourne",14,6,90,"Sydney",14,9,93,"Docklands",-3,2023,"Regular",10,"Away","Sydney","North Melbourne",3
16274,2023-05-20,"R10","Footscray",11,19,85,"Adelaide",5,10,40,"Eureka Stadium",45,2023,"Regular",10,"Home","Footscray","Adelaide",45
16275,2023-05-20,"R10","Fremantle",16,10,106,"Geelong",11,11,77,"Perth Stadium",29,2023,"Regular",10,"Home","Fremantle","Geelong",29
16276,2023-05-20,"R10","Brisbane Lions",16,11,107,"Gold Coast",9,10,64,"Gabba",43,2023,"Regular",10,"Home","Brisbane Lions","Gold Coast",43
16277,2023-05-20,"R10","Essendon",10,11,71,"Richmond",10,10,70,"M.C.G.",1,2023,"Regular",10,"Home","Essendon","Richmond",1
16278,2023-05-21,"R10","Hawthorn",22,10,142,"West Coast",4,2,26,"York Park",116,2023,"Regular",10,"Home","Hawthorn","West Coast",116
16279,2023-05-21,"R10","Carlton",7,15,57,"Collingwood",13,7,85,"M.C.G.",-28,2023,"Regular",10,"Away","Collingwood","Carlton",28
16280,2023-05-21,"R10","GWS",12,8,80,"St Kilda",13,14,92,"Sydney Showground",-12,2023,"Regular",10,"Away","St Kilda","GWS",12
16281,2023-05-26,"R11","Sydney",11,11,77,"Carlton",6,15,51,"S.C.G.",26,2023,"Regular",11,"Home","Sydney","Carlton",26
16282,2023-05-27,"R11","St Kilda",12,6,78,"Hawthorn",12,16,88,"Docklands",-10,2023,"Regular",11,"Away","Hawthorn","St Kilda",10
16283,2023-05-27,"R11","Melbourne",10,12,72,"Fremantle",12,7,79,"M.C.G.",-7,2023,"Regular",11,"Away","Fremantle","Melbourne",7
16284,2023-05-27,"R11","Geelong",10,14,74,"GWS",12,9,81,"Kardinia Park",-7,2023,"Regular",11,"Away","GWS","Geelong",7
16285,2023-05-27,"R11","Gold Coast",13,6,84,"Footscray",11,11,77,"Marrara Oval",7,2023,"Regular",11,"Home","Gold Coast","Footscray",7
16286,2023-05-27,"R11","West Coast",6,10,46,"Essendon",14,12,96,"Perth Stadium",-50,2023,"Regular",11,"Away","Essendon","West Coast",50
16287,2023-05-28,"R11","Richmond",9,13,67,"Port Adelaide",10,17,77,"M.C.G.",-10,2023,"Regular",11,"Away","Port Adelaide","Richmond",10
16288,2023-05-28,"R11","Collingwood",16,9,105,"North Melbourne",10,10,70,"Docklands",35,2023,"Regular",11,"Home","Collingwood","North Melbourne",35
16289,2023-05-28,"R11","Adelaide",14,11,95,"Brisbane Lions",10,18,78,"Adelaide Oval",17,2023,"Regular",11,"Home","Adelaide","Brisbane Lions",17
16290,2023-06-02,"R12","Melbourne",8,13,61,"Carlton",6,8,44,"M.C.G.",17,2023,"Regular",12,"Home","Melbourne","Carlton",17
16291,2023-06-03,"R12","Port Adelaide",23,13,151,"Hawthorn",14,12,96,"Adelaide Oval",55,2023,"Regular",12,"Home","Port Adelaide","Hawthorn",55
16292,2023-06-03,"R12","West Coast",8,9,57,"Collingwood",18,12,120,"Perth Stadium",-63,2023,"Regular",12,"Away","Collingwood","West Coast",63
16293,2023-06-03,"R12","Footscray",10,15,75,"Geelong",15,7,97,"Docklands",-22,2023,"Regular",12,"Away","Geelong","Footscray",22
16294,2023-06-03,"R12","Gold Coast",16,16,112,"Adelaide",13,9,87,"Marrara Oval",25,2023,"Regular",12,"Home","Gold Coast","Adelaide",25
16295,2023-06-04,"R12","GWS",15,14,104,"Richmond",16,14,110,"Sydney Showground",-6,2023,"Regular",12,"Away","Richmond","GWS",6
16296,2023-06-04,"R12","Essendon",16,9,105,"North Melbourne",15,9,99,"Docklands",6,2023,"Regular",12,"Home","Essendon","North Melbourne",6
16297,2023-06-08,"R13","Sydney",9,12,66,"St Kilda",12,8,80,"S.C.G.",-14,2023,"Regular",13,"Away","St Kilda","Sydney",14
16298,2023-06-09,"R13","Footscray",13,7,85,"Port Adelaide",16,11,107,"Docklands",-22,2023,"Regular",13,"Away","Port Adelaide","Footscray",22
16299,2023-06-10,"R13","Hawthorn",15,8,98,"Brisbane Lions",11,7,73,"M.C.G.",25,2023,"Regular",13,"Home","Hawthorn","Brisbane Lions",25
16300,2023-06-10,"R13","Adelaide",27,12,174,"West Coast",8,4,52,"Adelaide Oval",122,2023,"Regular",13,"Home","Adelaide","West Coast",122
16301,2023-06-10,"R13","Fremantle",10,10,70,"Richmond",12,13,85,"Perth Stadium",-15,2023,"Regular",13,"Away","Richmond","Fremantle",15
16302,2023-06-11,"R13","North Melbourne",11,9,75,"GWS",15,13,103,"Bellerive Oval",-28,2023,"Regular",13,"Away","GWS","North Melbourne",28
16303,2023-06-11,"R13","Carlton",6,16,52,"Essendon",13,8,86,"M.C.G.",-34,2023,"Regular",13,"Away","Essendon","Carlton",34
16304,2023-06-12,"R13","Melbourne",8,18,66,"Collingwood",9,8,62,"M.C.G.",4,2023,"Regular",13,"Home","Melbourne","Collingwood",4
16305,2023-06-15,"R14","Port Adelaide",16,14,110,"Geelong",11,6,72,"Adelaide Oval",38,2023,"Regular",14,"Home","Port Adelaide","Geelong",38
16306,2023-06-16,"R14","Brisbane Lions",13,19,97,"Sydney",12,9,81,"Gabba",16,2023,"Regular",14,"Home","Brisbane Lions","Sydney",16
16307,2023-06-17,"R14","GWS",16,10,106,"Fremantle",5,6,36,"Sydney Showground",70,2023,"Regular",14,"Home","GWS","Fremantle",70
16308,2023-06-17,"R14","Richmond",13,12,90,"St Kilda",11,4,70,"M.C.G.",20,2023,"Regular",14,"Home","Richmond","St Kilda",20
16309,2023-06-18,"R14","Carlton",18,12,120,"Gold Coast",8,13,61,"M.C.G.",59,2023,"Regular",14,"Home","Carlton","Gold Coast",59
16310,2023-06-18,"R14","North Melbourne",13,6,84,"Footscray",15,15,105,"Docklands",-21,2023,"Regular",14,"Away","Footscray","North Melbourne",21
16311,2023-06-22,"R15","Geelong",11,12,78,"Melbourne",8,15,63,"Kardinia Park",15,2023,"Regular",15,"Home","Geelong","Melbourne",15
16312,2023-06-23,"R15","St Kilda",8,8,56,"Brisbane Lions",12,12,84,"Docklands",-28,2023,"Regular",15,"Away","Brisbane Lions","St Kilda",28
16313,2023-06-24,"R15","Sydney",31,19,205,"West Coast",5,4,34,"S.C.G.",171,2023,"Regular",15,"Home","Sydney","West Coast",171
16314,2023-06-24,"R15","Fremantle",14,9,93,"Essendon",9,7,61,"Perth Stadium",32,2023,"Regular",15,"Home","Fremantle","Essendon",32
16315,2023-06-25,"R15","Collingwood",12,10,82,"Adelaide",11,14,80,"M.C.G.",2,2023,"Regular",15,"Home","Collingwood","Adelaide",2
16316,2023-06-25,"R15","Gold Coast",14,17,101,"Hawthorn",5,4,34,"Carrara",67,2023,"Regular",15,"Home","Gold Coast","Hawthorn",67
16317,2023-06-29,"R16","Brisbane Lions",20,14,134,"Richmond",7,11,53,"Gabba",81,2023,"Regular",16,"Home","Brisbane Lions","Richmond",81
16318,2023-06-30,"R16","Sydney",6,18,54,"Geelong",7,12,54,"S.C.G.",0,2023,"Regular",16,"Home","Sydney","Geelong",0
16319,2023-07-01,"R16","Adelaide",21,12,138,"North Melbourne",11,6,72,"Adelaide Oval",66,2023,"Regular",16,"Home","Adelaide","North Melbourne",66
16320,2023-07-01,"R16","Footscray",16,6,102,"Fremantle",11,7,73,"Docklands",29,2023,"Regular",16,"Home","Footscray","Fremantle",29
16321,2023-07-01,"R16","Gold Coast",5,12,42,"Collingwood",18,12,120,"Carrara",-78,2023,"Regular",16,"Away","Collingwood","Gold Coast",78
16322,2023-07-01,"R16","Essendon",10,14,74,"Port Adelaide",11,12,78,"M.C.G.",-4,2023,"Regular",16,"Away","Port Adelaide","Essendon",4
16323,2023-07-02,"R16","Hawthorn",7,10,52,"Carlton",17,10,112,"M.C.G.",-60,2023,"Regular",16,"Away","Carlton","Hawthorn",60
16324,2023-07-02,"R16","Melbourne",5,15,45,"GWS",7,5,47,"Traeger Park",-2,2023,"Regular",16,"Away","GWS","Melbourne",2
16325,2023-07-02,"R16","West Coast",12,5,77,"St Kilda",12,13,85,"Perth Stadium",-8,2023,"Regular",16,"Away","St Kilda","West Coast",8
16326,2023-07-06,"R17","Richmond",12,16,88,"Sydney",11,9,75,"M.C.G.",13,2023,"Regular",17,"Home","Richmond","Sydney",13
16327,2023-07-07,"R17","Footscray",11,11,77,"Collingwood",13,11,89,"Docklands",-12,2023,"Regular",17,"Away","Collingwood","Footscray",12
16328,2023-07-08,"R17","Brisbane Lions",16,20,116,"West Coast",5,5,35,"Gabba",81,2023,"Regular",17,"Home","Brisbane Lions","West Coast",81
16329,2023-07-08,"R17","GWS",12,13,85,"Hawthorn",10,12,72,"Sydney Showground",13,2023,"Regular",17,"Home","GWS","Hawthorn",13
16330,2023-07-08,"R17","St Kilda",8,10,58,"Melbourne",12,7,79,"Docklands",-21,2023,"Regular",17,"Away","Melbourne","St Kilda",21
16331,2023-07-08,"R17","Port Adelaide",16,10,106,"Gold Coast",11,7,73,"Adelaide Oval",33,2023,"Regular",17,"Home","Port Adelaide","Gold Coast",33
16332,2023-07-09,"R17","Geelong",19,11,125,"North Melbourne",9,9,63,"Kardinia Park",62,2023,"Regular",17,"Home","Geelong","North Melbourne",62
16333,2023-07-09,"R17","Essendon",17,13,115,"Adelaide",15,7,97,"Docklands",18,2023,"Regular",17,"Home","Essendon","Adelaide",18
16334,2023-07-09,"R17","Fremantle",6,9,45,"Carlton",14,14,98,"Perth Stadium",-53,2023,"Regular",17,"Away","Carlton","Fremantle",53
16335,2023-07-13,"R18","Sydney",11,12,78,"Footscray",11,10,76,"S.C.G.",2,2023,"Regular",18,"Home","Sydney","Footscray",2
16336,2023-07-14,"R18","Melbourne",16,9,105,"Brisbane Lions",16,8,104,"M.C.G.",1,2023,"Regular",18,"Home","Melbourne","Brisbane Lions",1
16337,2023-07-15,"R18","Collingwood",18,5,113,"Fremantle",10,7,67,"M.C.G.",46,2023,"Regular",18,"Home","Collingwood","Fremantle",46
16338,2023-07-15,"R18","Gold Coast",11,11,77,"St Kilda",8,3,51,"Carrara",26,2023,"Regular",18,"Home","Gold Coast","St Kilda",26
16339,2023-07-15,"R18","Carlton",18,14,122,"Port Adelaide",10,12,72,"Docklands",50,2023,"Regular",18,"Home","Carlton","Port Adelaide",50
16340,2023-07-15,"R18","Geelong",18,14,122,"Essendon",7,3,45,"Kardinia Park",77,2023,"Regular",18,"Home","Geelong","Essendon",77
16341,2023-07-15,"R18","Adelaide",8,9,57,"GWS",10,11,71,"Adelaide Oval",-14,2023,"Regular",18,"Away","GWS","Adelaide",14
16342,2023-07-16,"R18","North Melbourne",6,4,40,"Hawthorn",12,16,88,"Docklands",-48,2023,"Regular",18,"Away","Hawthorn","North Melbourne",48
16343,2023-07-16,"R18","West Coast",8,12,60,"Richmond",14,14,98,"Perth Stadium",-38,2023,"Regular",18,"Away","Richmond","West Coast",38
16344,2023-07-21,"R19","Essendon",7,7,49,"Footscray",13,12,90,"Docklands",-41,2023,"Regular",19,"Away","Footscray","Essendon",41
16345,2023-07-22,"R19","Richmond",14,12,96,"Hawthorn",15,5,95,"M.C.G.",1,2023,"Regular",19,"Home","Richmond","Hawthorn",1
16346,2023-07-22,"R19","Carlton",21,14,140,"West Coast",10,9,69,"Docklands",71,2023,"Regular",19,"Home","Carlton","West Coast",71
16347,2023-07-22,"R19","Brisbane Lions",9,10,64,"Geelong",7,11,53,"Gabba",11,2023,"Regular",19,"Home","Brisbane Lions","Geelong",11
16348,2023-07-22,"R19","Port Adelaide",12,11,83,"Collingwood",13,7,85,"Adelaide Oval",-2,2023,"Regular",19,"Away","Collingwood","Port Adelaide",2
16349,2023-07-22,"R19","Fremantle",12,4,76,"Sydney",16,9,105,"Perth Stadium",-29,2023,"Regular",19,"Away","Sydney","Fremantle",29
16350,2023-07-23,"R19","GWS",15,13,103,"Gold Coast",9,9,63,"Manuka Oval",40,2023,"Regular",19,"Home","GWS","Gold Coast",40
16351,2023-07-23,"R19","Melbourne",14,13,97,"Adelaide",13,15,93,"M.C.G.",4,2023,"Regular",19,"Home","Melbourne","Adelaide",4
16352,2023-07-23,"R19","St Kilda",9,15,69,"North Melbourne",9,7,61,"Docklands",8,2023,"Regular",19,"Home","St Kilda","North Melbourne",8
16353,2023-07-28,"R20","Collingwood",10,16,76,"Carlton",14,9,93,"M.C.G.",-17,2023,"Regular",20,"Away","Carlton","Collingwood",17
16354,2023-07-29,"R20","Footscray",10,13,73,"GWS",11,12,78,"Eureka Stadium",-5,2023,"Regular",20,"Away","GWS","Footscray",5
16355,2023-07-29,"R20","Geelong",9,10,64,"Fremantle",10,11,71,"Kardinia Park",-7,2023,"Regular",20,"Away","Fremantle","Geelong",7
16356,2023-07-29,"R20","Gold Coast",15,6,96,"Brisbane Lions",7,13,55,"Carrara",41,2023,"Regular",20,"Home","Gold Coast","Brisbane Lions",41
16357,2023-07-29,"R20","Essendon",15,9,99,"Sydney",15,11,101,"Docklands",-2,2023,"Regular",20,"Away","Sydney","Essendon",2
16358,2023-07-29,"R20","Adelaide",16,16,112,"Port Adelaide",9,11,65,"Adelaide Oval",47,2023,"Regular",20,"Home","Adelaide","Port Adelaide",47
16359,2023-07-30,"R20","Hawthorn",14,9,93,"St Kilda",19,8,122,"Docklands",-29,2023,"Regular",20,"Away","St Kilda","Hawthorn",29
16360,2023-07-30,"R20","Richmond",15,8,98,"Melbourne",20,10,130,"M.C.G.",-32,2023,"Regular",20,"Away","Melbourne","Richmond",32
16361,2023-07-30,"R20","West Coast",10,12,72,"North Melbourne",10,7,67,"Perth Stadium",5,2023,"Regular",20,"Home","West Coast","North Melbourne",5
16362,2023-08-04,"R21","Footscray",19,12,126,"Richmond",10,11,71,"Docklands",55,2023,"Regular",21,"Home","Footscray","Richmond",55
16363,2023-08-05,"R21","Essendon",10,13,73,"West Coast",11,6,72,"Docklands",1,2023,"Regular",21,"Home","Essendon","West Coast",1
16364,2023-08-05,"R21","Adelaide",13,11,89,"Gold Coast",9,7,61,"Adelaide Oval",28,2023,"Regular",21,"Home","Adelaide","Gold Coast",28
16365,2023-08-05,"R21","Hawthorn",16,9,105,"Collingwood",11,7,73,"M.C.G.",32,2023,"Regular",21,"Home","Hawthorn","Collingwood",32
16366,2023-08-05,"R21","Geelong",14,13,97,"Port Adelaide",12,13,85,"Kardinia Park",12,2023,"Regular",21,"Home","Geelong","Port Adelaide",12
16367,2023-08-05,"R21","GWS",12,13,85,"Sydney",15,6,96,"Sydney Showground",-11,2023,"Regular",21,"Away","Sydney","GWS",11
16368,2023-08-06,"R21","North Melbourne",10,11,71,"Melbourne",15,13,103,"Bellerive Oval",-32,2023,"Regular",21,"Away","Melbourne","North Melbourne",32
16369,2023-08-06,"R21","St Kilda",8,6,54,"Carlton",10,13,73,"Docklands",-19,2023,"Regular",21,"Away","Carlton","St Kilda",19
16370,2023-08-06,"R21","Fremantle",11,8,74,"Brisbane Lions",11,11,77,"Perth Stadium",-3,2023,"Regular",21,"Away","Brisbane Lions","Fremantle",3
16371,2023-08-11,"R22","Collingwood",16,13,109,"Geelong",15,11,101,"M.C.G.",8,2023,"Regular",22,"Home","Collingwood","Geelong",8
16372,2023-08-12,"R22","North Melbourne",12,5,77,"Essendon",13,8,86,"Docklands",-9,2023,"Regular",22,"Away","Essendon","North Melbourne",9
16373,2023-08-12,"R22","Sydney",18,6,114,"Gold Coast",13,12,90,"S.C.G.",24,2023,"Regular",22,"Home","Sydney","Gold Coast",24
16374,2023-08-12,"R22","Brisbane Lions",15,9,99,"Adelaide",13,15,93,"Gabba",6,2023,"Regular",22,"Home","Brisbane Lions","Adelaide",6
16375,2023-08-12,"R22","Carlton",9,6,60,"Melbourne",8,8,56,"M.C.G.",4,2023,"Regular",22,"Home","Carlton","Melbourne",4
16376,2023-08-12,"R22","West Coast",4,9,33,"Fremantle",20,14,134,"Perth Stadium",-101,2023,"Regular",22,"Away","Fremantle","West Coast",101
16377,2023-08-13,"R22","Hawthorn",9,13,67,"Footscray",9,10,64,"York Park",3,2023,"Regular",22,"Home","Hawthorn","Footscray",3
16378,2023-08-13,"R22","St Kilda",14,9,93,"Richmond",8,9,57,"Docklands",36,2023,"Regular",22,"Home","St Kilda","Richmond",36
16379,2023-08-13,"R22","Port Adelaide",21,10,136,"GWS",13,7,85,"Adelaide Oval",51,2023,"Regular",22,"Home","Port Adelaide","GWS",51
16380,2023-08-18,"R23","Collingwood",15,10,100,"Brisbane Lions",19,10,124,"Docklands",-24,2023,"Regular",23,"Away","Brisbane Lions","Collingwood",24
16381,2023-08-19,"R23","Richmond",14,17,101,"North Melbourne",10,12,72,"M.C.G.",29,2023,"Regular",23,"Home","Richmond","North Melbourne",29
16382,2023-08-19,"R23","Gold Coast",13,9,87,"Carlton",13,13,91,"Carrara",-4,2023,"Regular",23,"Away","Carlton","Gold Coast",4
16383,2023-08-19,"R23","GWS",25,12,162,"Essendon",5,6,36,"Sydney Showground",126,2023,"Regular",23,"Home","GWS","Essendon",126
16384,2023-08-19,"R23","St Kilda",12,16,88,"Geelong",8,7,55,"Docklands",33,2023,"Regular",23,"Home","St Kilda","Geelong",33
16385,2023-08-19,"R23","Adelaide",10,13,73,"Sydney",11,8,74,"Adelaide Oval",-1,2023,"Regular",23,"Away","Sydney","Adelaide",1
16386,2023-08-20,"R23","Footscray",12,13,85,"West Coast",14,8,92,"Docklands",-7,2023,"Regular",23,"Away","West Coast","Footscray",7
16387,2023-08-20,"R23","Melbourne",13,9,87,"Hawthorn",9,6,60,"M.C.G.",27,2023,"Regular",23,"Home","Melbourne","Hawthorn",27
16388,2023-08-20,"R23","Fremantle",8,10,58,"Port Adelaide",11,8,74,"Perth Stadium",-16,2023,"Regular",23,"Away","Port Adelaide","Fremantle",16
16389,2023-08-25,"R24","Essendon",3,13,31,"Collingwood",16,5,101,"M.C.G.",-70,2023,"Regular",24,"Away","Collingwood","Essendon",70
16390,2023-08-26,"R24","Hawthorn",8,8,56,"Fremantle",14,9,93,"M.C.G.",-37,2023,"Regular",24,"Away","Fremantle","Hawthorn",37
16391,2023-08-26,"R24","North Melbourne",20,12,132,"Gold Coast",14,13,97,"Bellerive Oval",35,2023,"Regular",24,"Home","North Melbourne","Gold Coast",35
16392,2023-08-26,"R24","Brisbane Lions",9,18,72,"St Kilda",9,6,60,"Gabba",12,2023,"Regular",24,"Home","Brisbane Lions","St Kilda",12
16393,2023-08-26,"R24","Geelong",11,13,79,"Footscray",16,8,104,"Kardinia Park",-25,2023,"Regular",24,"Away","Footscray","Geelong",25
16394,2023-08-26,"R24","West Coast",12,6,78,"Adelaide",17,21,123,"Perth Stadium",-45,2023,"Regular",24,"Away","Adelaide","West Coast",45
16395,2023-08-27,"R24","Port Adelaide",13,16,94,"Richmond",8,15,63,"Adelaide Oval",31,2023,"Regular",24,"Home","Port Adelaide","Richmond",31
16396,2023-08-27,"R24","Sydney",7,14,56,"Melbourne",11,11,77,"S.C.G.",-21,2023,"Regular",24,"Away","Melbourne","Sydney",21
16397,2023-08-27,"R24","Carlton",11,7,73,"GWS",16,9,105,"Docklands",-32,2023,"Regular",24,"Away","GWS","Carlton",32
16398,2023-09-07,"QF","Collingwood",9,6,60,"Melbourne",7,11,53,"M.C.G.",7,2023,"Finals",25,"Home","Collingwood","Melbourne",7
16399,2023-09-08,"EF","Carlton",11,8,74,"Sydney",9,14,68,"M.C.G.",6,2023,"Finals",25,"Home","Carlton","Sydney",6
16400,2023-09-09,"EF","St Kilda",11,11,77,"GWS",15,11,101,"M.C.G.",-24,2023,"Finals",25,"Away","GWS","St Kilda",24
16401,2023-09-09,"QF","Brisbane Lions",19,9,123,"Port Adelaide",11,9,75,"Gabba",48,2023,"Finals",25,"Home","Brisbane Lions","Port Adelaide",48
16402,2023-09-15,"SF","Melbourne",9,17,71,"Carlton",11,7,73,"M.C.G.",-2,2023,"Finals",26,"Away","Carlton","Melbourne",2
16403,2023-09-16,"SF","Port Adelaide",9,16,70,"GWS",13,15,93,"Adelaide Oval",-23,2023,"Finals",26,"Away","GWS","Port Adelaide",23
16404,2023-09-22,"PF","Collingwood",8,10,58,"GWS",8,9,57,"M.C.G.",1,2023,"Finals",27,"Home","Collingwood","GWS",1
16405,2023-09-23,"PF","Brisbane Lions",11,13,79,"Carlton",9,9,63,"Gabba",16,2023,"Finals",27,"Home","Brisbane Lions","Carlton",16
16406,2023-09-30,"GF","Collingwood",12,18,90,"Brisbane Lions",13,8,86,"M.C.G.",4,2023,"Finals",28,"Home","Collingwood","Brisbane Lions",4
16407,2024-03-07,"R1","Sydney",12,14,86,"Melbourne",9,10,64,"S.C.G.",22,2024,"Regular",1,"Home","Sydney","Melbourne",22
16408,2024-03-08,"R1","Brisbane Lions",12,13,85,"Carlton",13,8,86,"Gabba",-1,2024,"Regular",1,"Away","Carlton","Brisbane Lions",1
16409,2024-03-09,"R1","Gold Coast",14,15,99,"Richmond",9,6,60,"Carrara",39,2024,"Regular",1,"Home","Gold Coast","Richmond",39
16410,2024-03-09,"R1","GWS",18,6,114,"Collingwood",11,16,82,"Sydney Showground",32,2024,"Regular",1,"Home","GWS","Collingwood",32
16411,2024-03-14,"R2","Carlton",12,14,86,"Richmond",12,9,81,"M.C.G.",5,2024,"Regular",2,"Home","Carlton","Richmond",5
16412,2024-03-15,"R2","Collingwood",10,9,69,"Sydney",15,12,102,"M.C.G.",-33,2024,"Regular",2,"Away","Sydney","Collingwood",33
16413,2024-03-16,"R2","Essendon",17,5,107,"Hawthorn",11,17,83,"M.C.G.",24,2024,"Regular",2,"Home","Essendon","Hawthorn",24
16414,2024-03-16,"R2","GWS",17,19,121,"North Melbourne",13,4,82,"Sydney Showground",39,2024,"Regular",2,"Home","GWS","North Melbourne",39
16415,2024-03-16,"R2","Geelong",10,16,76,"St Kilda",9,14,68,"Kardinia Park",8,2024,"Regular",2,"Home","Geelong","St Kilda",8
16416,2024-03-16,"R2","Gold Coast",8,12,60,"Adelaide",8,6,54,"Carrara",6,2024,"Regular",2,"Home","Gold Coast","Adelaide",6
16417,2024-03-17,"R2","Melbourne",16,13,109,"Footscray",9,10,64,"M.C.G.",45,2024,"Regular",2,"Home","Melbourne","Footscray",45
16418,2024-03-17,"R2","Port Adelaide",16,24,120,"West Coast",10,10,70,"Adelaide Oval",50,2024,"Regular",2,"Home","Port Adelaide","West Coast",50
16419,2024-03-17,"R2","Fremantle",14,9,93,"Brisbane Lions",10,10,70,"Perth Stadium",23,2024,"Regular",2,"Home","Fremantle","Brisbane Lions",23
16420,2024-03-21,"R3","St Kilda",14,10,94,"Collingwood",12,7,79,"M.C.G.",15,2024,"Regular",3,"Home","St Kilda","Collingwood",15
16421,2024-03-22,"R3","Adelaide",11,11,77,"Geelong",14,12,96,"Adelaide Oval",-19,2024,"Regular",3,"Away","Geelong","Adelaide",19
16422,2024-03-23,"R3","North Melbourne",11,10,76,"Fremantle",15,12,102,"Docklands",-26,2024,"Regular",3,"Away","Fremantle","North Melbourne",26
16423,2024-03-23,"R3","Hawthorn",5,8,38,"Melbourne",14,9,93,"M.C.G.",-55,2024,"Regular",3,"Away","Melbourne","Hawthorn",55
16424,2024-03-23,"R3","Sydney",19,17,131,"Essendon",15,11,101,"S.C.G.",30,2024,"Regular",3,"Home","Sydney","Essendon",30
16425,2024-03-24,"R3","Footscray",18,7,115,"Gold Coast",10,7,67,"Eureka Stadium",48,2024,"Regular",3,"Home","Footscray","Gold Coast",48
16426,2024-03-24,"R3","Richmond",13,14,92,"Port Adelaide",18,14,122,"M.C.G.",-30,2024,"Regular",3,"Away","Port Adelaide","Richmond",30
16427,2024-03-24,"R3","West Coast",5,13,43,"GWS",16,12,108,"Perth Stadium",-65,2024,"Regular",3,"Away","GWS","West Coast",65
16428,2024-03-28,"R4","Brisbane Lions",10,12,72,"Collingwood",14,8,92,"Gabba",-20,2024,"Regular",4,"Away","Collingwood","Brisbane Lions",20
16429,2024-03-29,"R4","North Melbourne",12,9,81,"Carlton",21,11,137,"Docklands",-56,2024,"Regular",4,"Away","Carlton","North Melbourne",56
16430,2024-03-29,"R4","Fremantle",9,15,69,"Adelaide",4,10,34,"Perth Stadium",35,2024,"Regular",4,"Home","Fremantle","Adelaide",35
16431,2024-03-30,"R4","Essendon",10,11,71,"St Kilda",9,13,67,"Docklands",4,2024,"Regular",4,"Home","Essendon","St Kilda",4
16432,2024-03-30,"R4","Port Adelaide",13,11,89,"Melbourne",15,6,96,"Adelaide Oval",-7,2024,"Regular",4,"Away","Melbourne","Port Adelaide",7
16433,2024-03-31,"R4","Footscray",16,10,106,"West Coast",3,12,30,"Docklands",76,2024,"Regular",4,"Home","Footscray","West Coast",76
16434,2024-03-31,"R4","Richmond",11,16,82,"Sydney",11,11,77,"M.C.G.",5,2024,"Regular",4,"Home","Richmond","Sydney",5
16435,2024-04-01,"R4","Hawthorn",10,10,70,"Geelong",17,4,106,"M.C.G.",-36,2024,"Regular",4,"Away","Geelong","Hawthorn",36
16436,2024-04-04,"R5","Adelaide",8,15,63,"Melbourne",10,18,78,"Adelaide Oval",-15,2024,"Regular",5,"Away","Melbourne","Adelaide",15
16437,2024-04-05,"R5","Brisbane Lions",16,16,112,"North Melbourne",6,6,42,"Norwood Oval",70,2024,"Regular",5,"Home","Brisbane Lions","North Melbourne",70
16438,2024-04-05,"R5","Port Adelaide",17,9,111,"Essendon",6,6,42,"Adelaide Oval",69,2024,"Regular",5,"Home","Port Adelaide","Essendon",69
16439,2024-04-06,"R5","West Coast",11,12,78,"Sydney",15,14,104,"Summit Sports Park",-26,2024,"Regular",5,"Away","Sydney","West Coast",26
16440,2024-04-06,"R5","Fremantle",9,9,63,"Carlton",10,13,73,"Adelaide Oval",-10,2024,"Regular",5,"Away","Carlton","Fremantle",10
16441,2024-04-06,"R5","Footscray",14,7,91,"Geelong",14,11,95,"Adelaide Oval",-4,2024,"Regular",5,"Away","Geelong","Footscray",4
16442,2024-04-07,"R5","Gold Coast",13,11,89,"GWS",18,9,117,"Summit Sports Park",-28,2024,"Regular",5,"Away","GWS","Gold Coast",28
16443,2024-04-07,"R5","Richmond",9,6,60,"St Kilda",9,13,67,"Norwood Oval",-7,2024,"Regular",5,"Away","St Kilda","Richmond",7
16444,2024-04-07,"R5","Collingwood",11,11,77,"Hawthorn",11,6,72,"Adelaide Oval",5,2024,"Regular",5,"Home","Collingwood","Hawthorn",5
16445,2024-04-11,"R6","Melbourne",8,12,60,"Brisbane Lions",12,10,82,"M.C.G.",-22,2024,"Regular",6,"Away","Brisbane Lions","Melbourne",22
16446,2024-04-12,"R6","Footscray",9,13,67,"Essendon",15,6,96,"Docklands",-29,2024,"Regular",6,"Away","Essendon","Footscray",29
16447,2024-04-13,"R6","GWS",11,14,80,"St Kilda",12,7,79,"Manuka Oval",1,2024,"Regular",6,"Home","GWS","St Kilda",1
16448,2024-04-13,"R6","Carlton",14,14,98,"Adelaide",16,4,100,"Docklands",-2,2024,"Regular",6,"Away","Adelaide","Carlton",2
16449,2024-04-13,"R6","Port Adelaide",9,12,66,"Fremantle",9,9,63,"Adelaide Oval",3,2024,"Regular",6,"Home","Port Adelaide","Fremantle",3
16450,2024-04-13,"R6","Gold Coast",16,13,109,"Hawthorn",8,8,56,"Carrara",53,2024,"Regular",6,"Home","Gold Coast","Hawthorn",53
16451,2024-04-14,"R6","Geelong",21,13,139,"North Melbourne",10,4,64,"Kardinia Park",75,2024,"Regular",6,"Home","Geelong","North Melbourne",75
16452,2024-04-14,"R6","West Coast",16,13,109,"Richmond",10,10,70,"Perth Stadium",39,2024,"Regular",6,"Home","West Coast","Richmond",39
16453,2024-04-18,"R7","St Kilda",9,10,64,"Footscray",19,10,124,"Docklands",-60,2024,"Regular",7,"Away","Footscray","St Kilda",60
16454,2024-04-19,"R7","Adelaide",11,9,75,"Essendon",10,18,78,"Adelaide Oval",-3,2024,"Regular",7,"Away","Essendon","Adelaide",3
16455,2024-04-20,"R7","Collingwood",17,21,123,"Port Adelaide",12,9,81,"M.C.G.",42,2024,"Regular",7,"Home","Collingwood","Port Adelaide",42
16456,2024-04-20,"R7","Carlton",17,15,117,"GWS",15,8,98,"Docklands",19,2024,"Regular",7,"Home","Carlton","GWS",19
16457,2024-04-20,"R7","Brisbane Lions",4,13,37,"Geelong",9,9,63,"Gabba",-26,2024,"Regular",7,"Away","Geelong","Brisbane Lions",26
16458,2024-04-20,"R7","West Coast",16,9,105,"Fremantle",10,8,68,"Perth Stadium",37,2024,"Regular",7,"Home","West Coast","Fremantle",37
16459,2024-04-21,"R7","Sydney",17,8,110,"Gold Coast",8,9,57,"S.C.G.",53,2024,"Regular",7,"Home","Sydney","Gold Coast",53
16460,2024-04-21,"R7","North Melbourne",10,8,68,"Hawthorn",17,11,113,"Docklands",-45,2024,"Regular",7,"Away","Hawthorn","North Melbourne",45
16461,2024-04-24,"R8","Richmond",5,12,42,"Melbourne",13,7,85,"M.C.G.",-43,2024,"Regular",8,"Away","Melbourne","Richmond",43
16462,2024-04-25,"R8","Essendon",12,13,85,"Collingwood",12,13,85,"M.C.G.",0,2024,"Regular",8,"Home","Essendon","Collingwood",0
16463,2024-04-25,"R8","GWS",17,11,113,"Brisbane Lions",8,11,59,"Manuka Oval",54,2024,"Regular",8,"Home","GWS","Brisbane Lions",54
16464,2024-04-26,"R8","Port Adelaide",11,16,82,"St Kilda",11,6,72,"Adelaide Oval",10,2024,"Regular",8,"Home","Port Adelaide","St Kilda",10
16465,2024-04-27,"R8","North Melbourne",12,9,81,"Adelaide",20,18,138,"Bellerive Oval",-57,2024,"Regular",8,"Away","Adelaide","North Melbourne",57
16466,2024-04-27,"R8","Geelong",18,10,118,"Carlton",15,15,105,"M.C.G.",13,2024,"Regular",8,"Home","Geelong","Carlton",13
16467,2024-04-27,"R8","Fremantle",14,11,95,"Footscray",10,11,71,"Perth Stadium",24,2024,"Regular",8,"Home","Fremantle","Footscray",24
16468,2024-04-28,"R8","Gold Coast",17,10,112,"West Coast",12,3,75,"Carrara",37,2024,"Regular",8,"Home","Gold Coast","West Coast",37
16469,2024-04-28,"R8","Hawthorn",5,12,42,"Sydney",18,10,118,"M.C.G.",-76,2024,"Regular",8,"Away","Sydney","Hawthorn",76
16470,2024-05-02,"R9","Adelaide",12,6,78,"Port Adelaide",5,18,48,"Adelaide Oval",30,2024,"Regular",9,"Home","Adelaide","Port Adelaide",30
16471,2024-05-03,"R9","Carlton",12,7,79,"Collingwood",12,13,85,"M.C.G.",-6,2024,"Regular",9,"Away","Collingwood","Carlton",6
16472,2024-05-04,"R9","Sydney",14,14,98,"GWS",10,9,69,"S.C.G.",29,2024,"Regular",9,"Home","Sydney","GWS",29
16473,2024-05-04,"R9","St Kilda",15,13,103,"North Melbourne",10,5,65,"Docklands",38,2024,"Regular",9,"Home","St Kilda","North Melbourne",38
16474,2024-05-04,"R9","Melbourne",10,14,74,"Geelong",9,12,66,"M.C.G.",8,2024,"Regular",9,"Home","Melbourne","Geelong",8
16475,2024-05-04,"R9","West Coast",11,5,71,"Essendon",11,11,77,"Perth Stadium",-6,2024,"Regular",9,"Away","Essendon","West Coast",6
16476,2024-05-05,"R9","Richmond",6,13,49,"Fremantle",15,13,103,"M.C.G.",-54,2024,"Regular",9,"Away","Fremantle","Richmond",54
16477,2024-05-05,"R9","Footscray",14,7,91,"Hawthorn",14,14,98,"Docklands",-7,2024,"Regular",9,"Away","Hawthorn","Footscray",7
16478,2024-05-05,"R9","Brisbane Lions",10,19,79,"Gold Coast",6,9,45,"Gabba",34,2024,"Regular",9,"Home","Brisbane Lions","Gold Coast",34
16479,2024-05-09,"R10","Carlton",12,5,77,"Melbourne",11,10,76,"M.C.G.",1,2024,"Regular",10,"Home","Carlton","Melbourne",1
16480,2024-05-10,"R10","Geelong",14,11,95,"Port Adelaide",15,11,101,"Kardinia Park",-6,2024,"Regular",10,"Away","Port Adelaide","Geelong",6
16481,2024-05-10,"R10","Fremantle",4,15,39,"Sydney",13,9,87,"Perth Stadium",-48,2024,"Regular",10,"Away","Sydney","Fremantle",48
16482,2024-05-11,"R10","Hawthorn",8,10,58,"St Kilda",7,11,53,"York Park",5,2024,"Regular",10,"Home","Hawthorn","St Kilda",5
16483,2024-05-11,"R10","Essendon",12,10,82,"GWS",9,8,62,"Docklands",20,2024,"Regular",10,"Home","Essendon","GWS",20
16484,2024-05-11,"R10","Richmond",6,6,42,"Footscray",19,19,133,"M.C.G.",-91,2024,"Regular",10,"Away","Footscray","Richmond",91
16485,2024-05-11,"R10","Gold Coast",17,18,120,"North Melbourne",7,10,52,"Marrara Oval",68,2024,"Regular",10,"Home","Gold Coast","North Melbourne",68
16486,2024-05-12,"R10","Collingwood",15,13,103,"West Coast",5,7,37,"Docklands",66,2024,"Regular",10,"Home","Collingwood","West Coast",66
16487,2024-05-12,"R10","Adelaide",13,12,90,"Brisbane Lions",13,12,90,"Adelaide Oval",0,2024,"Regular",10,"Home","Adelaide","Brisbane Lions",0
16488,2024-05-16,"R11","Gold Coast",26,8,164,"Geelong",15,10,100,"Marrara Oval",64,2024,"Regular",11,"Home","Gold Coast","Geelong",64
16489,2024-05-17,"R11","Sydney",17,15,117,"Carlton",9,11,65,"S.C.G.",52,2024,"Regular",11,"Home","Sydney","Carlton",52
16490,2024-05-18,"R11","Collingwood",12,6,78,"Adelaide",11,8,74,"M.C.G.",4,2024,"Regular",11,"Home","Collingwood","Adelaide",4
16491,2024-05-18,"R11","GWS",6,7,43,"Footscray",8,22,70,"Sydney Showground",-27,2024,"Regular",11,"Away","Footscray","GWS",27
16492,2024-05-18,"R11","St Kilda",8,7,55,"Fremantle",9,18,72,"Docklands",-17,2024,"Regular",11,"Away","Fremantle","St Kilda",17
16493,2024-05-18,"R11","Brisbane Lions",26,7,163,"Richmond",6,8,44,"Gabba",119,2024,"Regular",11,"Home","Brisbane Lions","Richmond",119
16494,2024-05-19,"R11","Essendon",16,10,106,"North Melbourne",10,6,66,"Docklands",40,2024,"Regular",11,"Home","Essendon","North Melbourne",40
16495,2024-05-19,"R11","Port Adelaide",11,14,80,"Hawthorn",12,7,79,"Adelaide Oval",1,2024,"Regular",11,"Home","Port Adelaide","Hawthorn",1
16496,2024-05-19,"R11","West Coast",16,9,105,"Melbourne",10,10,70,"Perth Stadium",35,2024,"Regular",11,"Home","West Coast","Melbourne",35
16497,2024-05-23,"R12","Footscray",12,16,88,"Sydney",16,6,102,"Docklands",-14,2024,"Regular",12,"Away","Sydney","Footscray",14
16498,2024-05-24,"R12","Fremantle",11,9,75,"Collingwood",10,15,75,"Perth Stadium",0,2024,"Regular",12,"Home","Fremantle","Collingwood",0
16499,2024-05-25,"R12","Carlton",15,12,102,"Gold Coast",11,7,73,"Docklands",29,2024,"Regular",12,"Home","Carlton","Gold Coast",29
16500,2024-05-25,"R12","North Melbourne",7,6,48,"Port Adelaide",16,11,107,"Bellerive Oval",-59,2024,"Regular",12,"Away","Port Adelaide","North Melbourne",59
16501,2024-05-25,"R12","Geelong",11,8,74,"GWS",11,12,78,"Kardinia Park",-4,2024,"Regular",12,"Away","GWS","Geelong",4
16502,2024-05-25,"R12","Richmond",10,14,74,"Essendon",12,14,86,"M.C.G.",-12,2024,"Regular",12,"Away","Essendon","Richmond",12
16503,2024-05-26,"R12","Hawthorn",15,10,100,"Brisbane Lions",10,15,75,"Docklands",25,2024,"Regular",12,"Home","Hawthorn","Brisbane Lions",25
16504,2024-05-26,"R12","Melbourne",14,16,100,"St Kilda",9,8,62,"M.C.G.",38,2024,"Regular",12,"Home","Melbourne","St Kilda",38
16505,2024-05-26,"R12","Adelaide",21,11,137,"West Coast",5,8,38,"Adelaide Oval",99,2024,"Regular",12,"Home","Adelaide","West Coast",99
16506,2024-05-30,"R13","Port Adelaide",10,11,71,"Carlton",16,11,107,"Adelaide Oval",-36,2024,"Regular",13,"Away","Carlton","Port Adelaide",36
16507,2024-05-31,"R13","Collingwood",12,10,82,"Footscray",15,10,100,"Docklands",-18,2024,"Regular",13,"Away","Footscray","Collingwood",18
16508,2024-06-01,"R13","Hawthorn",16,11,107,"Adelaide",12,8,80,"M.C.G.",27,2024,"Regular",13,"Home","Hawthorn","Adelaide",27
16509,2024-06-01,"R13","West Coast",10,8,68,"St Kilda",12,10,82,"Perth Stadium",-14,2024,"Regular",13,"Away","St Kilda","West Coast",14
16510,2024-06-01,"R13","Geelong",15,9,99,"Richmond",10,9,69,"Kardinia Park",30,2024,"Regular",13,"Home","Geelong","Richmond",30
16511,2024-06-02,"R13","Melbourne",7,7,49,"Fremantle",22,9,141,"Traeger Park",-92,2024,"Regular",13,"Away","Fremantle","Melbourne",92
16512,2024-06-02,"R13","Gold Coast",14,7,91,"Essendon",11,14,80,"Carrara",11,2024,"Regular",13,"Home","Gold Coast","Essendon",11
16513,2024-06-06,"R14","Adelaide",10,11,71,"Richmond",12,7,79,"Adelaide Oval",-8,2024,"Regular",14,"Away","Richmond","Adelaide",8
16514,2024-06-07,"R14","Footscray",10,11,71,"Brisbane Lions",17,12,114,"Docklands",-43,2024,"Regular",14,"Away","Brisbane Lions","Footscray",43
16515,2024-06-08,"R14","Hawthorn",12,13,85,"GWS",12,7,79,"York Park",6,2024,"Regular",14,"Home","Hawthorn","GWS",6
16516,2024-06-08,"R14","West Coast",8,17,65,"North Melbourne",11,8,74,"Perth Stadium",-9,2024,"Regular",14,"Away","North Melbourne","West Coast",9
16517,2024-06-08,"R14","St Kilda",7,9,51,"Gold Coast",7,6,48,"Docklands",3,2024,"Regular",14,"Home","St Kilda","Gold Coast",3
16518,2024-06-09,"R14","Sydney",16,16,112,"Geelong",12,10,82,"S.C.G.",30,2024,"Regular",14,"Home","Sydney","Geelong",30
16519,2024-06-09,"R14","Essendon",9,16,70,"Carlton",15,6,96,"M.C.G.",-26,2024,"Regular",14,"Away","Carlton","Essendon",26
16520,2024-06-10,"R14","Collingwood",14,5,89,"Melbourne",6,15,51,"M.C.G.",38,2024,"Regular",14,"Home","Collingwood","Melbourne",38
16521,2024-06-14,"R15","Brisbane Lions",19,12,126,"St Kilda",16,10,106,"Gabba",20,2024,"Regular",15,"Home","Brisbane Lions","St Kilda",20
16522,2024-06-15,"R15","Footscray",23,11,149,"Fremantle",12,10,82,"Docklands",67,2024,"Regular",15,"Home","Footscray","Fremantle",67
16523,2024-06-15,"R15","Richmond",6,13,49,"Hawthorn",14,13,97,"M.C.G.",-48,2024,"Regular",15,"Away","Hawthorn","Richmond",48
16524,2024-06-15,"R15","Adelaide",10,7,67,"Sydney",16,13,109,"Adelaide Oval",-42,2024,"Regular",15,"Away","Sydney","Adelaide",42
16525,2024-06-16,"R15","North Melbourne",19,4,118,"Collingwood",18,11,119,"Docklands",-1,2024,"Regular",15,"Away","Collingwood","North Melbourne",1
16526,2024-06-16,"R15","GWS",9,19,73,"Port Adelaide",6,15,51,"Sydney Showground",22,2024,"Regular",15,"Home","GWS","Port Adelaide",22
16527,2024-06-21,"R16","Carlton",21,12,138,"Geelong",11,9,75,"M.C.G.",63,2024,"Regular",16,"Home","Carlton","Geelong",63
16528,2024-06-22,"R16","Port Adelaide",10,13,73,"Brisbane Lions",23,14,152,"Adelaide Oval",-79,2024,"Regular",16,"Away","Brisbane Lions","Port Adelaide",79
16529,2024-06-22,"R16","GWS",11,9,75,"Sydney",15,12,102,"Sydney Showground",-27,2024,"Regular",16,"Away","Sydney","GWS",27
16530,2024-06-22,"R16","Melbourne",11,4,70,"North Melbourne",10,7,67,"M.C.G.",3,2024,"Regular",16,"Home","Melbourne","North Melbourne",3
16531,2024-06-23,"R16","Essendon",19,8,122,"West Coast",13,14,92,"Docklands",30,2024,"Regular",16,"Home","Essendon","West Coast",30
16532,2024-06-23,"R16","Fremantle",12,13,85,"Gold Coast",10,5,65,"Perth Stadium",20,2024,"Regular",16,"Home","Fremantle","Gold Coast",20
16533,2024-06-28,"R17","Brisbane Lions",11,20,86,"Melbourne",11,15,81,"Gabba",5,2024,"Regular",17,"Home","Brisbane Lions","Melbourne",5
16534,2024-06-29,"R17","North Melbourne",9,6,60,"Footscray",11,11,77,"Docklands",-17,2024,"Regular",17,"Away","Footscray","North Melbourne",17
16535,2024-06-29,"R17","Sydney",14,14,98,"Fremantle",15,9,99,"S.C.G.",-1,2024,"Regular",17,"Away","Fremantle","Sydney",1
16536,2024-06-29,"R17","Gold Coast",14,17,101,"Collingwood",13,12,90,"Carrara",11,2024,"Regular",17,"Home","Gold Coast","Collingwood",11
16537,2024-06-29,"R17","Adelaide",13,16,94,"GWS",12,6,78,"Adelaide Oval",16,2024,"Regular",17,"Home","Adelaide","GWS",16
16538,2024-06-29,"R17","Geelong",16,9,105,"Essendon",9,6,60,"M.C.G.",45,2024,"Regular",17,"Home","Geelong","Essendon",45
16539,2024-06-30,"R17","St Kilda",8,12,60,"Port Adelaide",8,14,62,"Docklands",-2,2024,"Regular",17,"Away","Port Adelaide","St Kilda",2
16540,2024-06-30,"R17","Richmond",10,10,70,"Carlton",20,11,131,"M.C.G.",-61,2024,"Regular",17,"Away","Carlton","Richmond",61
16541,2024-06-30,"R17","West Coast",4,9,33,"Hawthorn",14,10,94,"Perth Stadium",-61,2024,"Regular",17,"Away","Hawthorn","West Coast",61
16542,2024-07-05,"R18","Collingwood",12,8,80,"Essendon",13,14,92,"M.C.G.",-12,2024,"Regular",18,"Away","Essendon","Collingwood",12
16543,2024-07-06,"R18","Port Adelaide",15,12,102,"Footscray",8,6,54,"Adelaide Oval",48,2024,"Regular",18,"Home","Port Adelaide","Footscray",48
16544,2024-07-06,"R18","North Melbourne",13,9,87,"Gold Coast",12,11,83,"Docklands",4,2024,"Regular",18,"Home","North Melbourne","Gold Coast",4
16545,2024-07-06,"R18","Geelong",16,14,110,"Hawthorn",9,5,59,"Kardinia Park",51,2024,"Regular",18,"Home","Geelong","Hawthorn",51
16546,2024-07-06,"R18","GWS",18,8,116,"Carlton",16,8,104,"Sydney Showground",12,2024,"Regular",18,"Home","GWS","Carlton",12
16547,2024-07-06,"R18","Fremantle",16,9,105,"Richmond",7,12,54,"Perth Stadium",51,2024,"Regular",18,"Home","Fremantle","Richmond",51
16548,2024-07-07,"R18","Melbourne",17,10,112,"West Coast",8,10,58,"M.C.G.",54,2024,"Regular",18,"Home","Melbourne","West Coast",54
16549,2024-07-07,"R18","St Kilda",13,6,84,"Sydney",11,16,82,"Docklands",2,2024,"Regular",18,"Home","St Kilda","Sydney",2
16550,2024-07-07,"R18","Brisbane Lions",14,13,97,"Adelaide",13,8,86,"Gabba",11,2024,"Regular",18,"Home","Brisbane Lions","Adelaide",11
16551,2024-07-12,"R19","Collingwood",10,11,71,"Geelong",13,13,91,"M.C.G.",-20,2024,"Regular",19,"Away","Geelong","Collingwood",20
16552,2024-07-13,"R19","Hawthorn",13,9,87,"Fremantle",10,14,74,"York Park",13,2024,"Regular",19,"Home","Hawthorn","Fremantle",13
16553,2024-07-13,"R19","Sydney",20,18,138,"North Melbourne",9,5,59,"S.C.G.",79,2024,"Regular",19,"Home","Sydney","North Melbourne",79
16554,2024-07-13,"R19","Footscray",14,16,100,"Carlton",12,14,86,"Docklands",14,2024,"Regular",19,"Home","Footscray","Carlton",14
16555,2024-07-13,"R19","Adelaide",10,11,71,"St Kilda",5,9,39,"Adelaide Oval",32,2024,"Regular",19,"Home","Adelaide","St Kilda",32
16556,2024-07-13,"R19","Melbourne",13,6,84,"Essendon",10,7,67,"M.C.G.",17,2024,"Regular",19,"Home","Melbourne","Essendon",17
16557,2024-07-14,"R19","Gold Coast",14,12,96,"Port Adelaide",12,10,82,"Carrara",14,2024,"Regular",19,"Home","Gold Coast","Port Adelaide",14
16558,2024-07-14,"R19","Richmond",12,12,84,"GWS",17,6,108,"M.C.G.",-24,2024,"Regular",19,"Away","GWS","Richmond",24
16559,2024-07-14,"R19","West Coast",14,9,93,"Brisbane Lions",16,10,106,"Perth Stadium",-13,2024,"Regular",19,"Away","Brisbane Lions","West Coast",13
16560,2024-07-19,"R20","Essendon",17,11,113,"Adelaide",17,13,115,"Docklands",-2,2024,"Regular",20,"Away","Adelaide","Essendon",2
16561,2024-07-20,"R20","St Kilda",17,11,113,"West Coast",6,5,41,"Docklands",72,2024,"Regular",20,"Home","St Kilda","West Coast",72
16562,2024-07-20,"R20","GWS",14,5,89,"Gold Coast",6,14,50,"Sydney Showground",39,2024,"Regular",20,"Home","GWS","Gold Coast",39
16563,2024-07-20,"R20","Hawthorn",20,13,133,"Collingwood",9,13,67,"M.C.G.",66,2024,"Regular",20,"Home","Hawthorn","Collingwood",66
16564,2024-07-20,"R20","Geelong",7,6,48,"Footscray",13,17,95,"Kardinia Park",-47,2024,"Regular",20,"Away","Footscray","Geelong",47
16565,2024-07-20,"R20","Port Adelaide",16,20,116,"Richmond",11,9,75,"Adelaide Oval",41,2024,"Regular",20,"Home","Port Adelaide","Richmond",41
16566,2024-07-21,"R20","Brisbane Lions",11,13,79,"Sydney",11,11,77,"Gabba",2,2024,"Regular",20,"Home","Brisbane Lions","Sydney",2
16567,2024-07-21,"R20","Fremantle",17,14,116,"Melbourne",10,6,66,"Perth Stadium",50,2024,"Regular",20,"Home","Fremantle","Melbourne",50
16568,2024-07-21,"R20","Carlton",16,11,107,"North Melbourne",14,4,88,"Docklands",19,2024,"Regular",20,"Home","Carlton","North Melbourne",19
16569,2024-07-26,"R21","Carlton",9,11,65,"Port Adelaide",11,13,79,"Docklands",-14,2024,"Regular",21,"Away","Port Adelaide","Carlton",14
16570,2024-07-27,"R21","North Melbourne",10,6,66,"Geelong",16,10,106,"Bellerive Oval",-40,2024,"Regular",21,"Away","Geelong","North Melbourne",40
16571,2024-07-27,"R21","St Kilda",17,6,108,"Essendon",8,7,55,"Docklands",53,2024,"Regular",21,"Home","St Kilda","Essendon",53
16572,2024-07-27,"R21","Gold Coast",9,11,65,"Brisbane Lions",13,15,93,"Carrara",-28,2024,"Regular",21,"Away","Brisbane Lions","Gold Coast",28
16573,2024-07-27,"R21","Melbourne",12,11,83,"GWS",13,7,85,"M.C.G.",-2,2024,"Regular",21,"Away","GWS","Melbourne",2
16574,2024-07-27,"R21","Fremantle",17,8,110,"West Coast",11,9,75,"Perth Stadium",35,2024,"Regular",21,"Home","Fremantle","West Coast",35
16575,2024-07-28,"R21","Collingwood",14,9,93,"Richmond",9,13,67,"M.C.G.",26,2024,"Regular",21,"Home","Collingwood","Richmond",26
16576,2024-07-28,"R21","Sydney",7,6,48,"Footscray",12,15,87,"S.C.G.",-39,2024,"Regular",21,"Away","Footscray","Sydney",39
16577,2024-07-28,"R21","Adelaide",8,10,58,"Hawthorn",19,10,124,"Adelaide Oval",-66,2024,"Regular",21,"Away","Hawthorn","Adelaide",66
16578,2024-08-02,"R22","Footscray",15,20,110,"Melbourne",9,5,59,"Docklands",51,2024,"Regular",22,"Home","Footscray","Melbourne",51
16579,2024-08-02,"R22","West Coast",15,7,97,"Gold Coast",13,9,87,"Perth Stadium",10,2024,"Regular",22,"Home","West Coast","Gold Coast",10
16580,2024-08-03,"R22","North Melbourne",14,6,90,"Richmond",10,17,77,"Docklands",13,2024,"Regular",22,"Home","North Melbourne","Richmond",13
16581,2024-08-03,"R22","Geelong",13,12,90,"Adelaide",13,7,85,"Kardinia Park",5,2024,"Regular",22,"Home","Geelong","Adelaide",5
16582,2024-08-03,"R22","Collingwood",12,12,84,"Carlton",11,15,81,"M.C.G.",3,2024,"Regular",22,"Home","Collingwood","Carlton",3
16583,2024-08-03,"R22","Port Adelaide",22,16,148,"Sydney",5,6,36,"Adelaide Oval",112,2024,"Regular",22,"Home","Port Adelaide","Sydney",112
16584,2024-08-04,"R22","GWS",12,12,84,"Hawthorn",12,10,82,"Manuka Oval",2,2024,"Regular",22,"Home","GWS","Hawthorn",2
16585,2024-08-04,"R22","Essendon",13,12,90,"Fremantle",14,5,89,"M.C.G.",1,2024,"Regular",22,"Home","Essendon","Fremantle",1
16586,2024-08-04,"R22","St Kilda",5,9,39,"Brisbane Lions",19,10,124,"Docklands",-85,2024,"Regular",22,"Away","Brisbane Lions","St Kilda",85
16587,2024-08-09,"R23","Sydney",13,11,89,"Collingwood",12,14,86,"S.C.G.",3,2024,"Regular",23,"Home","Sydney","Collingwood",3
16588,2024-08-10,"R23","North Melbourne",14,13,97,"West Coast",15,12,102,"Bellerive Oval",-5,2024,"Regular",23,"Away","West Coast","North Melbourne",5
16589,2024-08-10,"R23","Brisbane Lions",8,16,64,"GWS",13,4,82,"Gabba",-18,2024,"Regular",23,"Away","GWS","Brisbane Lions",18
16590,2024-08-10,"R23","Fremantle",9,8,62,"Geelong",10,13,73,"Perth Stadium",-11,2024,"Regular",23,"Away","Geelong","Fremantle",11
16591,2024-08-10,"R23","Essendon",12,14,86,"Gold Coast",13,9,87,"Docklands",-1,2024,"Regular",23,"Away","Gold Coast","Essendon",1
16592,2024-08-10,"R23","Melbourne",7,9,51,"Port Adelaide",7,11,53,"M.C.G.",-2,2024,"Regular",23,"Away","Port Adelaide","Melbourne",2
16593,2024-08-11,"R23","Carlton",5,8,38,"Hawthorn",16,16,112,"M.C.G.",-74,2024,"Regular",23,"Away","Hawthorn","Carlton",74
16594,2024-08-11,"R23","Richmond",7,9,51,"St Kilda",15,9,99,"Docklands",-48,2024,"Regular",23,"Away","St Kilda","Richmond",48
16595,2024-08-11,"R23","Adelaide",17,9,111,"Footscray",9,18,72,"Adelaide Oval",39,2024,"Regular",23,"Home","Adelaide","Footscray",39
16596,2024-08-16,"R24","Essendon",8,11,59,"Sydney",15,8,98,"Docklands",-39,2024,"Regular",24,"Away","Sydney","Essendon",39
16597,2024-08-17,"R24","GWS",15,11,101,"Fremantle",14,8,92,"Sydney Showground",9,2024,"Regular",24,"Home","GWS","Fremantle",9
16598,2024-08-17,"R24","Gold Coast",9,9,63,"Melbourne",18,9,117,"Carrara",-54,2024,"Regular",24,"Away","Melbourne","Gold Coast",54
16599,2024-08-17,"R24","Collingwood",11,13,79,"Brisbane Lions",11,12,78,"M.C.G.",1,2024,"Regular",24,"Home","Collingwood","Brisbane Lions",1
16600,2024-08-17,"R24","Port Adelaide",11,14,80,"Adelaide",8,10,58,"Adelaide Oval",22,2024,"Regular",24,"Home","Port Adelaide","Adelaide",22
16601,2024-08-17,"R24","St Kilda",16,11,107,"Geelong",14,5,89,"Docklands",18,2024,"Regular",24,"Home","St Kilda","Geelong",18
16602,2024-08-18,"R24","Footscray",20,18,138,"North Melbourne",6,6,42,"Docklands",96,2024,"Regular",24,"Home","Footscray","North Melbourne",96
16603,2024-08-18,"R24","Hawthorn",19,17,131,"Richmond",10,8,68,"M.C.G.",63,2024,"Regular",24,"Home","Hawthorn","Richmond",63
16604,2024-08-18,"R24","West Coast",4,10,34,"Carlton",14,15,99,"Perth Stadium",-65,2024,"Regular",24,"Away","Carlton","West Coast",65
16605,2024-08-23,"R25","Melbourne",8,9,57,"Collingwood",15,13,103,"M.C.G.",-46,2024,"Regular",25,"Away","Collingwood","Melbourne",46
16606,2024-08-24,"R25","Hawthorn",26,14,170,"North Melbourne",7,4,46,"York Park",124,2024,"Regular",25,"Home","Hawthorn","North Melbourne",124
16607,2024-08-24,"R25","Geelong",26,12,168,"West Coast",11,9,75,"Kardinia Park",93,2024,"Regular",25,"Home","Geelong","West Coast",93
16608,2024-08-24,"R25","Richmond",10,6,66,"Gold Coast",14,10,94,"M.C.G.",-28,2024,"Regular",25,"Away","Gold Coast","Richmond",28
16609,2024-08-24,"R25","Brisbane Lions",11,21,87,"Essendon",10,7,67,"Gabba",20,2024,"Regular",25,"Home","Brisbane Lions","Essendon",20
16610,2024-08-24,"R25","Sydney",18,13,121,"Adelaide",13,12,90,"S.C.G.",31,2024,"Regular",25,"Home","Sydney","Adelaide",31
16611,2024-08-25,"R25","Footscray",14,14,98,"GWS",9,7,61,"Eureka Stadium",37,2024,"Regular",25,"Home","Footscray","GWS",37
16612,2024-08-25,"R25","Carlton",11,8,74,"St Kilda",11,10,76,"Docklands",-2,2024,"Regular",25,"Away","St Kilda","Carlton",2
16613,2024-08-25,"R25","Fremantle",9,13,67,"Port Adelaide",13,9,87,"Perth Stadium",-20,2024,"Regular",25,"Away","Port Adelaide","Fremantle",20
16614,2024-09-05,"QF","Port Adelaide",7,12,54,"Geelong",20,18,138,"Adelaide Oval",-84,2024,"Finals",26,"Away","Geelong","Port Adelaide",84
16615,2024-09-06,"EF","Footscray",9,8,62,"Hawthorn",14,15,99,"M.C.G.",-37,2024,"Finals",26,"Away","Hawthorn","Footscray",37
16616,2024-09-07,"QF","Sydney",13,10,88,"GWS",12,10,82,"S.C.G.",6,2024,"Finals",26,"Home","Sydney","GWS",6
16617,2024-09-07,"EF","Brisbane Lions",14,15,99,"Carlton",11,5,71,"Gabba",28,2024,"Finals",26,"Home","Brisbane Lions","Carlton",28
16618,2024-09-13,"SF","Port Adelaide",11,9,75,"Hawthorn",11,6,72,"Adelaide Oval",3,2024,"Finals",27,"Home","Port Adelaide","Hawthorn",3
16619,2024-09-14,"SF","GWS",15,10,100,"Brisbane Lions",15,15,105,"Sydney Showground",-5,2024,"Finals",27,"Away","Brisbane Lions","GWS",5
16620,2024-09-20,"PF","Sydney",14,11,95,"Port Adelaide",8,11,59,"S.C.G.",36,2024,"Finals",28,"Home","Sydney","Port Adelaide",36
16621,2024-09-21,"PF","Geelong",12,13,85,"Brisbane Lions",14,11,95,"M.C.G.",-10,2024,"Finals",28,"Away","Brisbane Lions","Geelong",10
16622,2024-09-28,"GF","Sydney",9,6,60,"Brisbane Lions",18,12,120,"M.C.G.",-60,2024,"Finals",29,"Away","Brisbane Lions","Sydney",60
